,left_minus_right_scores,left_scores,left_team,right_scores,right_team,scenario
0,10,11,f5v0to1to2t05_e2_ckpt291,1,easy_bots,5_vs_5
1,10,13,f5v0to1to2t05_e2_ckpt291,3,easy_bots,5_vs_5
2,9,10,f5v0to1to2t05_e2_ckpt291,1,easy_bots,5_vs_5
3,8,9,f5v0to1to2t05_e2_ckpt291,1,easy_bots,5_vs_5
4,14,14,f5v0to1to2t05_e2_ckpt291,0,easy_bots,5_vs_5
5,7,8,f5v0to1to2t05_e2_ckpt291,1,easy_bots,5_vs_5
6,13,13,f5v0to1to2t05_e2_ckpt291,0,easy_bots,5_vs_5
7,8,10,f5v0to1to2t05_e2_ckpt291,2,easy_bots,5_vs_5
8,12,12,f5v0to1to2t05_e2_ckpt291,0,easy_bots,5_vs_5
9,10,10,f5v0to1to2t05_e2_ckpt291,0,easy_bots,5_vs_5
10,7,10,f5v0to1to2t05_e2_ckpt291,3,medium_bots,5_vs_5_medium
11,2,6,f5v0to1to2t05_e2_ckpt291,4,medium_bots,5_vs_5_medium
12,8,10,f5v0to1to2t05_e2_ckpt291,2,medium_bots,5_vs_5_medium
13,6,8,f5v0to1to2t05_e2_ckpt291,2,medium_bots,5_vs_5_medium
14,10,11,f5v0to1to2t05_e2_ckpt291,1,medium_bots,5_vs_5_medium
15,1,3,f5v0to1to2t05_e2_ckpt291,2,medium_bots,5_vs_5_medium
16,11,11,f5v0to1to2t05_e2_ckpt291,0,medium_bots,5_vs_5_medium
17,6,9,f5v0to1to2t05_e2_ckpt291,3,medium_bots,5_vs_5_medium
18,13,14,f5v0to1to2t05_e2_ckpt291,1,medium_bots,5_vs_5_medium
19,14,14,f5v0to1to2t05_e2_ckpt291,0,medium_bots,5_vs_5_medium
20,8,9,f5v0to1to2t05_e2_ckpt291,1,hard_bots,5_vs_5_hard
21,3,4,f5v0to1to2t05_e2_ckpt291,1,hard_bots,5_vs_5_hard
22,12,12,f5v0to1to2t05_e2_ckpt291,0,hard_bots,5_vs_5_hard
23,4,5,f5v0to1to2t05_e2_ckpt291,1,hard_bots,5_vs_5_hard
24,6,6,f5v0to1to2t05_e2_ckpt291,0,hard_bots,5_vs_5_hard
25,5,6,f5v0to1to2t05_e2_ckpt291,1,hard_bots,5_vs_5_hard
26,6,7,f5v0to1to2t05_e2_ckpt291,1,hard_bots,5_vs_5_hard
27,6,8,f5v0to1to2t05_e2_ckpt291,2,hard_bots,5_vs_5_hard
28,7,9,f5v0to1to2t05_e2_ckpt291,2,hard_bots,5_vs_5_hard
29,10,11,f5v0to1to2t05_e2_ckpt291,1,hard_bots,5_vs_5_hard
30,1,4,f5v0to1to2t05_e2_ckpt291,3,f5v0to1to2t05_e2_ckpt291,5_vs_5
31,-1,4,f5v0to1to2t05_e2_ckpt291,5,f5v0to1to2t05_e2_ckpt291,5_vs_5
32,-3,3,f5v0to1to2t05_e2_ckpt291,6,f5v0to1to2t05_e2_ckpt291,5_vs_5
33,3,5,f5v0to1to2t05_e2_ckpt291,2,f5v0to1to2t05_e2_ckpt291,5_vs_5
34,-4,0,f5v0to1to2t05_e2_ckpt291,4,f5v0to1to2t05_e2_ckpt291,5_vs_5
35,3,5,f5v0to1to2t05_e2_ckpt291,2,f5v0to1to5_e2_ckpt252,5_vs_5
36,3,4,f5v0to1to2t05_e2_ckpt291,1,f5v0to1to5_e2_ckpt252,5_vs_5
37,0,4,f5v0to1to2t05_e2_ckpt291,4,f5v0to1to5_e2_ckpt252,5_vs_5
38,-6,1,f5v0to1to2t05_e2_ckpt291,7,f5v0to1to5_e2_ckpt252,5_vs_5
39,2,5,f5v0to1to2t05_e2_ckpt291,3,f5v0to1to5_e2_ckpt252,5_vs_5
40,-2,2,f5v0to1to2t05_e2_ckpt291,4,scon_e3_p2_hard_ckpt840,5_vs_5
41,0,3,f5v0to1to2t05_e2_ckpt291,3,scon_e3_p2_hard_ckpt840,5_vs_5
42,5,5,f5v0to1to2t05_e2_ckpt291,0,scon_e3_p2_hard_ckpt840,5_vs_5
43,4,4,f5v0to1to2t05_e2_ckpt291,0,scon_e3_p2_hard_ckpt840,5_vs_5
44,3,4,f5v0to1to2t05_e2_ckpt291,1,scon_e3_p2_hard_ckpt840,5_vs_5
45,-1,4,f5v0to1to2t05_e2_ckpt291,5,less_then_partially_randomized_checkpoints_bots_4_heads_38_ckpt108,5_vs_5
46,-5,1,f5v0to1to2t05_e2_ckpt291,6,less_then_partially_randomized_checkpoints_bots_4_heads_38_ckpt108,5_vs_5
47,1,4,f5v0to1to2t05_e2_ckpt291,3,less_then_partially_randomized_checkpoints_bots_4_heads_38_ckpt108,5_vs_5
48,-5,2,f5v0to1to2t05_e2_ckpt291,7,less_then_partially_randomized_checkpoints_bots_4_heads_38_ckpt108,5_vs_5
49,-5,2,f5v0to1to2t05_e2_ckpt291,7,less_then_partially_randomized_checkpoints_bots_4_heads_38_ckpt108,5_vs_5
50,1,4,f5v0to1to2t05_e2_ckpt291,3,less_then_partially_randomized_entropy_checkpoints_bots_4_heads_39_ckpt109,5_vs_5
51,2,7,f5v0to1to2t05_e2_ckpt291,5,less_then_partially_randomized_entropy_checkpoints_bots_4_heads_39_ckpt109,5_vs_5
52,-2,2,f5v0to1to2t05_e2_ckpt291,4,less_then_partially_randomized_entropy_checkpoints_bots_4_heads_39_ckpt109,5_vs_5
53,3,6,f5v0to1to2t05_e2_ckpt291,3,less_then_partially_randomized_entropy_checkpoints_bots_4_heads_39_ckpt109,5_vs_5
54,4,6,f5v0to1to2t05_e2_ckpt291,2,less_then_partially_randomized_entropy_checkpoints_bots_4_heads_39_ckpt109,5_vs_5
55,8,9,f5v0to1to2t05_e2_ckpt291,1,reward_shaping_checkpoints_bots_4_heads_1_ckpt360,5_vs_5
56,3,3,f5v0to1to2t05_e2_ckpt291,0,reward_shaping_checkpoints_bots_4_heads_1_ckpt360,5_vs_5
57,3,5,f5v0to1to2t05_e2_ckpt291,2,reward_shaping_checkpoints_bots_4_heads_1_ckpt360,5_vs_5
58,6,6,f5v0to1to2t05_e2_ckpt291,0,reward_shaping_checkpoints_bots_4_heads_1_ckpt360,5_vs_5
59,4,9,f5v0to1to2t05_e2_ckpt291,5,reward_shaping_checkpoints_bots_4_heads_1_ckpt360,5_vs_5
60,-8,2,f5v0to1to2t05_e2_ckpt291,10,checkpoints_selfplay_e9_sp_ckpt274,5_vs_5
61,0,1,f5v0to1to2t05_e2_ckpt291,1,checkpoints_selfplay_e9_sp_ckpt274,5_vs_5
62,-9,1,f5v0to1to2t05_e2_ckpt291,10,checkpoints_selfplay_e9_sp_ckpt274,5_vs_5
63,-2,3,f5v0to1to2t05_e2_ckpt291,5,checkpoints_selfplay_e9_sp_ckpt274,5_vs_5
64,-8,1,f5v0to1to2t05_e2_ckpt291,9,checkpoints_selfplay_e9_sp_ckpt274,5_vs_5
65,0,2,f5v0to1to2t05_e2_ckpt291,2,checkpoints_sp_c_nb_e2_ckpt667,5_vs_5
66,-8,2,f5v0to1to2t05_e2_ckpt291,10,checkpoints_sp_c_nb_e2_ckpt667,5_vs_5
67,-2,2,f5v0to1to2t05_e2_ckpt291,4,checkpoints_sp_c_nb_e2_ckpt667,5_vs_5
68,0,3,f5v0to1to2t05_e2_ckpt291,3,checkpoints_sp_c_nb_e2_ckpt667,5_vs_5
69,-3,2,f5v0to1to2t05_e2_ckpt291,5,checkpoints_sp_c_nb_e2_ckpt667,5_vs_5
70,0,4,f5v0to1to2t05_e2_ckpt291,4,m_sp_arch_medium_heads_conv16_0_bt_32_r313_m335,5_vs_5
71,-3,1,f5v0to1to2t05_e2_ckpt291,4,m_sp_arch_medium_heads_conv16_0_bt_32_r313_m335,5_vs_5
72,-1,3,f5v0to1to2t05_e2_ckpt291,4,m_sp_arch_medium_heads_conv16_0_bt_32_r313_m335,5_vs_5
73,-1,2,f5v0to1to2t05_e2_ckpt291,3,m_sp_arch_medium_heads_conv16_0_bt_32_r313_m335,5_vs_5
74,3,5,f5v0to1to2t05_e2_ckpt291,2,m_sp_arch_medium_heads_conv16_0_bt_32_r313_m335,5_vs_5
75,0,2,f5v0to1to2t05_e2_ckpt291,2,m_sp_arch_longer_heads_bt_32_r201_m335,5_vs_5
76,-3,4,f5v0to1to2t05_e2_ckpt291,7,m_sp_arch_longer_heads_bt_32_r201_m335,5_vs_5
77,-3,0,f5v0to1to2t05_e2_ckpt291,3,m_sp_arch_longer_heads_bt_32_r201_m335,5_vs_5
78,-5,2,f5v0to1to2t05_e2_ckpt291,7,m_sp_arch_longer_heads_bt_32_r201_m335,5_vs_5
79,-3,1,f5v0to1to2t05_e2_ckpt291,4,m_sp_arch_longer_heads_bt_32_r201_m335,5_vs_5
80,-4,3,f5v0to1to2t05_e2_ckpt291,7,m_sp_arch_medium_heads_bt_32_r201_m335,5_vs_5
81,-1,3,f5v0to1to2t05_e2_ckpt291,4,m_sp_arch_medium_heads_bt_32_r201_m335,5_vs_5
82,-4,3,f5v0to1to2t05_e2_ckpt291,7,m_sp_arch_medium_heads_bt_32_r201_m335,5_vs_5
83,-4,3,f5v0to1to2t05_e2_ckpt291,7,m_sp_arch_medium_heads_bt_32_r201_m335,5_vs_5
84,-5,1,f5v0to1to2t05_e2_ckpt291,6,m_sp_arch_medium_heads_bt_32_r201_m335,5_vs_5
85,-8,1,f5v0to1to2t05_e2_ckpt291,9,m_sp_arch_4x1_bt_32_r201_m335,5_vs_5
86,-9,1,f5v0to1to2t05_e2_ckpt291,10,m_sp_arch_4x1_bt_32_r201_m335,5_vs_5
87,-8,1,f5v0to1to2t05_e2_ckpt291,9,m_sp_arch_4x1_bt_32_r201_m335,5_vs_5
88,-9,1,f5v0to1to2t05_e2_ckpt291,10,m_sp_arch_4x1_bt_32_r201_m335,5_vs_5
89,-9,1,f5v0to1to2t05_e2_ckpt291,10,m_sp_arch_4x1_bt_32_r201_m335,5_vs_5
90,-9,0,f5v0to1to2t05_e2_ckpt291,9,m_sp_arch_4x1_bt_32_r201_cont3_m650,5_vs_5
91,-7,0,f5v0to1to2t05_e2_ckpt291,7,m_sp_arch_4x1_bt_32_r201_cont3_m650,5_vs_5
92,-10,0,f5v0to1to2t05_e2_ckpt291,10,m_sp_arch_4x1_bt_32_r201_cont3_m650,5_vs_5
93,-10,0,f5v0to1to2t05_e2_ckpt291,10,m_sp_arch_4x1_bt_32_r201_cont3_m650,5_vs_5
94,-8,1,f5v0to1to2t05_e2_ckpt291,9,m_sp_arch_4x1_bt_32_r201_cont3_m650,5_vs_5
95,-3,0,f5v0to1to2t05_e2_ckpt291,3,explt_v0_7_2_m54,5_vs_5
96,-2,0,f5v0to1to2t05_e2_ckpt291,2,explt_v0_7_2_m54,5_vs_5
97,-1,2,f5v0to1to2t05_e2_ckpt291,3,explt_v0_7_2_m54,5_vs_5
98,0,2,f5v0to1to2t05_e2_ckpt291,2,explt_v0_7_2_m54,5_vs_5
99,-2,1,f5v0to1to2t05_e2_ckpt291,3,explt_v0_7_2_m54,5_vs_5
100,-12,0,f5v0to1to2t05_e2_ckpt291,12,m_sp_sc3v3_arch_2x1_32_r500_cont4x1_m224,5_vs_5
101,-11,0,f5v0to1to2t05_e2_ckpt291,11,m_sp_sc3v3_arch_2x1_32_r500_cont4x1_m224,5_vs_5
102,-11,0,f5v0to1to2t05_e2_ckpt291,11,m_sp_sc3v3_arch_2x1_32_r500_cont4x1_m224,5_vs_5
103,-11,0,f5v0to1to2t05_e2_ckpt291,11,m_sp_sc3v3_arch_2x1_32_r500_cont4x1_m224,5_vs_5
104,-16,0,f5v0to1to2t05_e2_ckpt291,16,m_sp_sc3v3_arch_2x1_32_r500_cont4x1_m224,5_vs_5
105,-11,2,f5v0to1to2t05_e2_ckpt291,13,m_sp_arch_4x1_bt_32_roles_r500_m335,5_vs_5
106,-7,1,f5v0to1to2t05_e2_ckpt291,8,m_sp_arch_4x1_bt_32_roles_r500_m335,5_vs_5
107,-4,2,f5v0to1to2t05_e2_ckpt291,6,m_sp_arch_4x1_bt_32_roles_r500_m335,5_vs_5
108,-9,1,f5v0to1to2t05_e2_ckpt291,10,m_sp_arch_4x1_bt_32_roles_r500_m335,5_vs_5
109,-14,0,f5v0to1to2t05_e2_ckpt291,14,m_sp_arch_4x1_bt_32_roles_r500_m335,5_vs_5
110,-1,0,m_sp_sc3v3_arch_2x1_32_r500_cont4x1_m224,1,easy_bots,5_vs_5
111,0,0,m_sp_sc3v3_arch_2x1_32_r500_cont4x1_m224,0,easy_bots,5_vs_5
112,-2,0,m_sp_sc3v3_arch_2x1_32_r500_cont4x1_m224,2,easy_bots,5_vs_5
113,1,1,m_sp_sc3v3_arch_2x1_32_r500_cont4x1_m224,0,easy_bots,5_vs_5
114,-1,0,m_sp_sc3v3_arch_2x1_32_r500_cont4x1_m224,1,easy_bots,5_vs_5
115,3,3,m_sp_sc3v3_arch_2x1_32_r500_cont4x1_m224,0,easy_bots,5_vs_5
116,2,3,m_sp_sc3v3_arch_2x1_32_r500_cont4x1_m224,1,easy_bots,5_vs_5
117,-2,0,m_sp_sc3v3_arch_2x1_32_r500_cont4x1_m224,2,easy_bots,5_vs_5
118,-1,1,m_sp_sc3v3_arch_2x1_32_r500_cont4x1_m224,2,easy_bots,5_vs_5
119,1,1,m_sp_sc3v3_arch_2x1_32_r500_cont4x1_m224,0,easy_bots,5_vs_5
120,2,2,m_sp_sc3v3_arch_2x1_32_r500_cont4x1_m224,0,medium_bots,5_vs_5_medium
121,1,2,m_sp_sc3v3_arch_2x1_32_r500_cont4x1_m224,1,medium_bots,5_vs_5_medium
122,1,2,m_sp_sc3v3_arch_2x1_32_r500_cont4x1_m224,1,medium_bots,5_vs_5_medium
123,1,1,m_sp_sc3v3_arch_2x1_32_r500_cont4x1_m224,0,medium_bots,5_vs_5_medium
124,2,2,m_sp_sc3v3_arch_2x1_32_r500_cont4x1_m224,0,medium_bots,5_vs_5_medium
125,-1,0,m_sp_sc3v3_arch_2x1_32_r500_cont4x1_m224,1,medium_bots,5_vs_5_medium
126,0,1,m_sp_sc3v3_arch_2x1_32_r500_cont4x1_m224,1,medium_bots,5_vs_5_medium
127,2,2,m_sp_sc3v3_arch_2x1_32_r500_cont4x1_m224,0,medium_bots,5_vs_5_medium
128,2,2,m_sp_sc3v3_arch_2x1_32_r500_cont4x1_m224,0,medium_bots,5_vs_5_medium
129,2,2,m_sp_sc3v3_arch_2x1_32_r500_cont4x1_m224,0,medium_bots,5_vs_5_medium
130,0,0,m_sp_sc3v3_arch_2x1_32_r500_cont4x1_m224,0,hard_bots,5_vs_5_hard
131,0,0,m_sp_sc3v3_arch_2x1_32_r500_cont4x1_m224,0,hard_bots,5_vs_5_hard
132,-1,0,m_sp_sc3v3_arch_2x1_32_r500_cont4x1_m224,1,hard_bots,5_vs_5_hard
133,-3,0,m_sp_sc3v3_arch_2x1_32_r500_cont4x1_m224,3,hard_bots,5_vs_5_hard
134,-1,1,m_sp_sc3v3_arch_2x1_32_r500_cont4x1_m224,2,hard_bots,5_vs_5_hard
135,-3,0,m_sp_sc3v3_arch_2x1_32_r500_cont4x1_m224,3,hard_bots,5_vs_5_hard
136,-1,0,m_sp_sc3v3_arch_2x1_32_r500_cont4x1_m224,1,hard_bots,5_vs_5_hard
137,0,0,m_sp_sc3v3_arch_2x1_32_r500_cont4x1_m224,0,hard_bots,5_vs_5_hard
138,-1,0,m_sp_sc3v3_arch_2x1_32_r500_cont4x1_m224,1,hard_bots,5_vs_5_hard
139,0,1,m_sp_sc3v3_arch_2x1_32_r500_cont4x1_m224,1,hard_bots,5_vs_5_hard
140,9,11,m_sp_sc3v3_arch_2x1_32_r500_cont4x1_m224,2,f5v0to1to2t05_e2_ckpt291,5_vs_5
141,13,13,m_sp_sc3v3_arch_2x1_32_r500_cont4x1_m224,0,f5v0to1to2t05_e2_ckpt291,5_vs_5
142,10,10,m_sp_sc3v3_arch_2x1_32_r500_cont4x1_m224,0,f5v0to1to2t05_e2_ckpt291,5_vs_5
143,11,11,m_sp_sc3v3_arch_2x1_32_r500_cont4x1_m224,0,f5v0to1to2t05_e2_ckpt291,5_vs_5
144,11,12,m_sp_sc3v3_arch_2x1_32_r500_cont4x1_m224,1,f5v0to1to2t05_e2_ckpt291,5_vs_5
145,10,13,m_sp_sc3v3_arch_2x1_32_r500_cont4x1_m224,3,f5v0to1to5_e2_ckpt252,5_vs_5
146,13,13,m_sp_sc3v3_arch_2x1_32_r500_cont4x1_m224,0,f5v0to1to5_e2_ckpt252,5_vs_5
147,8,8,m_sp_sc3v3_arch_2x1_32_r500_cont4x1_m224,0,f5v0to1to5_e2_ckpt252,5_vs_5
148,7,7,m_sp_sc3v3_arch_2x1_32_r500_cont4x1_m224,0,f5v0to1to5_e2_ckpt252,5_vs_5
149,12,12,m_sp_sc3v3_arch_2x1_32_r500_cont4x1_m224,0,f5v0to1to5_e2_ckpt252,5_vs_5
150,10,10,m_sp_sc3v3_arch_2x1_32_r500_cont4x1_m224,0,scon_e3_p2_hard_ckpt840,5_vs_5
151,10,10,m_sp_sc3v3_arch_2x1_32_r500_cont4x1_m224,0,scon_e3_p2_hard_ckpt840,5_vs_5
152,14,14,m_sp_sc3v3_arch_2x1_32_r500_cont4x1_m224,0,scon_e3_p2_hard_ckpt840,5_vs_5
153,13,13,m_sp_sc3v3_arch_2x1_32_r500_cont4x1_m224,0,scon_e3_p2_hard_ckpt840,5_vs_5
154,13,13,m_sp_sc3v3_arch_2x1_32_r500_cont4x1_m224,0,scon_e3_p2_hard_ckpt840,5_vs_5
155,10,10,m_sp_sc3v3_arch_2x1_32_r500_cont4x1_m224,0,less_then_partially_randomized_checkpoints_bots_4_heads_38_ckpt108,5_vs_5
156,10,11,m_sp_sc3v3_arch_2x1_32_r500_cont4x1_m224,1,less_then_partially_randomized_checkpoints_bots_4_heads_38_ckpt108,5_vs_5
157,12,12,m_sp_sc3v3_arch_2x1_32_r500_cont4x1_m224,0,less_then_partially_randomized_checkpoints_bots_4_heads_38_ckpt108,5_vs_5
158,12,12,m_sp_sc3v3_arch_2x1_32_r500_cont4x1_m224,0,less_then_partially_randomized_checkpoints_bots_4_heads_38_ckpt108,5_vs_5
159,12,12,m_sp_sc3v3_arch_2x1_32_r500_cont4x1_m224,0,less_then_partially_randomized_checkpoints_bots_4_heads_38_ckpt108,5_vs_5
160,7,7,m_sp_sc3v3_arch_2x1_32_r500_cont4x1_m224,0,less_then_partially_randomized_entropy_checkpoints_bots_4_heads_39_ckpt109,5_vs_5
161,18,18,m_sp_sc3v3_arch_2x1_32_r500_cont4x1_m224,0,less_then_partially_randomized_entropy_checkpoints_bots_4_heads_39_ckpt109,5_vs_5
162,11,11,m_sp_sc3v3_arch_2x1_32_r500_cont4x1_m224,0,less_then_partially_randomized_entropy_checkpoints_bots_4_heads_39_ckpt109,5_vs_5
163,14,14,m_sp_sc3v3_arch_2x1_32_r500_cont4x1_m224,0,less_then_partially_randomized_entropy_checkpoints_bots_4_heads_39_ckpt109,5_vs_5
164,11,11,m_sp_sc3v3_arch_2x1_32_r500_cont4x1_m224,0,less_then_partially_randomized_entropy_checkpoints_bots_4_heads_39_ckpt109,5_vs_5
165,10,10,m_sp_sc3v3_arch_2x1_32_r500_cont4x1_m224,0,reward_shaping_checkpoints_bots_4_heads_1_ckpt360,5_vs_5
166,13,13,m_sp_sc3v3_arch_2x1_32_r500_cont4x1_m224,0,reward_shaping_checkpoints_bots_4_heads_1_ckpt360,5_vs_5
167,10,10,m_sp_sc3v3_arch_2x1_32_r500_cont4x1_m224,0,reward_shaping_checkpoints_bots_4_heads_1_ckpt360,5_vs_5
168,8,8,m_sp_sc3v3_arch_2x1_32_r500_cont4x1_m224,0,reward_shaping_checkpoints_bots_4_heads_1_ckpt360,5_vs_5
169,15,15,m_sp_sc3v3_arch_2x1_32_r500_cont4x1_m224,0,reward_shaping_checkpoints_bots_4_heads_1_ckpt360,5_vs_5
170,8,9,m_sp_sc3v3_arch_2x1_32_r500_cont4x1_m224,1,checkpoints_selfplay_e9_sp_ckpt274,5_vs_5
171,4,6,m_sp_sc3v3_arch_2x1_32_r500_cont4x1_m224,2,checkpoints_selfplay_e9_sp_ckpt274,5_vs_5
172,3,4,m_sp_sc3v3_arch_2x1_32_r500_cont4x1_m224,1,checkpoints_selfplay_e9_sp_ckpt274,5_vs_5
173,5,9,m_sp_sc3v3_arch_2x1_32_r500_cont4x1_m224,4,checkpoints_selfplay_e9_sp_ckpt274,5_vs_5
174,9,10,m_sp_sc3v3_arch_2x1_32_r500_cont4x1_m224,1,checkpoints_selfplay_e9_sp_ckpt274,5_vs_5
175,1,4,m_sp_sc3v3_arch_2x1_32_r500_cont4x1_m224,3,checkpoints_sp_c_nb_e2_ckpt667,5_vs_5
176,-1,1,m_sp_sc3v3_arch_2x1_32_r500_cont4x1_m224,2,checkpoints_sp_c_nb_e2_ckpt667,5_vs_5
177,2,5,m_sp_sc3v3_arch_2x1_32_r500_cont4x1_m224,3,checkpoints_sp_c_nb_e2_ckpt667,5_vs_5
178,3,5,m_sp_sc3v3_arch_2x1_32_r500_cont4x1_m224,2,checkpoints_sp_c_nb_e2_ckpt667,5_vs_5
179,6,8,m_sp_sc3v3_arch_2x1_32_r500_cont4x1_m224,2,checkpoints_sp_c_nb_e2_ckpt667,5_vs_5
180,1,2,m_sp_sc3v3_arch_2x1_32_r500_cont4x1_m224,1,m_sp_arch_medium_heads_conv16_0_bt_32_r313_m335,5_vs_5
181,4,5,m_sp_sc3v3_arch_2x1_32_r500_cont4x1_m224,1,m_sp_arch_medium_heads_conv16_0_bt_32_r313_m335,5_vs_5
182,0,0,m_sp_sc3v3_arch_2x1_32_r500_cont4x1_m224,0,m_sp_arch_medium_heads_conv16_0_bt_32_r313_m335,5_vs_5
183,7,8,m_sp_sc3v3_arch_2x1_32_r500_cont4x1_m224,1,m_sp_arch_medium_heads_conv16_0_bt_32_r313_m335,5_vs_5
184,8,8,m_sp_sc3v3_arch_2x1_32_r500_cont4x1_m224,0,m_sp_arch_medium_heads_conv16_0_bt_32_r313_m335,5_vs_5
185,7,8,m_sp_sc3v3_arch_2x1_32_r500_cont4x1_m224,1,m_sp_arch_longer_heads_bt_32_r201_m335,5_vs_5
186,3,4,m_sp_sc3v3_arch_2x1_32_r500_cont4x1_m224,1,m_sp_arch_longer_heads_bt_32_r201_m335,5_vs_5
187,4,5,m_sp_sc3v3_arch_2x1_32_r500_cont4x1_m224,1,m_sp_arch_longer_heads_bt_32_r201_m335,5_vs_5
188,4,5,m_sp_sc3v3_arch_2x1_32_r500_cont4x1_m224,1,m_sp_arch_longer_heads_bt_32_r201_m335,5_vs_5
189,8,8,m_sp_sc3v3_arch_2x1_32_r500_cont4x1_m224,0,m_sp_arch_longer_heads_bt_32_r201_m335,5_vs_5
190,4,6,m_sp_sc3v3_arch_2x1_32_r500_cont4x1_m224,2,m_sp_arch_medium_heads_bt_32_r201_m335,5_vs_5
191,0,4,m_sp_sc3v3_arch_2x1_32_r500_cont4x1_m224,4,m_sp_arch_medium_heads_bt_32_r201_m335,5_vs_5
192,6,8,m_sp_sc3v3_arch_2x1_32_r500_cont4x1_m224,2,m_sp_arch_medium_heads_bt_32_r201_m335,5_vs_5
193,7,7,m_sp_sc3v3_arch_2x1_32_r500_cont4x1_m224,0,m_sp_arch_medium_heads_bt_32_r201_m335,5_vs_5
194,4,4,m_sp_sc3v3_arch_2x1_32_r500_cont4x1_m224,0,m_sp_arch_medium_heads_bt_32_r201_m335,5_vs_5
195,-4,0,m_sp_sc3v3_arch_2x1_32_r500_cont4x1_m224,4,m_sp_arch_4x1_bt_32_r201_m335,5_vs_5
196,-5,2,m_sp_sc3v3_arch_2x1_32_r500_cont4x1_m224,7,m_sp_arch_4x1_bt_32_r201_m335,5_vs_5
197,-2,4,m_sp_sc3v3_arch_2x1_32_r500_cont4x1_m224,6,m_sp_arch_4x1_bt_32_r201_m335,5_vs_5
198,0,4,m_sp_sc3v3_arch_2x1_32_r500_cont4x1_m224,4,m_sp_arch_4x1_bt_32_r201_m335,5_vs_5
199,-5,0,m_sp_sc3v3_arch_2x1_32_r500_cont4x1_m224,5,m_sp_arch_4x1_bt_32_r201_m335,5_vs_5
200,0,1,m_sp_sc3v3_arch_2x1_32_r500_cont4x1_m224,1,m_sp_arch_4x1_bt_32_r201_cont3_m650,5_vs_5
201,1,1,m_sp_sc3v3_arch_2x1_32_r500_cont4x1_m224,0,m_sp_arch_4x1_bt_32_r201_cont3_m650,5_vs_5
202,-1,1,m_sp_sc3v3_arch_2x1_32_r500_cont4x1_m224,2,m_sp_arch_4x1_bt_32_r201_cont3_m650,5_vs_5
203,-1,4,m_sp_sc3v3_arch_2x1_32_r500_cont4x1_m224,5,m_sp_arch_4x1_bt_32_r201_cont3_m650,5_vs_5
204,-2,2,m_sp_sc3v3_arch_2x1_32_r500_cont4x1_m224,4,m_sp_arch_4x1_bt_32_r201_cont3_m650,5_vs_5
205,5,6,m_sp_sc3v3_arch_2x1_32_r500_cont4x1_m224,1,explt_v0_7_2_m54,5_vs_5
206,-2,1,m_sp_sc3v3_arch_2x1_32_r500_cont4x1_m224,3,explt_v0_7_2_m54,5_vs_5
207,1,1,m_sp_sc3v3_arch_2x1_32_r500_cont4x1_m224,0,explt_v0_7_2_m54,5_vs_5
208,-2,2,m_sp_sc3v3_arch_2x1_32_r500_cont4x1_m224,4,explt_v0_7_2_m54,5_vs_5
209,2,5,m_sp_sc3v3_arch_2x1_32_r500_cont4x1_m224,3,explt_v0_7_2_m54,5_vs_5
210,-2,1,m_sp_sc3v3_arch_2x1_32_r500_cont4x1_m224,3,m_sp_sc3v3_arch_2x1_32_r500_cont4x1_m224,5_vs_5
211,0,2,m_sp_sc3v3_arch_2x1_32_r500_cont4x1_m224,2,m_sp_sc3v3_arch_2x1_32_r500_cont4x1_m224,5_vs_5
212,-1,2,m_sp_sc3v3_arch_2x1_32_r500_cont4x1_m224,3,m_sp_sc3v3_arch_2x1_32_r500_cont4x1_m224,5_vs_5
213,-1,0,m_sp_sc3v3_arch_2x1_32_r500_cont4x1_m224,1,m_sp_sc3v3_arch_2x1_32_r500_cont4x1_m224,5_vs_5
214,0,2,m_sp_sc3v3_arch_2x1_32_r500_cont4x1_m224,2,m_sp_sc3v3_arch_2x1_32_r500_cont4x1_m224,5_vs_5
215,-4,0,m_sp_sc3v3_arch_2x1_32_r500_cont4x1_m224,4,m_sp_arch_4x1_bt_32_roles_r500_m335,5_vs_5
216,0,5,m_sp_sc3v3_arch_2x1_32_r500_cont4x1_m224,5,m_sp_arch_4x1_bt_32_roles_r500_m335,5_vs_5
217,-1,1,m_sp_sc3v3_arch_2x1_32_r500_cont4x1_m224,2,m_sp_arch_4x1_bt_32_roles_r500_m335,5_vs_5
218,-1,4,m_sp_sc3v3_arch_2x1_32_r500_cont4x1_m224,5,m_sp_arch_4x1_bt_32_roles_r500_m335,5_vs_5
219,-2,2,m_sp_sc3v3_arch_2x1_32_r500_cont4x1_m224,4,m_sp_arch_4x1_bt_32_roles_r500_m335,5_vs_5
220,2,3,m_sp_sc3v3_arch_2x1_32_r500_cont4x1_m224,1,easy_bots,5_vs_5
221,1,1,m_sp_sc3v3_arch_2x1_32_r500_cont4x1_m224,0,easy_bots,5_vs_5
222,-1,0,m_sp_sc3v3_arch_2x1_32_r500_cont4x1_m224,1,easy_bots,5_vs_5
223,2,2,m_sp_sc3v3_arch_2x1_32_r500_cont4x1_m224,0,easy_bots,5_vs_5
224,-1,0,m_sp_sc3v3_arch_2x1_32_r500_cont4x1_m224,1,medium_bots,5_vs_5_medium
225,1,1,m_sp_sc3v3_arch_2x1_32_r500_cont4x1_m224,0,medium_bots,5_vs_5_medium
226,-2,0,m_sp_sc3v3_arch_2x1_32_r500_cont4x1_m224,2,medium_bots,5_vs_5_medium
227,-1,1,m_sp_sc3v3_arch_2x1_32_r500_cont4x1_m224,2,medium_bots,5_vs_5_medium
228,-2,0,m_sp_sc3v3_arch_2x1_32_r500_cont4x1_m224,2,hard_bots,5_vs_5_hard
229,1,1,m_sp_sc3v3_arch_2x1_32_r500_cont4x1_m224,0,hard_bots,5_vs_5_hard
230,0,1,m_sp_sc3v3_arch_2x1_32_r500_cont4x1_m224,1,hard_bots,5_vs_5_hard
231,1,1,m_sp_sc3v3_arch_2x1_32_r500_cont4x1_m224,0,hard_bots,5_vs_5_hard
232,9,9,m_sp_sc3v3_arch_2x1_32_r500_cont4x1_m224,0,f5v0to1to2t05_e2_ckpt291,5_vs_5
233,10,10,m_sp_sc3v3_arch_2x1_32_r500_cont4x1_m224,0,f5v0to1to2t05_e2_ckpt291,5_vs_5
234,10,10,m_sp_sc3v3_arch_2x1_32_r500_cont4x1_m224,0,f5v0to1to5_e2_ckpt252,5_vs_5
235,11,12,m_sp_sc3v3_arch_2x1_32_r500_cont4x1_m224,1,f5v0to1to5_e2_ckpt252,5_vs_5
236,10,11,m_sp_sc3v3_arch_2x1_32_r500_cont4x1_m224,1,scon_e3_p2_hard_ckpt840,5_vs_5
237,11,11,m_sp_sc3v3_arch_2x1_32_r500_cont4x1_m224,0,scon_e3_p2_hard_ckpt840,5_vs_5
238,12,12,m_sp_sc3v3_arch_2x1_32_r500_cont4x1_m224,0,less_then_partially_randomized_checkpoints_bots_4_heads_38_ckpt108,5_vs_5
239,10,10,m_sp_sc3v3_arch_2x1_32_r500_cont4x1_m224,0,less_then_partially_randomized_checkpoints_bots_4_heads_38_ckpt108,5_vs_5
240,13,13,m_sp_sc3v3_arch_2x1_32_r500_cont4x1_m224,0,less_then_partially_randomized_entropy_checkpoints_bots_4_heads_39_ckpt109,5_vs_5
241,14,14,m_sp_sc3v3_arch_2x1_32_r500_cont4x1_m224,0,less_then_partially_randomized_entropy_checkpoints_bots_4_heads_39_ckpt109,5_vs_5
242,13,13,m_sp_sc3v3_arch_2x1_32_r500_cont4x1_m224,0,reward_shaping_checkpoints_bots_4_heads_1_ckpt360,5_vs_5
243,12,12,m_sp_sc3v3_arch_2x1_32_r500_cont4x1_m224,0,reward_shaping_checkpoints_bots_4_heads_1_ckpt360,5_vs_5
244,4,5,m_sp_sc3v3_arch_2x1_32_r500_cont4x1_m224,1,checkpoints_selfplay_e9_sp_ckpt274,5_vs_5
245,6,6,m_sp_sc3v3_arch_2x1_32_r500_cont4x1_m224,0,checkpoints_selfplay_e9_sp_ckpt274,5_vs_5
246,2,6,m_sp_sc3v3_arch_2x1_32_r500_cont4x1_m224,4,checkpoints_sp_c_nb_e2_ckpt667,5_vs_5
247,0,4,m_sp_sc3v3_arch_2x1_32_r500_cont4x1_m224,4,checkpoints_sp_c_nb_e2_ckpt667,5_vs_5
248,6,7,m_sp_sc3v3_arch_2x1_32_r500_cont4x1_m224,1,m_sp_arch_medium_heads_conv16_0_bt_32_r313_m335,5_vs_5
249,5,6,m_sp_sc3v3_arch_2x1_32_r500_cont4x1_m224,1,m_sp_arch_medium_heads_conv16_0_bt_32_r313_m335,5_vs_5
250,6,6,m_sp_sc3v3_arch_2x1_32_r500_cont4x1_m224,0,m_sp_arch_longer_heads_bt_32_r201_m335,5_vs_5
251,8,8,m_sp_sc3v3_arch_2x1_32_r500_cont4x1_m224,0,m_sp_arch_longer_heads_bt_32_r201_m335,5_vs_5
252,6,8,m_sp_sc3v3_arch_2x1_32_r500_cont4x1_m224,2,m_sp_arch_medium_heads_bt_32_r201_m335,5_vs_5
253,4,6,m_sp_sc3v3_arch_2x1_32_r500_cont4x1_m224,2,m_sp_arch_medium_heads_bt_32_r201_m335,5_vs_5
254,0,3,m_sp_sc3v3_arch_2x1_32_r500_cont4x1_m224,3,m_sp_arch_4x1_bt_32_r201_m335,5_vs_5
255,-2,2,m_sp_sc3v3_arch_2x1_32_r500_cont4x1_m224,4,m_sp_arch_4x1_bt_32_r201_m335,5_vs_5
256,-1,2,m_sp_sc3v3_arch_2x1_32_r500_cont4x1_m224,3,m_sp_arch_4x1_bt_32_r201_cont3_m650,5_vs_5
257,0,3,m_sp_sc3v3_arch_2x1_32_r500_cont4x1_m224,3,m_sp_arch_4x1_bt_32_r201_cont3_m650,5_vs_5
258,-1,0,m_sp_sc3v3_arch_2x1_32_r500_cont4x1_m224,1,explt_v0_7_2_m54,5_vs_5
259,2,2,m_sp_sc3v3_arch_2x1_32_r500_cont4x1_m224,0,explt_v0_7_2_m54,5_vs_5
260,1,1,m_sp_sc3v3_arch_2x1_32_r500_cont4x1_m224,0,m_sp_sc3v3_arch_2x1_32_r500_cont4x1_m224,5_vs_5
261,-2,1,m_sp_sc3v3_arch_2x1_32_r500_cont4x1_m224,3,m_sp_sc3v3_arch_2x1_32_r500_cont4x1_m224,5_vs_5
262,-5,2,m_sp_sc3v3_arch_2x1_32_r500_cont4x1_m224,7,m_sp_arch_4x1_bt_32_roles_r500_m335,5_vs_5
263,-2,2,m_sp_sc3v3_arch_2x1_32_r500_cont4x1_m224,4,m_sp_arch_4x1_bt_32_roles_r500_m335,5_vs_5
264,9,10,less_then_partially_randomized_checkpoints_bots_4_heads_38_ckpt108,1,easy_bots,5_vs_5
265,11,11,less_then_partially_randomized_checkpoints_bots_4_heads_38_ckpt108,0,easy_bots,5_vs_5
266,13,13,less_then_partially_randomized_checkpoints_bots_4_heads_38_ckpt108,0,easy_bots,5_vs_5
267,11,12,less_then_partially_randomized_checkpoints_bots_4_heads_38_ckpt108,1,easy_bots,5_vs_5
268,5,7,less_then_partially_randomized_checkpoints_bots_4_heads_38_ckpt108,2,easy_bots,5_vs_5
269,11,11,less_then_partially_randomized_checkpoints_bots_4_heads_38_ckpt108,0,easy_bots,5_vs_5
270,3,6,less_then_partially_randomized_checkpoints_bots_4_heads_38_ckpt108,3,medium_bots,5_vs_5_medium
271,8,8,less_then_partially_randomized_checkpoints_bots_4_heads_38_ckpt108,0,medium_bots,5_vs_5_medium
272,7,9,less_then_partially_randomized_checkpoints_bots_4_heads_38_ckpt108,2,medium_bots,5_vs_5_medium
273,8,9,less_then_partially_randomized_checkpoints_bots_4_heads_38_ckpt108,1,medium_bots,5_vs_5_medium
274,6,6,less_then_partially_randomized_checkpoints_bots_4_heads_38_ckpt108,0,medium_bots,5_vs_5_medium
275,7,8,less_then_partially_randomized_checkpoints_bots_4_heads_38_ckpt108,1,medium_bots,5_vs_5_medium
276,2,4,less_then_partially_randomized_checkpoints_bots_4_heads_38_ckpt108,2,hard_bots,5_vs_5_hard
277,6,6,less_then_partially_randomized_checkpoints_bots_4_heads_38_ckpt108,0,hard_bots,5_vs_5_hard
278,3,4,less_then_partially_randomized_checkpoints_bots_4_heads_38_ckpt108,1,hard_bots,5_vs_5_hard
279,1,5,less_then_partially_randomized_checkpoints_bots_4_heads_38_ckpt108,4,hard_bots,5_vs_5_hard
280,5,5,less_then_partially_randomized_checkpoints_bots_4_heads_38_ckpt108,0,hard_bots,5_vs_5_hard
281,3,3,less_then_partially_randomized_checkpoints_bots_4_heads_38_ckpt108,0,hard_bots,5_vs_5_hard
282,-1,3,less_then_partially_randomized_checkpoints_bots_4_heads_38_ckpt108,4,f5v0to1to2t05_e2_ckpt291,5_vs_5
283,-2,2,less_then_partially_randomized_checkpoints_bots_4_heads_38_ckpt108,4,f5v0to1to2t05_e2_ckpt291,5_vs_5
284,0,3,less_then_partially_randomized_checkpoints_bots_4_heads_38_ckpt108,3,f5v0to1to2t05_e2_ckpt291,5_vs_5
285,3,6,less_then_partially_randomized_checkpoints_bots_4_heads_38_ckpt108,3,f5v0to1to5_e2_ckpt252,5_vs_5
286,-1,3,less_then_partially_randomized_checkpoints_bots_4_heads_38_ckpt108,4,f5v0to1to5_e2_ckpt252,5_vs_5
287,3,7,less_then_partially_randomized_checkpoints_bots_4_heads_38_ckpt108,4,f5v0to1to5_e2_ckpt252,5_vs_5
288,1,4,less_then_partially_randomized_checkpoints_bots_4_heads_38_ckpt108,3,scon_e3_p2_hard_ckpt840,5_vs_5
289,4,5,less_then_partially_randomized_checkpoints_bots_4_heads_38_ckpt108,1,scon_e3_p2_hard_ckpt840,5_vs_5
290,0,2,less_then_partially_randomized_checkpoints_bots_4_heads_38_ckpt108,2,scon_e3_p2_hard_ckpt840,5_vs_5
291,-1,4,less_then_partially_randomized_checkpoints_bots_4_heads_38_ckpt108,5,less_then_partially_randomized_checkpoints_bots_4_heads_38_ckpt108,5_vs_5
292,1,4,less_then_partially_randomized_checkpoints_bots_4_heads_38_ckpt108,3,less_then_partially_randomized_checkpoints_bots_4_heads_38_ckpt108,5_vs_5
293,1,4,less_then_partially_randomized_checkpoints_bots_4_heads_38_ckpt108,3,less_then_partially_randomized_checkpoints_bots_4_heads_38_ckpt108,5_vs_5
294,-5,0,less_then_partially_randomized_checkpoints_bots_4_heads_38_ckpt108,5,less_then_partially_randomized_entropy_checkpoints_bots_4_heads_39_ckpt109,5_vs_5
295,-2,6,less_then_partially_randomized_checkpoints_bots_4_heads_38_ckpt108,8,less_then_partially_randomized_entropy_checkpoints_bots_4_heads_39_ckpt109,5_vs_5
296,4,7,less_then_partially_randomized_checkpoints_bots_4_heads_38_ckpt108,3,less_then_partially_randomized_entropy_checkpoints_bots_4_heads_39_ckpt109,5_vs_5
297,6,8,less_then_partially_randomized_checkpoints_bots_4_heads_38_ckpt108,2,reward_shaping_checkpoints_bots_4_heads_1_ckpt360,5_vs_5
298,2,4,less_then_partially_randomized_checkpoints_bots_4_heads_38_ckpt108,2,reward_shaping_checkpoints_bots_4_heads_1_ckpt360,5_vs_5
299,7,9,less_then_partially_randomized_checkpoints_bots_4_heads_38_ckpt108,2,reward_shaping_checkpoints_bots_4_heads_1_ckpt360,5_vs_5
300,-13,2,less_then_partially_randomized_checkpoints_bots_4_heads_38_ckpt108,15,checkpoints_selfplay_e9_sp_ckpt274,5_vs_5
301,-1,0,less_then_partially_randomized_checkpoints_bots_4_heads_38_ckpt108,1,checkpoints_selfplay_e9_sp_ckpt274,5_vs_5
302,-10,0,less_then_partially_randomized_checkpoints_bots_4_heads_38_ckpt108,10,checkpoints_selfplay_e9_sp_ckpt274,5_vs_5
303,-4,0,less_then_partially_randomized_checkpoints_bots_4_heads_38_ckpt108,4,checkpoints_sp_c_nb_e2_ckpt667,5_vs_5
304,-7,1,less_then_partially_randomized_checkpoints_bots_4_heads_38_ckpt108,8,checkpoints_sp_c_nb_e2_ckpt667,5_vs_5
305,-2,3,less_then_partially_randomized_checkpoints_bots_4_heads_38_ckpt108,5,checkpoints_sp_c_nb_e2_ckpt667,5_vs_5
306,1,4,less_then_partially_randomized_checkpoints_bots_4_heads_38_ckpt108,3,m_sp_arch_medium_heads_conv16_0_bt_32_r313_m335,5_vs_5
307,-2,1,less_then_partially_randomized_checkpoints_bots_4_heads_38_ckpt108,3,m_sp_arch_medium_heads_conv16_0_bt_32_r313_m335,5_vs_5
308,-3,2,less_then_partially_randomized_checkpoints_bots_4_heads_38_ckpt108,5,m_sp_arch_medium_heads_conv16_0_bt_32_r313_m335,5_vs_5
309,-9,0,less_then_partially_randomized_checkpoints_bots_4_heads_38_ckpt108,9,m_sp_arch_longer_heads_bt_32_r201_m335,5_vs_5
310,-9,1,less_then_partially_randomized_checkpoints_bots_4_heads_38_ckpt108,10,m_sp_arch_longer_heads_bt_32_r201_m335,5_vs_5
311,-5,0,less_then_partially_randomized_checkpoints_bots_4_heads_38_ckpt108,5,m_sp_arch_longer_heads_bt_32_r201_m335,5_vs_5
312,-3,3,less_then_partially_randomized_checkpoints_bots_4_heads_38_ckpt108,6,m_sp_arch_medium_heads_bt_32_r201_m335,5_vs_5
313,-5,2,less_then_partially_randomized_checkpoints_bots_4_heads_38_ckpt108,7,m_sp_arch_medium_heads_bt_32_r201_m335,5_vs_5
314,-4,3,less_then_partially_randomized_checkpoints_bots_4_heads_38_ckpt108,7,m_sp_arch_medium_heads_bt_32_r201_m335,5_vs_5
315,-10,0,less_then_partially_randomized_checkpoints_bots_4_heads_38_ckpt108,10,m_sp_arch_4x1_bt_32_r201_m335,5_vs_5
316,-11,0,less_then_partially_randomized_checkpoints_bots_4_heads_38_ckpt108,11,m_sp_arch_4x1_bt_32_r201_m335,5_vs_5
317,-10,0,less_then_partially_randomized_checkpoints_bots_4_heads_38_ckpt108,10,m_sp_arch_4x1_bt_32_r201_m335,5_vs_5
318,-10,0,less_then_partially_randomized_checkpoints_bots_4_heads_38_ckpt108,10,m_sp_arch_4x1_bt_32_r201_cont3_m650,5_vs_5
319,-14,0,less_then_partially_randomized_checkpoints_bots_4_heads_38_ckpt108,14,m_sp_arch_4x1_bt_32_r201_cont3_m650,5_vs_5
320,-8,0,less_then_partially_randomized_checkpoints_bots_4_heads_38_ckpt108,8,m_sp_arch_4x1_bt_32_r201_cont3_m650,5_vs_5
321,-1,1,less_then_partially_randomized_checkpoints_bots_4_heads_38_ckpt108,2,explt_v0_7_2_m54,5_vs_5
322,-4,0,less_then_partially_randomized_checkpoints_bots_4_heads_38_ckpt108,4,explt_v0_7_2_m54,5_vs_5
323,1,2,less_then_partially_randomized_checkpoints_bots_4_heads_38_ckpt108,1,explt_v0_7_2_m54,5_vs_5
324,-12,0,less_then_partially_randomized_checkpoints_bots_4_heads_38_ckpt108,12,m_sp_sc3v3_arch_2x1_32_r500_cont4x1_m224,5_vs_5
325,-15,0,less_then_partially_randomized_checkpoints_bots_4_heads_38_ckpt108,15,m_sp_sc3v3_arch_2x1_32_r500_cont4x1_m224,5_vs_5
326,-19,0,less_then_partially_randomized_checkpoints_bots_4_heads_38_ckpt108,19,m_sp_sc3v3_arch_2x1_32_r500_cont4x1_m224,5_vs_5
327,-8,0,less_then_partially_randomized_checkpoints_bots_4_heads_38_ckpt108,8,m_sp_arch_4x1_bt_32_roles_r500_m335,5_vs_5
328,-14,0,less_then_partially_randomized_checkpoints_bots_4_heads_38_ckpt108,14,m_sp_arch_4x1_bt_32_roles_r500_m335,5_vs_5
329,-14,0,less_then_partially_randomized_checkpoints_bots_4_heads_38_ckpt108,14,m_sp_arch_4x1_bt_32_roles_r500_m335,5_vs_5
330,10,12,f5v0to1to2t05_e2_ckpt291,2,easy_bots,5_vs_5
331,14,14,f5v0to1to2t05_e2_ckpt291,0,easy_bots,5_vs_5
332,15,16,f5v0to1to2t05_e2_ckpt291,1,easy_bots,5_vs_5
333,10,10,f5v0to1to2t05_e2_ckpt291,0,easy_bots,5_vs_5
334,17,18,f5v0to1to2t05_e2_ckpt291,1,easy_bots,5_vs_5
335,9,9,f5v0to1to2t05_e2_ckpt291,0,easy_bots,5_vs_5
336,8,8,f5v0to1to2t05_e2_ckpt291,0,medium_bots,5_vs_5_medium
337,5,7,f5v0to1to2t05_e2_ckpt291,2,medium_bots,5_vs_5_medium
338,12,13,f5v0to1to2t05_e2_ckpt291,1,medium_bots,5_vs_5_medium
339,6,6,f5v0to1to2t05_e2_ckpt291,0,medium_bots,5_vs_5_medium
340,6,8,f5v0to1to2t05_e2_ckpt291,2,medium_bots,5_vs_5_medium
341,5,7,f5v0to1to2t05_e2_ckpt291,2,medium_bots,5_vs_5_medium
342,1,3,f5v0to1to2t05_e2_ckpt291,2,hard_bots,5_vs_5_hard
343,12,14,f5v0to1to2t05_e2_ckpt291,2,hard_bots,5_vs_5_hard
344,7,8,f5v0to1to2t05_e2_ckpt291,1,hard_bots,5_vs_5_hard
345,9,10,f5v0to1to2t05_e2_ckpt291,1,hard_bots,5_vs_5_hard
346,7,10,f5v0to1to2t05_e2_ckpt291,3,hard_bots,5_vs_5_hard
347,6,8,f5v0to1to2t05_e2_ckpt291,2,hard_bots,5_vs_5_hard
348,0,3,f5v0to1to2t05_e2_ckpt291,3,f5v0to1to2t05_e2_ckpt291,5_vs_5
349,-3,2,f5v0to1to2t05_e2_ckpt291,5,f5v0to1to2t05_e2_ckpt291,5_vs_5
350,-3,0,f5v0to1to2t05_e2_ckpt291,3,f5v0to1to2t05_e2_ckpt291,5_vs_5
351,-2,3,f5v0to1to2t05_e2_ckpt291,5,f5v0to1to5_e2_ckpt252,5_vs_5
352,3,5,f5v0to1to2t05_e2_ckpt291,2,f5v0to1to5_e2_ckpt252,5_vs_5
353,-4,3,f5v0to1to2t05_e2_ckpt291,7,f5v0to1to5_e2_ckpt252,5_vs_5
354,2,2,f5v0to1to2t05_e2_ckpt291,0,scon_e3_p2_hard_ckpt840,5_vs_5
355,6,7,f5v0to1to2t05_e2_ckpt291,1,scon_e3_p2_hard_ckpt840,5_vs_5
356,5,5,f5v0to1to2t05_e2_ckpt291,0,scon_e3_p2_hard_ckpt840,5_vs_5
357,10,10,f5v0to1to2t05_e2_ckpt291,0,less_then_partially_randomized_checkpoints_bots_4_heads_38_ckpt108,5_vs_5
358,5,7,f5v0to1to2t05_e2_ckpt291,2,less_then_partially_randomized_checkpoints_bots_4_heads_38_ckpt108,5_vs_5
359,4,6,f5v0to1to2t05_e2_ckpt291,2,less_then_partially_randomized_checkpoints_bots_4_heads_38_ckpt108,5_vs_5
360,1,4,f5v0to1to2t05_e2_ckpt291,3,less_then_partially_randomized_entropy_checkpoints_bots_4_heads_39_ckpt109,5_vs_5
361,1,4,f5v0to1to2t05_e2_ckpt291,3,less_then_partially_randomized_entropy_checkpoints_bots_4_heads_39_ckpt109,5_vs_5
362,3,5,f5v0to1to2t05_e2_ckpt291,2,less_then_partially_randomized_entropy_checkpoints_bots_4_heads_39_ckpt109,5_vs_5
363,4,5,f5v0to1to2t05_e2_ckpt291,1,reward_shaping_checkpoints_bots_4_heads_1_ckpt360,5_vs_5
364,1,3,f5v0to1to2t05_e2_ckpt291,2,reward_shaping_checkpoints_bots_4_heads_1_ckpt360,5_vs_5
365,0,4,f5v0to1to2t05_e2_ckpt291,4,reward_shaping_checkpoints_bots_4_heads_1_ckpt360,5_vs_5
366,-4,3,f5v0to1to2t05_e2_ckpt291,7,checkpoints_selfplay_e9_sp_ckpt274,5_vs_5
367,-8,1,f5v0to1to2t05_e2_ckpt291,9,checkpoints_selfplay_e9_sp_ckpt274,5_vs_5
368,-9,1,f5v0to1to2t05_e2_ckpt291,10,checkpoints_selfplay_e9_sp_ckpt274,5_vs_5
369,-6,2,f5v0to1to2t05_e2_ckpt291,8,checkpoints_sp_c_nb_e2_ckpt667,5_vs_5
370,-9,1,f5v0to1to2t05_e2_ckpt291,10,checkpoints_sp_c_nb_e2_ckpt667,5_vs_5
371,-7,1,f5v0to1to2t05_e2_ckpt291,8,checkpoints_sp_c_nb_e2_ckpt667,5_vs_5
372,-2,1,f5v0to1to2t05_e2_ckpt291,3,m_sp_arch_medium_heads_conv16_0_bt_32_r313_m335,5_vs_5
373,-1,3,f5v0to1to2t05_e2_ckpt291,4,m_sp_arch_medium_heads_conv16_0_bt_32_r313_m335,5_vs_5
374,-1,1,f5v0to1to2t05_e2_ckpt291,2,m_sp_arch_medium_heads_conv16_0_bt_32_r313_m335,5_vs_5
375,-4,3,f5v0to1to2t05_e2_ckpt291,7,m_sp_arch_longer_heads_bt_32_r201_m335,5_vs_5
376,-6,0,f5v0to1to2t05_e2_ckpt291,6,m_sp_arch_longer_heads_bt_32_r201_m335,5_vs_5
377,-7,3,f5v0to1to2t05_e2_ckpt291,10,m_sp_arch_longer_heads_bt_32_r201_m335,5_vs_5
378,-8,3,f5v0to1to2t05_e2_ckpt291,11,m_sp_arch_medium_heads_bt_32_r201_m335,5_vs_5
379,-4,1,f5v0to1to2t05_e2_ckpt291,5,m_sp_arch_medium_heads_bt_32_r201_m335,5_vs_5
380,0,6,f5v0to1to2t05_e2_ckpt291,6,m_sp_arch_medium_heads_bt_32_r201_m335,5_vs_5
381,-7,0,f5v0to1to2t05_e2_ckpt291,7,m_sp_arch_4x1_bt_32_r201_m335,5_vs_5
382,-12,0,f5v0to1to2t05_e2_ckpt291,12,m_sp_arch_4x1_bt_32_r201_m335,5_vs_5
383,-7,1,f5v0to1to2t05_e2_ckpt291,8,m_sp_arch_4x1_bt_32_r201_m335,5_vs_5
384,-10,1,f5v0to1to2t05_e2_ckpt291,11,m_sp_arch_4x1_bt_32_r201_cont3_m650,5_vs_5
385,-12,0,f5v0to1to2t05_e2_ckpt291,12,m_sp_arch_4x1_bt_32_r201_cont3_m650,5_vs_5
386,-9,0,f5v0to1to2t05_e2_ckpt291,9,m_sp_arch_4x1_bt_32_r201_cont3_m650,5_vs_5
387,-1,1,f5v0to1to2t05_e2_ckpt291,2,explt_v0_7_2_m54,5_vs_5
388,0,0,f5v0to1to2t05_e2_ckpt291,0,explt_v0_7_2_m54,5_vs_5
389,-1,1,f5v0to1to2t05_e2_ckpt291,2,explt_v0_7_2_m54,5_vs_5
390,-9,0,f5v0to1to2t05_e2_ckpt291,9,m_sp_sc3v3_arch_2x1_32_r500_cont4x1_m224,5_vs_5
391,-5,0,f5v0to1to2t05_e2_ckpt291,5,m_sp_sc3v3_arch_2x1_32_r500_cont4x1_m224,5_vs_5
392,-9,0,f5v0to1to2t05_e2_ckpt291,9,m_sp_sc3v3_arch_2x1_32_r500_cont4x1_m224,5_vs_5
393,-14,0,f5v0to1to2t05_e2_ckpt291,14,m_sp_arch_4x1_bt_32_roles_r500_m335,5_vs_5
394,-20,0,f5v0to1to2t05_e2_ckpt291,20,m_sp_arch_4x1_bt_32_roles_r500_m335,5_vs_5
395,-10,0,f5v0to1to2t05_e2_ckpt291,10,m_sp_arch_4x1_bt_32_roles_r500_m335,5_vs_5
396,14,14,reward_shaping_checkpoints_bots_4_heads_1_ckpt360,0,easy_bots,5_vs_5
397,9,9,reward_shaping_checkpoints_bots_4_heads_1_ckpt360,0,easy_bots,5_vs_5
398,9,10,reward_shaping_checkpoints_bots_4_heads_1_ckpt360,1,easy_bots,5_vs_5
399,5,8,reward_shaping_checkpoints_bots_4_heads_1_ckpt360,3,easy_bots,5_vs_5
400,5,6,reward_shaping_checkpoints_bots_4_heads_1_ckpt360,1,easy_bots,5_vs_5
401,7,8,reward_shaping_checkpoints_bots_4_heads_1_ckpt360,1,easy_bots,5_vs_5
402,8,9,reward_shaping_checkpoints_bots_4_heads_1_ckpt360,1,easy_bots,5_vs_5
403,11,11,reward_shaping_checkpoints_bots_4_heads_1_ckpt360,0,easy_bots,5_vs_5
404,7,8,reward_shaping_checkpoints_bots_4_heads_1_ckpt360,1,easy_bots,5_vs_5
405,6,7,reward_shaping_checkpoints_bots_4_heads_1_ckpt360,1,easy_bots,5_vs_5
406,3,5,reward_shaping_checkpoints_bots_4_heads_1_ckpt360,2,medium_bots,5_vs_5_medium
407,3,5,reward_shaping_checkpoints_bots_4_heads_1_ckpt360,2,medium_bots,5_vs_5_medium
408,7,9,reward_shaping_checkpoints_bots_4_heads_1_ckpt360,2,medium_bots,5_vs_5_medium
409,5,6,reward_shaping_checkpoints_bots_4_heads_1_ckpt360,1,medium_bots,5_vs_5_medium
410,6,6,reward_shaping_checkpoints_bots_4_heads_1_ckpt360,0,medium_bots,5_vs_5_medium
411,4,5,reward_shaping_checkpoints_bots_4_heads_1_ckpt360,1,medium_bots,5_vs_5_medium
412,2,5,reward_shaping_checkpoints_bots_4_heads_1_ckpt360,3,medium_bots,5_vs_5_medium
413,4,7,reward_shaping_checkpoints_bots_4_heads_1_ckpt360,3,medium_bots,5_vs_5_medium
414,3,4,reward_shaping_checkpoints_bots_4_heads_1_ckpt360,1,medium_bots,5_vs_5_medium
415,-2,1,reward_shaping_checkpoints_bots_4_heads_1_ckpt360,3,medium_bots,5_vs_5_medium
416,-1,0,reward_shaping_checkpoints_bots_4_heads_1_ckpt360,1,hard_bots,5_vs_5_hard
417,5,6,reward_shaping_checkpoints_bots_4_heads_1_ckpt360,1,hard_bots,5_vs_5_hard
418,0,4,reward_shaping_checkpoints_bots_4_heads_1_ckpt360,4,hard_bots,5_vs_5_hard
419,0,3,reward_shaping_checkpoints_bots_4_heads_1_ckpt360,3,hard_bots,5_vs_5_hard
420,-2,0,reward_shaping_checkpoints_bots_4_heads_1_ckpt360,2,hard_bots,5_vs_5_hard
421,6,7,reward_shaping_checkpoints_bots_4_heads_1_ckpt360,1,hard_bots,5_vs_5_hard
422,0,1,reward_shaping_checkpoints_bots_4_heads_1_ckpt360,1,hard_bots,5_vs_5_hard
423,3,5,reward_shaping_checkpoints_bots_4_heads_1_ckpt360,2,hard_bots,5_vs_5_hard
424,3,6,reward_shaping_checkpoints_bots_4_heads_1_ckpt360,3,hard_bots,5_vs_5_hard
425,4,4,reward_shaping_checkpoints_bots_4_heads_1_ckpt360,0,hard_bots,5_vs_5_hard
426,-4,1,reward_shaping_checkpoints_bots_4_heads_1_ckpt360,5,f5v0to1to2t05_e2_ckpt291,5_vs_5
427,-5,1,reward_shaping_checkpoints_bots_4_heads_1_ckpt360,6,f5v0to1to2t05_e2_ckpt291,5_vs_5
428,-3,2,reward_shaping_checkpoints_bots_4_heads_1_ckpt360,5,f5v0to1to2t05_e2_ckpt291,5_vs_5
429,-6,1,reward_shaping_checkpoints_bots_4_heads_1_ckpt360,7,f5v0to1to2t05_e2_ckpt291,5_vs_5
430,-3,3,reward_shaping_checkpoints_bots_4_heads_1_ckpt360,6,f5v0to1to2t05_e2_ckpt291,5_vs_5
431,-2,1,reward_shaping_checkpoints_bots_4_heads_1_ckpt360,3,f5v0to1to5_e2_ckpt252,5_vs_5
432,0,1,reward_shaping_checkpoints_bots_4_heads_1_ckpt360,1,f5v0to1to5_e2_ckpt252,5_vs_5
433,-2,4,reward_shaping_checkpoints_bots_4_heads_1_ckpt360,6,f5v0to1to5_e2_ckpt252,5_vs_5
434,3,7,reward_shaping_checkpoints_bots_4_heads_1_ckpt360,4,f5v0to1to5_e2_ckpt252,5_vs_5
435,0,2,reward_shaping_checkpoints_bots_4_heads_1_ckpt360,2,f5v0to1to5_e2_ckpt252,5_vs_5
436,1,2,reward_shaping_checkpoints_bots_4_heads_1_ckpt360,1,scon_e3_p2_hard_ckpt840,5_vs_5
437,-5,0,reward_shaping_checkpoints_bots_4_heads_1_ckpt360,5,scon_e3_p2_hard_ckpt840,5_vs_5
438,-3,0,reward_shaping_checkpoints_bots_4_heads_1_ckpt360,3,scon_e3_p2_hard_ckpt840,5_vs_5
439,0,2,reward_shaping_checkpoints_bots_4_heads_1_ckpt360,2,scon_e3_p2_hard_ckpt840,5_vs_5
440,-1,2,reward_shaping_checkpoints_bots_4_heads_1_ckpt360,3,scon_e3_p2_hard_ckpt840,5_vs_5
441,-1,5,reward_shaping_checkpoints_bots_4_heads_1_ckpt360,6,less_then_partially_randomized_checkpoints_bots_4_heads_38_ckpt108,5_vs_5
442,-3,4,reward_shaping_checkpoints_bots_4_heads_1_ckpt360,7,less_then_partially_randomized_checkpoints_bots_4_heads_38_ckpt108,5_vs_5
443,-3,0,reward_shaping_checkpoints_bots_4_heads_1_ckpt360,3,less_then_partially_randomized_checkpoints_bots_4_heads_38_ckpt108,5_vs_5
444,-1,2,reward_shaping_checkpoints_bots_4_heads_1_ckpt360,3,less_then_partially_randomized_checkpoints_bots_4_heads_38_ckpt108,5_vs_5
445,2,5,reward_shaping_checkpoints_bots_4_heads_1_ckpt360,3,less_then_partially_randomized_checkpoints_bots_4_heads_38_ckpt108,5_vs_5
446,-1,5,reward_shaping_checkpoints_bots_4_heads_1_ckpt360,6,less_then_partially_randomized_entropy_checkpoints_bots_4_heads_39_ckpt109,5_vs_5
447,0,3,reward_shaping_checkpoints_bots_4_heads_1_ckpt360,3,less_then_partially_randomized_entropy_checkpoints_bots_4_heads_39_ckpt109,5_vs_5
448,-3,2,reward_shaping_checkpoints_bots_4_heads_1_ckpt360,5,less_then_partially_randomized_entropy_checkpoints_bots_4_heads_39_ckpt109,5_vs_5
449,-4,3,reward_shaping_checkpoints_bots_4_heads_1_ckpt360,7,less_then_partially_randomized_entropy_checkpoints_bots_4_heads_39_ckpt109,5_vs_5
450,0,3,reward_shaping_checkpoints_bots_4_heads_1_ckpt360,3,less_then_partially_randomized_entropy_checkpoints_bots_4_heads_39_ckpt109,5_vs_5
451,1,5,reward_shaping_checkpoints_bots_4_heads_1_ckpt360,4,reward_shaping_checkpoints_bots_4_heads_1_ckpt360,5_vs_5
452,1,4,reward_shaping_checkpoints_bots_4_heads_1_ckpt360,3,reward_shaping_checkpoints_bots_4_heads_1_ckpt360,5_vs_5
453,2,4,reward_shaping_checkpoints_bots_4_heads_1_ckpt360,2,reward_shaping_checkpoints_bots_4_heads_1_ckpt360,5_vs_5
454,1,4,reward_shaping_checkpoints_bots_4_heads_1_ckpt360,3,reward_shaping_checkpoints_bots_4_heads_1_ckpt360,5_vs_5
455,-1,1,reward_shaping_checkpoints_bots_4_heads_1_ckpt360,2,reward_shaping_checkpoints_bots_4_heads_1_ckpt360,5_vs_5
456,-9,0,reward_shaping_checkpoints_bots_4_heads_1_ckpt360,9,checkpoints_selfplay_e9_sp_ckpt274,5_vs_5
457,-8,4,reward_shaping_checkpoints_bots_4_heads_1_ckpt360,12,checkpoints_selfplay_e9_sp_ckpt274,5_vs_5
458,-8,0,reward_shaping_checkpoints_bots_4_heads_1_ckpt360,8,checkpoints_selfplay_e9_sp_ckpt274,5_vs_5
459,-9,2,reward_shaping_checkpoints_bots_4_heads_1_ckpt360,11,checkpoints_selfplay_e9_sp_ckpt274,5_vs_5
460,-9,1,reward_shaping_checkpoints_bots_4_heads_1_ckpt360,10,checkpoints_selfplay_e9_sp_ckpt274,5_vs_5
461,-2,2,reward_shaping_checkpoints_bots_4_heads_1_ckpt360,4,checkpoints_sp_c_nb_e2_ckpt667,5_vs_5
462,-4,1,reward_shaping_checkpoints_bots_4_heads_1_ckpt360,5,checkpoints_sp_c_nb_e2_ckpt667,5_vs_5
463,-4,1,reward_shaping_checkpoints_bots_4_heads_1_ckpt360,5,checkpoints_sp_c_nb_e2_ckpt667,5_vs_5
464,-8,1,reward_shaping_checkpoints_bots_4_heads_1_ckpt360,9,checkpoints_sp_c_nb_e2_ckpt667,5_vs_5
465,-8,0,reward_shaping_checkpoints_bots_4_heads_1_ckpt360,8,checkpoints_sp_c_nb_e2_ckpt667,5_vs_5
466,1,2,reward_shaping_checkpoints_bots_4_heads_1_ckpt360,1,m_sp_arch_medium_heads_conv16_0_bt_32_r313_m335,5_vs_5
467,-2,2,reward_shaping_checkpoints_bots_4_heads_1_ckpt360,4,m_sp_arch_medium_heads_conv16_0_bt_32_r313_m335,5_vs_5
468,-4,2,reward_shaping_checkpoints_bots_4_heads_1_ckpt360,6,m_sp_arch_medium_heads_conv16_0_bt_32_r313_m335,5_vs_5
469,-2,1,reward_shaping_checkpoints_bots_4_heads_1_ckpt360,3,m_sp_arch_medium_heads_conv16_0_bt_32_r313_m335,5_vs_5
470,-3,0,reward_shaping_checkpoints_bots_4_heads_1_ckpt360,3,m_sp_arch_medium_heads_conv16_0_bt_32_r313_m335,5_vs_5
471,-7,1,reward_shaping_checkpoints_bots_4_heads_1_ckpt360,8,m_sp_arch_longer_heads_bt_32_r201_m335,5_vs_5
472,-6,0,reward_shaping_checkpoints_bots_4_heads_1_ckpt360,6,m_sp_arch_longer_heads_bt_32_r201_m335,5_vs_5
473,-7,0,reward_shaping_checkpoints_bots_4_heads_1_ckpt360,7,m_sp_arch_longer_heads_bt_32_r201_m335,5_vs_5
474,-4,0,reward_shaping_checkpoints_bots_4_heads_1_ckpt360,4,m_sp_arch_longer_heads_bt_32_r201_m335,5_vs_5
475,-4,0,reward_shaping_checkpoints_bots_4_heads_1_ckpt360,4,m_sp_arch_longer_heads_bt_32_r201_m335,5_vs_5
476,-9,1,reward_shaping_checkpoints_bots_4_heads_1_ckpt360,10,m_sp_arch_medium_heads_bt_32_r201_m335,5_vs_5
477,-3,1,reward_shaping_checkpoints_bots_4_heads_1_ckpt360,4,m_sp_arch_medium_heads_bt_32_r201_m335,5_vs_5
478,-5,1,reward_shaping_checkpoints_bots_4_heads_1_ckpt360,6,m_sp_arch_medium_heads_bt_32_r201_m335,5_vs_5
479,-1,2,reward_shaping_checkpoints_bots_4_heads_1_ckpt360,3,m_sp_arch_medium_heads_bt_32_r201_m335,5_vs_5
480,-7,2,reward_shaping_checkpoints_bots_4_heads_1_ckpt360,9,m_sp_arch_medium_heads_bt_32_r201_m335,5_vs_5
481,-13,0,reward_shaping_checkpoints_bots_4_heads_1_ckpt360,13,m_sp_arch_4x1_bt_32_r201_m335,5_vs_5
482,-7,0,reward_shaping_checkpoints_bots_4_heads_1_ckpt360,7,m_sp_arch_4x1_bt_32_r201_m335,5_vs_5
483,-10,0,reward_shaping_checkpoints_bots_4_heads_1_ckpt360,10,m_sp_arch_4x1_bt_32_r201_m335,5_vs_5
484,-15,1,reward_shaping_checkpoints_bots_4_heads_1_ckpt360,16,m_sp_arch_4x1_bt_32_r201_m335,5_vs_5
485,-10,1,reward_shaping_checkpoints_bots_4_heads_1_ckpt360,11,m_sp_arch_4x1_bt_32_r201_m335,5_vs_5
486,-10,0,reward_shaping_checkpoints_bots_4_heads_1_ckpt360,10,m_sp_arch_4x1_bt_32_r201_cont3_m650,5_vs_5
487,-10,0,reward_shaping_checkpoints_bots_4_heads_1_ckpt360,10,m_sp_arch_4x1_bt_32_r201_cont3_m650,5_vs_5
488,-8,1,reward_shaping_checkpoints_bots_4_heads_1_ckpt360,9,m_sp_arch_4x1_bt_32_r201_cont3_m650,5_vs_5
489,-14,0,reward_shaping_checkpoints_bots_4_heads_1_ckpt360,14,m_sp_arch_4x1_bt_32_r201_cont3_m650,5_vs_5
490,-11,0,reward_shaping_checkpoints_bots_4_heads_1_ckpt360,11,m_sp_arch_4x1_bt_32_r201_cont3_m650,5_vs_5
491,-1,0,reward_shaping_checkpoints_bots_4_heads_1_ckpt360,1,explt_v0_7_2_m54,5_vs_5
492,-2,0,reward_shaping_checkpoints_bots_4_heads_1_ckpt360,2,explt_v0_7_2_m54,5_vs_5
493,-1,1,reward_shaping_checkpoints_bots_4_heads_1_ckpt360,2,explt_v0_7_2_m54,5_vs_5
494,-1,1,reward_shaping_checkpoints_bots_4_heads_1_ckpt360,2,explt_v0_7_2_m54,5_vs_5
495,-1,1,reward_shaping_checkpoints_bots_4_heads_1_ckpt360,2,explt_v0_7_2_m54,5_vs_5
496,-8,0,reward_shaping_checkpoints_bots_4_heads_1_ckpt360,8,m_sp_sc3v3_arch_2x1_32_r500_cont4x1_m224,5_vs_5
497,-11,0,reward_shaping_checkpoints_bots_4_heads_1_ckpt360,11,m_sp_sc3v3_arch_2x1_32_r500_cont4x1_m224,5_vs_5
498,-13,0,reward_shaping_checkpoints_bots_4_heads_1_ckpt360,13,m_sp_sc3v3_arch_2x1_32_r500_cont4x1_m224,5_vs_5
499,-13,1,reward_shaping_checkpoints_bots_4_heads_1_ckpt360,14,m_sp_sc3v3_arch_2x1_32_r500_cont4x1_m224,5_vs_5
500,-13,0,reward_shaping_checkpoints_bots_4_heads_1_ckpt360,13,m_sp_sc3v3_arch_2x1_32_r500_cont4x1_m224,5_vs_5
501,-7,0,reward_shaping_checkpoints_bots_4_heads_1_ckpt360,7,m_sp_arch_4x1_bt_32_roles_r500_m335,5_vs_5
502,-11,1,reward_shaping_checkpoints_bots_4_heads_1_ckpt360,12,m_sp_arch_4x1_bt_32_roles_r500_m335,5_vs_5
503,-12,0,reward_shaping_checkpoints_bots_4_heads_1_ckpt360,12,m_sp_arch_4x1_bt_32_roles_r500_m335,5_vs_5
504,-12,0,reward_shaping_checkpoints_bots_4_heads_1_ckpt360,12,m_sp_arch_4x1_bt_32_roles_r500_m335,5_vs_5
505,-11,0,reward_shaping_checkpoints_bots_4_heads_1_ckpt360,11,m_sp_arch_4x1_bt_32_roles_r500_m335,5_vs_5
506,11,11,less_then_partially_randomized_checkpoints_bots_4_heads_38_ckpt108,0,easy_bots,5_vs_5
507,2,3,less_then_partially_randomized_checkpoints_bots_4_heads_38_ckpt108,1,easy_bots,5_vs_5
508,9,10,less_then_partially_randomized_checkpoints_bots_4_heads_38_ckpt108,1,easy_bots,5_vs_5
509,8,9,less_then_partially_randomized_checkpoints_bots_4_heads_38_ckpt108,1,easy_bots,5_vs_5
510,7,7,less_then_partially_randomized_checkpoints_bots_4_heads_38_ckpt108,0,medium_bots,5_vs_5_medium
511,7,9,less_then_partially_randomized_checkpoints_bots_4_heads_38_ckpt108,2,medium_bots,5_vs_5_medium
512,9,9,less_then_partially_randomized_checkpoints_bots_4_heads_38_ckpt108,0,medium_bots,5_vs_5_medium
513,3,6,less_then_partially_randomized_checkpoints_bots_4_heads_38_ckpt108,3,medium_bots,5_vs_5_medium
514,5,8,less_then_partially_randomized_checkpoints_bots_4_heads_38_ckpt108,3,hard_bots,5_vs_5_hard
515,3,4,less_then_partially_randomized_checkpoints_bots_4_heads_38_ckpt108,1,hard_bots,5_vs_5_hard
516,7,10,less_then_partially_randomized_checkpoints_bots_4_heads_38_ckpt108,3,hard_bots,5_vs_5_hard
517,9,10,less_then_partially_randomized_checkpoints_bots_4_heads_38_ckpt108,1,hard_bots,5_vs_5_hard
518,0,3,less_then_partially_randomized_checkpoints_bots_4_heads_38_ckpt108,3,f5v0to1to2t05_e2_ckpt291,5_vs_5
519,1,3,less_then_partially_randomized_checkpoints_bots_4_heads_38_ckpt108,2,f5v0to1to2t05_e2_ckpt291,5_vs_5
520,0,3,less_then_partially_randomized_checkpoints_bots_4_heads_38_ckpt108,3,f5v0to1to5_e2_ckpt252,5_vs_5
521,-1,3,less_then_partially_randomized_checkpoints_bots_4_heads_38_ckpt108,4,f5v0to1to5_e2_ckpt252,5_vs_5
522,0,1,less_then_partially_randomized_checkpoints_bots_4_heads_38_ckpt108,1,scon_e3_p2_hard_ckpt840,5_vs_5
523,-1,4,less_then_partially_randomized_checkpoints_bots_4_heads_38_ckpt108,5,scon_e3_p2_hard_ckpt840,5_vs_5
524,-2,3,less_then_partially_randomized_checkpoints_bots_4_heads_38_ckpt108,5,less_then_partially_randomized_checkpoints_bots_4_heads_38_ckpt108,5_vs_5
525,-5,1,less_then_partially_randomized_checkpoints_bots_4_heads_38_ckpt108,6,less_then_partially_randomized_checkpoints_bots_4_heads_38_ckpt108,5_vs_5
526,-1,3,less_then_partially_randomized_checkpoints_bots_4_heads_38_ckpt108,4,less_then_partially_randomized_entropy_checkpoints_bots_4_heads_39_ckpt109,5_vs_5
527,-1,4,less_then_partially_randomized_checkpoints_bots_4_heads_38_ckpt108,5,less_then_partially_randomized_entropy_checkpoints_bots_4_heads_39_ckpt109,5_vs_5
528,1,4,less_then_partially_randomized_checkpoints_bots_4_heads_38_ckpt108,3,reward_shaping_checkpoints_bots_4_heads_1_ckpt360,5_vs_5
529,3,6,less_then_partially_randomized_checkpoints_bots_4_heads_38_ckpt108,3,reward_shaping_checkpoints_bots_4_heads_1_ckpt360,5_vs_5
530,-11,2,less_then_partially_randomized_checkpoints_bots_4_heads_38_ckpt108,13,checkpoints_selfplay_e9_sp_ckpt274,5_vs_5
531,-7,2,less_then_partially_randomized_checkpoints_bots_4_heads_38_ckpt108,9,checkpoints_selfplay_e9_sp_ckpt274,5_vs_5
532,-8,1,less_then_partially_randomized_checkpoints_bots_4_heads_38_ckpt108,9,checkpoints_sp_c_nb_e2_ckpt667,5_vs_5
533,-8,0,less_then_partially_randomized_checkpoints_bots_4_heads_38_ckpt108,8,checkpoints_sp_c_nb_e2_ckpt667,5_vs_5
534,-1,2,less_then_partially_randomized_checkpoints_bots_4_heads_38_ckpt108,3,m_sp_arch_medium_heads_conv16_0_bt_32_r313_m335,5_vs_5
535,-3,2,less_then_partially_randomized_checkpoints_bots_4_heads_38_ckpt108,5,m_sp_arch_medium_heads_conv16_0_bt_32_r313_m335,5_vs_5
536,-3,0,less_then_partially_randomized_checkpoints_bots_4_heads_38_ckpt108,3,m_sp_arch_longer_heads_bt_32_r201_m335,5_vs_5
537,-4,0,less_then_partially_randomized_checkpoints_bots_4_heads_38_ckpt108,4,m_sp_arch_longer_heads_bt_32_r201_m335,5_vs_5
538,-6,2,less_then_partially_randomized_checkpoints_bots_4_heads_38_ckpt108,8,m_sp_arch_medium_heads_bt_32_r201_m335,5_vs_5
539,-8,1,less_then_partially_randomized_checkpoints_bots_4_heads_38_ckpt108,9,m_sp_arch_medium_heads_bt_32_r201_m335,5_vs_5
540,-8,0,less_then_partially_randomized_checkpoints_bots_4_heads_38_ckpt108,8,m_sp_arch_4x1_bt_32_r201_m335,5_vs_5
541,-9,0,less_then_partially_randomized_checkpoints_bots_4_heads_38_ckpt108,9,m_sp_arch_4x1_bt_32_r201_m335,5_vs_5
542,-6,1,less_then_partially_randomized_checkpoints_bots_4_heads_38_ckpt108,7,m_sp_arch_4x1_bt_32_r201_cont3_m650,5_vs_5
543,-8,0,less_then_partially_randomized_checkpoints_bots_4_heads_38_ckpt108,8,m_sp_arch_4x1_bt_32_r201_cont3_m650,5_vs_5
544,0,0,less_then_partially_randomized_checkpoints_bots_4_heads_38_ckpt108,0,explt_v0_7_2_m54,5_vs_5
545,-3,0,less_then_partially_randomized_checkpoints_bots_4_heads_38_ckpt108,3,explt_v0_7_2_m54,5_vs_5
546,-17,0,less_then_partially_randomized_checkpoints_bots_4_heads_38_ckpt108,17,m_sp_sc3v3_arch_2x1_32_r500_cont4x1_m224,5_vs_5
547,-14,0,less_then_partially_randomized_checkpoints_bots_4_heads_38_ckpt108,14,m_sp_sc3v3_arch_2x1_32_r500_cont4x1_m224,5_vs_5
548,-9,0,less_then_partially_randomized_checkpoints_bots_4_heads_38_ckpt108,9,m_sp_arch_4x1_bt_32_roles_r500_m335,5_vs_5
549,-7,0,less_then_partially_randomized_checkpoints_bots_4_heads_38_ckpt108,7,m_sp_arch_4x1_bt_32_roles_r500_m335,5_vs_5
550,11,14,scon_e3_p2_hard_ckpt840,3,easy_bots,5_vs_5
551,5,5,scon_e3_p2_hard_ckpt840,0,easy_bots,5_vs_5
552,13,14,scon_e3_p2_hard_ckpt840,1,easy_bots,5_vs_5
553,7,8,scon_e3_p2_hard_ckpt840,1,easy_bots,5_vs_5
554,14,14,scon_e3_p2_hard_ckpt840,0,easy_bots,5_vs_5
555,6,8,scon_e3_p2_hard_ckpt840,2,easy_bots,5_vs_5
556,10,11,scon_e3_p2_hard_ckpt840,1,medium_bots,5_vs_5_medium
557,7,9,scon_e3_p2_hard_ckpt840,2,medium_bots,5_vs_5_medium
558,3,5,scon_e3_p2_hard_ckpt840,2,medium_bots,5_vs_5_medium
559,14,14,scon_e3_p2_hard_ckpt840,0,medium_bots,5_vs_5_medium
560,3,8,scon_e3_p2_hard_ckpt840,5,medium_bots,5_vs_5_medium
561,7,9,scon_e3_p2_hard_ckpt840,2,medium_bots,5_vs_5_medium
562,9,9,scon_e3_p2_hard_ckpt840,0,hard_bots,5_vs_5_hard
563,4,7,scon_e3_p2_hard_ckpt840,3,hard_bots,5_vs_5_hard
564,7,7,scon_e3_p2_hard_ckpt840,0,hard_bots,5_vs_5_hard
565,6,8,scon_e3_p2_hard_ckpt840,2,hard_bots,5_vs_5_hard
566,14,14,scon_e3_p2_hard_ckpt840,0,hard_bots,5_vs_5_hard
567,8,8,scon_e3_p2_hard_ckpt840,0,hard_bots,5_vs_5_hard
568,-7,1,scon_e3_p2_hard_ckpt840,8,f5v0to1to2t05_e2_ckpt291,5_vs_5
569,3,5,scon_e3_p2_hard_ckpt840,2,f5v0to1to2t05_e2_ckpt291,5_vs_5
570,-5,1,scon_e3_p2_hard_ckpt840,6,f5v0to1to2t05_e2_ckpt291,5_vs_5
571,0,3,scon_e3_p2_hard_ckpt840,3,f5v0to1to5_e2_ckpt252,5_vs_5
572,-4,3,scon_e3_p2_hard_ckpt840,7,f5v0to1to5_e2_ckpt252,5_vs_5
573,-1,2,scon_e3_p2_hard_ckpt840,3,f5v0to1to5_e2_ckpt252,5_vs_5
574,-2,1,scon_e3_p2_hard_ckpt840,3,scon_e3_p2_hard_ckpt840,5_vs_5
575,-3,2,scon_e3_p2_hard_ckpt840,5,scon_e3_p2_hard_ckpt840,5_vs_5
576,1,2,scon_e3_p2_hard_ckpt840,1,scon_e3_p2_hard_ckpt840,5_vs_5
577,0,2,scon_e3_p2_hard_ckpt840,2,less_then_partially_randomized_checkpoints_bots_4_heads_38_ckpt108,5_vs_5
578,-1,0,scon_e3_p2_hard_ckpt840,1,less_then_partially_randomized_checkpoints_bots_4_heads_38_ckpt108,5_vs_5
579,0,2,scon_e3_p2_hard_ckpt840,2,less_then_partially_randomized_checkpoints_bots_4_heads_38_ckpt108,5_vs_5
580,1,2,scon_e3_p2_hard_ckpt840,1,less_then_partially_randomized_entropy_checkpoints_bots_4_heads_39_ckpt109,5_vs_5
581,-5,1,scon_e3_p2_hard_ckpt840,6,less_then_partially_randomized_entropy_checkpoints_bots_4_heads_39_ckpt109,5_vs_5
582,2,5,scon_e3_p2_hard_ckpt840,3,less_then_partially_randomized_entropy_checkpoints_bots_4_heads_39_ckpt109,5_vs_5
583,-1,2,scon_e3_p2_hard_ckpt840,3,reward_shaping_checkpoints_bots_4_heads_1_ckpt360,5_vs_5
584,3,4,scon_e3_p2_hard_ckpt840,1,reward_shaping_checkpoints_bots_4_heads_1_ckpt360,5_vs_5
585,4,6,scon_e3_p2_hard_ckpt840,2,reward_shaping_checkpoints_bots_4_heads_1_ckpt360,5_vs_5
586,-5,1,scon_e3_p2_hard_ckpt840,6,checkpoints_selfplay_e9_sp_ckpt274,5_vs_5
587,-5,1,scon_e3_p2_hard_ckpt840,6,checkpoints_selfplay_e9_sp_ckpt274,5_vs_5
588,-13,0,scon_e3_p2_hard_ckpt840,13,checkpoints_selfplay_e9_sp_ckpt274,5_vs_5
589,-12,0,scon_e3_p2_hard_ckpt840,12,checkpoints_sp_c_nb_e2_ckpt667,5_vs_5
590,-6,0,scon_e3_p2_hard_ckpt840,6,checkpoints_sp_c_nb_e2_ckpt667,5_vs_5
591,-8,0,scon_e3_p2_hard_ckpt840,8,checkpoints_sp_c_nb_e2_ckpt667,5_vs_5
592,-6,0,scon_e3_p2_hard_ckpt840,6,m_sp_arch_medium_heads_conv16_0_bt_32_r313_m335,5_vs_5
593,-2,0,scon_e3_p2_hard_ckpt840,2,m_sp_arch_medium_heads_conv16_0_bt_32_r313_m335,5_vs_5
594,-1,0,scon_e3_p2_hard_ckpt840,1,m_sp_arch_medium_heads_conv16_0_bt_32_r313_m335,5_vs_5
595,-5,1,scon_e3_p2_hard_ckpt840,6,m_sp_arch_longer_heads_bt_32_r201_m335,5_vs_5
596,-3,1,scon_e3_p2_hard_ckpt840,4,m_sp_arch_longer_heads_bt_32_r201_m335,5_vs_5
597,-7,0,scon_e3_p2_hard_ckpt840,7,m_sp_arch_longer_heads_bt_32_r201_m335,5_vs_5
598,-4,2,scon_e3_p2_hard_ckpt840,6,m_sp_arch_medium_heads_bt_32_r201_m335,5_vs_5
599,-7,0,scon_e3_p2_hard_ckpt840,7,m_sp_arch_medium_heads_bt_32_r201_m335,5_vs_5
600,-9,1,scon_e3_p2_hard_ckpt840,10,m_sp_arch_medium_heads_bt_32_r201_m335,5_vs_5
601,-10,0,scon_e3_p2_hard_ckpt840,10,m_sp_arch_4x1_bt_32_r201_m335,5_vs_5
602,-12,0,scon_e3_p2_hard_ckpt840,12,m_sp_arch_4x1_bt_32_r201_m335,5_vs_5
603,-9,0,scon_e3_p2_hard_ckpt840,9,m_sp_arch_4x1_bt_32_r201_m335,5_vs_5
604,-12,0,scon_e3_p2_hard_ckpt840,12,m_sp_arch_4x1_bt_32_r201_cont3_m650,5_vs_5
605,-10,0,scon_e3_p2_hard_ckpt840,10,m_sp_arch_4x1_bt_32_r201_cont3_m650,5_vs_5
606,-10,0,scon_e3_p2_hard_ckpt840,10,m_sp_arch_4x1_bt_32_r201_cont3_m650,5_vs_5
607,-3,0,scon_e3_p2_hard_ckpt840,3,explt_v0_7_2_m54,5_vs_5
608,-2,2,scon_e3_p2_hard_ckpt840,4,explt_v0_7_2_m54,5_vs_5
609,-3,0,scon_e3_p2_hard_ckpt840,3,explt_v0_7_2_m54,5_vs_5
610,-12,0,scon_e3_p2_hard_ckpt840,12,m_sp_sc3v3_arch_2x1_32_r500_cont4x1_m224,5_vs_5
611,-15,0,scon_e3_p2_hard_ckpt840,15,m_sp_sc3v3_arch_2x1_32_r500_cont4x1_m224,5_vs_5
612,-13,0,scon_e3_p2_hard_ckpt840,13,m_sp_sc3v3_arch_2x1_32_r500_cont4x1_m224,5_vs_5
613,-6,0,scon_e3_p2_hard_ckpt840,6,m_sp_arch_4x1_bt_32_roles_r500_m335,5_vs_5
614,-9,0,scon_e3_p2_hard_ckpt840,9,m_sp_arch_4x1_bt_32_roles_r500_m335,5_vs_5
615,-12,0,scon_e3_p2_hard_ckpt840,12,m_sp_arch_4x1_bt_32_roles_r500_m335,5_vs_5
616,4,4,m_sp_arch_4x1_bt_32_roles_r500_m335,0,easy_bots,5_vs_5
617,0,1,m_sp_arch_4x1_bt_32_roles_r500_m335,1,easy_bots,5_vs_5
618,2,3,m_sp_arch_4x1_bt_32_roles_r500_m335,1,easy_bots,5_vs_5
619,3,3,m_sp_arch_4x1_bt_32_roles_r500_m335,0,easy_bots,5_vs_5
620,4,4,m_sp_arch_4x1_bt_32_roles_r500_m335,0,easy_bots,5_vs_5
621,1,2,m_sp_arch_4x1_bt_32_roles_r500_m335,1,easy_bots,5_vs_5
622,3,3,m_sp_arch_4x1_bt_32_roles_r500_m335,0,easy_bots,5_vs_5
623,-1,0,m_sp_arch_4x1_bt_32_roles_r500_m335,1,easy_bots,5_vs_5
624,1,1,m_sp_arch_4x1_bt_32_roles_r500_m335,0,easy_bots,5_vs_5
625,2,2,m_sp_arch_4x1_bt_32_roles_r500_m335,0,easy_bots,5_vs_5
626,1,2,m_sp_arch_4x1_bt_32_roles_r500_m335,1,medium_bots,5_vs_5_medium
627,1,1,m_sp_arch_4x1_bt_32_roles_r500_m335,0,medium_bots,5_vs_5_medium
628,2,2,m_sp_arch_4x1_bt_32_roles_r500_m335,0,medium_bots,5_vs_5_medium
629,1,2,m_sp_arch_4x1_bt_32_roles_r500_m335,1,medium_bots,5_vs_5_medium
630,0,2,m_sp_arch_4x1_bt_32_roles_r500_m335,2,medium_bots,5_vs_5_medium
631,0,1,m_sp_arch_4x1_bt_32_roles_r500_m335,1,medium_bots,5_vs_5_medium
632,1,1,m_sp_arch_4x1_bt_32_roles_r500_m335,0,medium_bots,5_vs_5_medium
633,1,2,m_sp_arch_4x1_bt_32_roles_r500_m335,1,medium_bots,5_vs_5_medium
634,4,4,m_sp_arch_4x1_bt_32_roles_r500_m335,0,medium_bots,5_vs_5_medium
635,0,1,m_sp_arch_4x1_bt_32_roles_r500_m335,1,medium_bots,5_vs_5_medium
636,-2,0,m_sp_arch_4x1_bt_32_roles_r500_m335,2,hard_bots,5_vs_5_hard
637,1,2,m_sp_arch_4x1_bt_32_roles_r500_m335,1,hard_bots,5_vs_5_hard
638,-1,1,m_sp_arch_4x1_bt_32_roles_r500_m335,2,hard_bots,5_vs_5_hard
639,2,2,m_sp_arch_4x1_bt_32_roles_r500_m335,0,hard_bots,5_vs_5_hard
640,-2,0,m_sp_arch_4x1_bt_32_roles_r500_m335,2,hard_bots,5_vs_5_hard
641,-1,2,m_sp_arch_4x1_bt_32_roles_r500_m335,3,hard_bots,5_vs_5_hard
642,0,1,m_sp_arch_4x1_bt_32_roles_r500_m335,1,hard_bots,5_vs_5_hard
643,-1,0,m_sp_arch_4x1_bt_32_roles_r500_m335,1,hard_bots,5_vs_5_hard
644,-1,0,m_sp_arch_4x1_bt_32_roles_r500_m335,1,hard_bots,5_vs_5_hard
645,1,1,m_sp_arch_4x1_bt_32_roles_r500_m335,0,hard_bots,5_vs_5_hard
646,10,11,m_sp_arch_4x1_bt_32_roles_r500_m335,1,f5v0to1to2t05_e2_ckpt291,5_vs_5
647,6,6,m_sp_arch_4x1_bt_32_roles_r500_m335,0,f5v0to1to2t05_e2_ckpt291,5_vs_5
648,11,13,m_sp_arch_4x1_bt_32_roles_r500_m335,2,f5v0to1to2t05_e2_ckpt291,5_vs_5
649,8,9,m_sp_arch_4x1_bt_32_roles_r500_m335,1,f5v0to1to2t05_e2_ckpt291,5_vs_5
650,10,10,m_sp_arch_4x1_bt_32_roles_r500_m335,0,f5v0to1to2t05_e2_ckpt291,5_vs_5
651,12,14,m_sp_arch_4x1_bt_32_roles_r500_m335,2,f5v0to1to5_e2_ckpt252,5_vs_5
652,8,9,m_sp_arch_4x1_bt_32_roles_r500_m335,1,f5v0to1to5_e2_ckpt252,5_vs_5
653,9,11,m_sp_arch_4x1_bt_32_roles_r500_m335,2,f5v0to1to5_e2_ckpt252,5_vs_5
654,9,9,m_sp_arch_4x1_bt_32_roles_r500_m335,0,f5v0to1to5_e2_ckpt252,5_vs_5
655,8,10,m_sp_arch_4x1_bt_32_roles_r500_m335,2,f5v0to1to5_e2_ckpt252,5_vs_5
656,11,11,m_sp_arch_4x1_bt_32_roles_r500_m335,0,scon_e3_p2_hard_ckpt840,5_vs_5
657,9,9,m_sp_arch_4x1_bt_32_roles_r500_m335,0,scon_e3_p2_hard_ckpt840,5_vs_5
658,16,16,m_sp_arch_4x1_bt_32_roles_r500_m335,0,scon_e3_p2_hard_ckpt840,5_vs_5
659,9,10,m_sp_arch_4x1_bt_32_roles_r500_m335,1,scon_e3_p2_hard_ckpt840,5_vs_5
660,12,12,m_sp_arch_4x1_bt_32_roles_r500_m335,0,scon_e3_p2_hard_ckpt840,5_vs_5
661,13,14,m_sp_arch_4x1_bt_32_roles_r500_m335,1,less_then_partially_randomized_checkpoints_bots_4_heads_38_ckpt108,5_vs_5
662,10,11,m_sp_arch_4x1_bt_32_roles_r500_m335,1,less_then_partially_randomized_checkpoints_bots_4_heads_38_ckpt108,5_vs_5
663,10,10,m_sp_arch_4x1_bt_32_roles_r500_m335,0,less_then_partially_randomized_checkpoints_bots_4_heads_38_ckpt108,5_vs_5
664,15,15,m_sp_arch_4x1_bt_32_roles_r500_m335,0,less_then_partially_randomized_checkpoints_bots_4_heads_38_ckpt108,5_vs_5
665,11,12,m_sp_arch_4x1_bt_32_roles_r500_m335,1,less_then_partially_randomized_checkpoints_bots_4_heads_38_ckpt108,5_vs_5
666,7,7,m_sp_arch_4x1_bt_32_roles_r500_m335,0,less_then_partially_randomized_entropy_checkpoints_bots_4_heads_39_ckpt109,5_vs_5
667,14,14,m_sp_arch_4x1_bt_32_roles_r500_m335,0,less_then_partially_randomized_entropy_checkpoints_bots_4_heads_39_ckpt109,5_vs_5
668,13,13,m_sp_arch_4x1_bt_32_roles_r500_m335,0,less_then_partially_randomized_entropy_checkpoints_bots_4_heads_39_ckpt109,5_vs_5
669,15,15,m_sp_arch_4x1_bt_32_roles_r500_m335,0,less_then_partially_randomized_entropy_checkpoints_bots_4_heads_39_ckpt109,5_vs_5
670,14,14,m_sp_arch_4x1_bt_32_roles_r500_m335,0,less_then_partially_randomized_entropy_checkpoints_bots_4_heads_39_ckpt109,5_vs_5
671,15,15,m_sp_arch_4x1_bt_32_roles_r500_m335,0,reward_shaping_checkpoints_bots_4_heads_1_ckpt360,5_vs_5
672,11,11,m_sp_arch_4x1_bt_32_roles_r500_m335,0,reward_shaping_checkpoints_bots_4_heads_1_ckpt360,5_vs_5
673,14,14,m_sp_arch_4x1_bt_32_roles_r500_m335,0,reward_shaping_checkpoints_bots_4_heads_1_ckpt360,5_vs_5
674,10,10,m_sp_arch_4x1_bt_32_roles_r500_m335,0,reward_shaping_checkpoints_bots_4_heads_1_ckpt360,5_vs_5
675,13,13,m_sp_arch_4x1_bt_32_roles_r500_m335,0,reward_shaping_checkpoints_bots_4_heads_1_ckpt360,5_vs_5
676,3,4,m_sp_arch_4x1_bt_32_roles_r500_m335,1,checkpoints_selfplay_e9_sp_ckpt274,5_vs_5
677,3,4,m_sp_arch_4x1_bt_32_roles_r500_m335,1,checkpoints_selfplay_e9_sp_ckpt274,5_vs_5
678,6,6,m_sp_arch_4x1_bt_32_roles_r500_m335,0,checkpoints_selfplay_e9_sp_ckpt274,5_vs_5
679,5,6,m_sp_arch_4x1_bt_32_roles_r500_m335,1,checkpoints_selfplay_e9_sp_ckpt274,5_vs_5
680,7,10,m_sp_arch_4x1_bt_32_roles_r500_m335,3,checkpoints_selfplay_e9_sp_ckpt274,5_vs_5
681,-1,3,m_sp_arch_4x1_bt_32_roles_r500_m335,4,checkpoints_sp_c_nb_e2_ckpt667,5_vs_5
682,-1,3,m_sp_arch_4x1_bt_32_roles_r500_m335,4,checkpoints_sp_c_nb_e2_ckpt667,5_vs_5
683,6,6,m_sp_arch_4x1_bt_32_roles_r500_m335,0,checkpoints_sp_c_nb_e2_ckpt667,5_vs_5
684,0,1,m_sp_arch_4x1_bt_32_roles_r500_m335,1,checkpoints_sp_c_nb_e2_ckpt667,5_vs_5
685,2,4,m_sp_arch_4x1_bt_32_roles_r500_m335,2,checkpoints_sp_c_nb_e2_ckpt667,5_vs_5
686,1,3,m_sp_arch_4x1_bt_32_roles_r500_m335,2,m_sp_arch_medium_heads_conv16_0_bt_32_r313_m335,5_vs_5
687,7,8,m_sp_arch_4x1_bt_32_roles_r500_m335,1,m_sp_arch_medium_heads_conv16_0_bt_32_r313_m335,5_vs_5
688,5,6,m_sp_arch_4x1_bt_32_roles_r500_m335,1,m_sp_arch_medium_heads_conv16_0_bt_32_r313_m335,5_vs_5
689,6,8,m_sp_arch_4x1_bt_32_roles_r500_m335,2,m_sp_arch_medium_heads_conv16_0_bt_32_r313_m335,5_vs_5
690,6,8,m_sp_arch_4x1_bt_32_roles_r500_m335,2,m_sp_arch_medium_heads_conv16_0_bt_32_r313_m335,5_vs_5
691,7,8,m_sp_arch_4x1_bt_32_roles_r500_m335,1,m_sp_arch_longer_heads_bt_32_r201_m335,5_vs_5
692,4,6,m_sp_arch_4x1_bt_32_roles_r500_m335,2,m_sp_arch_longer_heads_bt_32_r201_m335,5_vs_5
693,3,6,m_sp_arch_4x1_bt_32_roles_r500_m335,3,m_sp_arch_longer_heads_bt_32_r201_m335,5_vs_5
694,5,6,m_sp_arch_4x1_bt_32_roles_r500_m335,1,m_sp_arch_longer_heads_bt_32_r201_m335,5_vs_5
695,5,6,m_sp_arch_4x1_bt_32_roles_r500_m335,1,m_sp_arch_longer_heads_bt_32_r201_m335,5_vs_5
696,6,7,m_sp_arch_4x1_bt_32_roles_r500_m335,1,m_sp_arch_medium_heads_bt_32_r201_m335,5_vs_5
697,6,6,m_sp_arch_4x1_bt_32_roles_r500_m335,0,m_sp_arch_medium_heads_bt_32_r201_m335,5_vs_5
698,6,6,m_sp_arch_4x1_bt_32_roles_r500_m335,0,m_sp_arch_medium_heads_bt_32_r201_m335,5_vs_5
699,8,8,m_sp_arch_4x1_bt_32_roles_r500_m335,0,m_sp_arch_medium_heads_bt_32_r201_m335,5_vs_5
700,8,8,m_sp_arch_4x1_bt_32_roles_r500_m335,0,m_sp_arch_medium_heads_bt_32_r201_m335,5_vs_5
701,-1,2,m_sp_arch_4x1_bt_32_roles_r500_m335,3,m_sp_arch_4x1_bt_32_r201_m335,5_vs_5
702,0,0,m_sp_arch_4x1_bt_32_roles_r500_m335,0,m_sp_arch_4x1_bt_32_r201_m335,5_vs_5
703,-3,1,m_sp_arch_4x1_bt_32_roles_r500_m335,4,m_sp_arch_4x1_bt_32_r201_m335,5_vs_5
704,2,2,m_sp_arch_4x1_bt_32_roles_r500_m335,0,m_sp_arch_4x1_bt_32_r201_m335,5_vs_5
705,-2,0,m_sp_arch_4x1_bt_32_roles_r500_m335,2,m_sp_arch_4x1_bt_32_r201_m335,5_vs_5
706,0,1,m_sp_arch_4x1_bt_32_roles_r500_m335,1,m_sp_arch_4x1_bt_32_r201_cont3_m650,5_vs_5
707,1,3,m_sp_arch_4x1_bt_32_roles_r500_m335,2,m_sp_arch_4x1_bt_32_r201_cont3_m650,5_vs_5
708,2,4,m_sp_arch_4x1_bt_32_roles_r500_m335,2,m_sp_arch_4x1_bt_32_r201_cont3_m650,5_vs_5
709,1,1,m_sp_arch_4x1_bt_32_roles_r500_m335,0,m_sp_arch_4x1_bt_32_r201_cont3_m650,5_vs_5
710,0,2,m_sp_arch_4x1_bt_32_roles_r500_m335,2,m_sp_arch_4x1_bt_32_r201_cont3_m650,5_vs_5
711,-3,0,m_sp_arch_4x1_bt_32_roles_r500_m335,3,explt_v0_7_2_m54,5_vs_5
712,-1,0,m_sp_arch_4x1_bt_32_roles_r500_m335,1,explt_v0_7_2_m54,5_vs_5
713,1,3,m_sp_arch_4x1_bt_32_roles_r500_m335,2,explt_v0_7_2_m54,5_vs_5
714,2,3,m_sp_arch_4x1_bt_32_roles_r500_m335,1,explt_v0_7_2_m54,5_vs_5
715,-1,1,m_sp_arch_4x1_bt_32_roles_r500_m335,2,explt_v0_7_2_m54,5_vs_5
716,5,5,m_sp_arch_4x1_bt_32_roles_r500_m335,0,m_sp_sc3v3_arch_2x1_32_r500_cont4x1_m224,5_vs_5
717,3,5,m_sp_arch_4x1_bt_32_roles_r500_m335,2,m_sp_sc3v3_arch_2x1_32_r500_cont4x1_m224,5_vs_5
718,3,4,m_sp_arch_4x1_bt_32_roles_r500_m335,1,m_sp_sc3v3_arch_2x1_32_r500_cont4x1_m224,5_vs_5
719,6,6,m_sp_arch_4x1_bt_32_roles_r500_m335,0,m_sp_sc3v3_arch_2x1_32_r500_cont4x1_m224,5_vs_5
720,1,2,m_sp_arch_4x1_bt_32_roles_r500_m335,1,m_sp_sc3v3_arch_2x1_32_r500_cont4x1_m224,5_vs_5
721,1,4,m_sp_arch_4x1_bt_32_roles_r500_m335,3,m_sp_arch_4x1_bt_32_roles_r500_m335,5_vs_5
722,0,1,m_sp_arch_4x1_bt_32_roles_r500_m335,1,m_sp_arch_4x1_bt_32_roles_r500_m335,5_vs_5
723,3,4,m_sp_arch_4x1_bt_32_roles_r500_m335,1,m_sp_arch_4x1_bt_32_roles_r500_m335,5_vs_5
724,-2,1,m_sp_arch_4x1_bt_32_roles_r500_m335,3,m_sp_arch_4x1_bt_32_roles_r500_m335,5_vs_5
725,0,3,m_sp_arch_4x1_bt_32_roles_r500_m335,3,m_sp_arch_4x1_bt_32_roles_r500_m335,5_vs_5
726,1,1,m_sp_arch_4x1_bt_32_r201_cont3_m650,0,easy_bots,5_vs_5
727,1,1,m_sp_arch_4x1_bt_32_r201_cont3_m650,0,easy_bots,5_vs_5
728,-1,1,m_sp_arch_4x1_bt_32_r201_cont3_m650,2,easy_bots,5_vs_5
729,1,1,m_sp_arch_4x1_bt_32_r201_cont3_m650,0,easy_bots,5_vs_5
730,0,0,m_sp_arch_4x1_bt_32_r201_cont3_m650,0,easy_bots,5_vs_5
731,2,2,m_sp_arch_4x1_bt_32_r201_cont3_m650,0,easy_bots,5_vs_5
732,-3,0,m_sp_arch_4x1_bt_32_r201_cont3_m650,3,medium_bots,5_vs_5_medium
733,0,1,m_sp_arch_4x1_bt_32_r201_cont3_m650,1,medium_bots,5_vs_5_medium
734,0,2,m_sp_arch_4x1_bt_32_r201_cont3_m650,2,medium_bots,5_vs_5_medium
735,-1,0,m_sp_arch_4x1_bt_32_r201_cont3_m650,1,medium_bots,5_vs_5_medium
736,0,1,m_sp_arch_4x1_bt_32_r201_cont3_m650,1,medium_bots,5_vs_5_medium
737,0,1,m_sp_arch_4x1_bt_32_r201_cont3_m650,1,medium_bots,5_vs_5_medium
738,1,2,m_sp_arch_4x1_bt_32_r201_cont3_m650,1,hard_bots,5_vs_5_hard
739,0,1,m_sp_arch_4x1_bt_32_r201_cont3_m650,1,hard_bots,5_vs_5_hard
740,1,1,m_sp_arch_4x1_bt_32_r201_cont3_m650,0,hard_bots,5_vs_5_hard
741,1,1,m_sp_arch_4x1_bt_32_r201_cont3_m650,0,hard_bots,5_vs_5_hard
742,-1,2,m_sp_arch_4x1_bt_32_r201_cont3_m650,3,hard_bots,5_vs_5_hard
743,-1,0,m_sp_arch_4x1_bt_32_r201_cont3_m650,1,hard_bots,5_vs_5_hard
744,13,13,m_sp_arch_4x1_bt_32_r201_cont3_m650,0,f5v0to1to2t05_e2_ckpt291,5_vs_5
745,9,11,m_sp_arch_4x1_bt_32_r201_cont3_m650,2,f5v0to1to2t05_e2_ckpt291,5_vs_5
746,6,7,m_sp_arch_4x1_bt_32_r201_cont3_m650,1,f5v0to1to2t05_e2_ckpt291,5_vs_5
747,6,6,m_sp_arch_4x1_bt_32_r201_cont3_m650,0,f5v0to1to5_e2_ckpt252,5_vs_5
748,7,7,m_sp_arch_4x1_bt_32_r201_cont3_m650,0,f5v0to1to5_e2_ckpt252,5_vs_5
749,10,10,m_sp_arch_4x1_bt_32_r201_cont3_m650,0,f5v0to1to5_e2_ckpt252,5_vs_5
750,11,11,m_sp_arch_4x1_bt_32_r201_cont3_m650,0,scon_e3_p2_hard_ckpt840,5_vs_5
751,11,11,m_sp_arch_4x1_bt_32_r201_cont3_m650,0,scon_e3_p2_hard_ckpt840,5_vs_5
752,14,14,m_sp_arch_4x1_bt_32_r201_cont3_m650,0,scon_e3_p2_hard_ckpt840,5_vs_5
753,12,12,m_sp_arch_4x1_bt_32_r201_cont3_m650,0,less_then_partially_randomized_checkpoints_bots_4_heads_38_ckpt108,5_vs_5
754,11,12,m_sp_arch_4x1_bt_32_r201_cont3_m650,1,less_then_partially_randomized_checkpoints_bots_4_heads_38_ckpt108,5_vs_5
755,13,13,m_sp_arch_4x1_bt_32_r201_cont3_m650,0,less_then_partially_randomized_checkpoints_bots_4_heads_38_ckpt108,5_vs_5
756,12,12,m_sp_arch_4x1_bt_32_r201_cont3_m650,0,less_then_partially_randomized_entropy_checkpoints_bots_4_heads_39_ckpt109,5_vs_5
757,12,12,m_sp_arch_4x1_bt_32_r201_cont3_m650,0,less_then_partially_randomized_entropy_checkpoints_bots_4_heads_39_ckpt109,5_vs_5
758,10,10,m_sp_arch_4x1_bt_32_r201_cont3_m650,0,less_then_partially_randomized_entropy_checkpoints_bots_4_heads_39_ckpt109,5_vs_5
759,10,11,m_sp_arch_4x1_bt_32_r201_cont3_m650,1,reward_shaping_checkpoints_bots_4_heads_1_ckpt360,5_vs_5
760,11,11,m_sp_arch_4x1_bt_32_r201_cont3_m650,0,reward_shaping_checkpoints_bots_4_heads_1_ckpt360,5_vs_5
761,10,10,m_sp_arch_4x1_bt_32_r201_cont3_m650,0,reward_shaping_checkpoints_bots_4_heads_1_ckpt360,5_vs_5
762,10,10,m_sp_arch_4x1_bt_32_r201_cont3_m650,0,checkpoints_selfplay_e9_sp_ckpt274,5_vs_5
763,9,9,m_sp_arch_4x1_bt_32_r201_cont3_m650,0,checkpoints_selfplay_e9_sp_ckpt274,5_vs_5
764,3,4,m_sp_arch_4x1_bt_32_r201_cont3_m650,1,checkpoints_selfplay_e9_sp_ckpt274,5_vs_5
765,1,3,m_sp_arch_4x1_bt_32_r201_cont3_m650,2,checkpoints_sp_c_nb_e2_ckpt667,5_vs_5
766,2,4,m_sp_arch_4x1_bt_32_r201_cont3_m650,2,checkpoints_sp_c_nb_e2_ckpt667,5_vs_5
767,0,1,m_sp_arch_4x1_bt_32_r201_cont3_m650,1,checkpoints_sp_c_nb_e2_ckpt667,5_vs_5
768,4,5,m_sp_arch_4x1_bt_32_r201_cont3_m650,1,m_sp_arch_medium_heads_conv16_0_bt_32_r313_m335,5_vs_5
769,6,6,m_sp_arch_4x1_bt_32_r201_cont3_m650,0,m_sp_arch_medium_heads_conv16_0_bt_32_r313_m335,5_vs_5
770,4,7,m_sp_arch_4x1_bt_32_r201_cont3_m650,3,m_sp_arch_medium_heads_conv16_0_bt_32_r313_m335,5_vs_5
771,8,10,m_sp_arch_4x1_bt_32_r201_cont3_m650,2,m_sp_arch_longer_heads_bt_32_r201_m335,5_vs_5
772,3,5,m_sp_arch_4x1_bt_32_r201_cont3_m650,2,m_sp_arch_longer_heads_bt_32_r201_m335,5_vs_5
773,3,3,m_sp_arch_4x1_bt_32_r201_cont3_m650,0,m_sp_arch_longer_heads_bt_32_r201_m335,5_vs_5
774,5,5,m_sp_arch_4x1_bt_32_r201_cont3_m650,0,m_sp_arch_medium_heads_bt_32_r201_m335,5_vs_5
775,1,2,m_sp_arch_4x1_bt_32_r201_cont3_m650,1,m_sp_arch_medium_heads_bt_32_r201_m335,5_vs_5
776,6,6,m_sp_arch_4x1_bt_32_r201_cont3_m650,0,m_sp_arch_medium_heads_bt_32_r201_m335,5_vs_5
777,2,3,m_sp_arch_4x1_bt_32_r201_cont3_m650,1,m_sp_arch_4x1_bt_32_r201_m335,5_vs_5
778,1,3,m_sp_arch_4x1_bt_32_r201_cont3_m650,2,m_sp_arch_4x1_bt_32_r201_m335,5_vs_5
779,0,2,m_sp_arch_4x1_bt_32_r201_cont3_m650,2,m_sp_arch_4x1_bt_32_r201_m335,5_vs_5
780,-2,0,m_sp_arch_4x1_bt_32_r201_cont3_m650,2,m_sp_arch_4x1_bt_32_r201_cont3_m650,5_vs_5
781,1,2,m_sp_arch_4x1_bt_32_r201_cont3_m650,1,m_sp_arch_4x1_bt_32_r201_cont3_m650,5_vs_5
782,0,0,m_sp_arch_4x1_bt_32_r201_cont3_m650,0,m_sp_arch_4x1_bt_32_r201_cont3_m650,5_vs_5
783,0,1,m_sp_arch_4x1_bt_32_r201_cont3_m650,1,explt_v0_7_2_m54,5_vs_5
784,-2,0,m_sp_arch_4x1_bt_32_r201_cont3_m650,2,explt_v0_7_2_m54,5_vs_5
785,0,1,m_sp_arch_4x1_bt_32_r201_cont3_m650,1,explt_v0_7_2_m54,5_vs_5
786,4,5,m_sp_arch_4x1_bt_32_r201_cont3_m650,1,m_sp_sc3v3_arch_2x1_32_r500_cont4x1_m224,5_vs_5
787,2,4,m_sp_arch_4x1_bt_32_r201_cont3_m650,2,m_sp_sc3v3_arch_2x1_32_r500_cont4x1_m224,5_vs_5
788,-1,2,m_sp_arch_4x1_bt_32_r201_cont3_m650,3,m_sp_sc3v3_arch_2x1_32_r500_cont4x1_m224,5_vs_5
789,4,4,m_sp_arch_4x1_bt_32_r201_cont3_m650,0,m_sp_arch_4x1_bt_32_roles_r500_m335,5_vs_5
790,-1,1,m_sp_arch_4x1_bt_32_r201_cont3_m650,2,m_sp_arch_4x1_bt_32_roles_r500_m335,5_vs_5
791,2,2,m_sp_arch_4x1_bt_32_r201_cont3_m650,0,m_sp_arch_4x1_bt_32_roles_r500_m335,5_vs_5
792,-1,1,m_sp_arch_longer_heads_bt_32_r201_m335,2,easy_bots,5_vs_5
793,-3,0,m_sp_arch_longer_heads_bt_32_r201_m335,3,easy_bots,5_vs_5
794,-2,0,m_sp_arch_longer_heads_bt_32_r201_m335,2,easy_bots,5_vs_5
795,0,0,m_sp_arch_longer_heads_bt_32_r201_m335,0,easy_bots,5_vs_5
796,0,0,m_sp_arch_longer_heads_bt_32_r201_m335,0,medium_bots,5_vs_5_medium
797,-4,0,m_sp_arch_longer_heads_bt_32_r201_m335,4,medium_bots,5_vs_5_medium
798,-2,0,m_sp_arch_longer_heads_bt_32_r201_m335,2,medium_bots,5_vs_5_medium
799,0,1,m_sp_arch_longer_heads_bt_32_r201_m335,1,medium_bots,5_vs_5_medium
800,-3,1,m_sp_arch_longer_heads_bt_32_r201_m335,4,hard_bots,5_vs_5_hard
801,-3,0,m_sp_arch_longer_heads_bt_32_r201_m335,3,hard_bots,5_vs_5_hard
802,-4,0,m_sp_arch_longer_heads_bt_32_r201_m335,4,hard_bots,5_vs_5_hard
803,-4,0,m_sp_arch_longer_heads_bt_32_r201_m335,4,hard_bots,5_vs_5_hard
804,4,5,m_sp_arch_longer_heads_bt_32_r201_m335,1,f5v0to1to2t05_e2_ckpt291,5_vs_5
805,1,4,m_sp_arch_longer_heads_bt_32_r201_m335,3,f5v0to1to2t05_e2_ckpt291,5_vs_5
806,1,2,m_sp_arch_longer_heads_bt_32_r201_m335,1,f5v0to1to5_e2_ckpt252,5_vs_5
807,4,7,m_sp_arch_longer_heads_bt_32_r201_m335,3,f5v0to1to5_e2_ckpt252,5_vs_5
808,3,3,m_sp_arch_longer_heads_bt_32_r201_m335,0,scon_e3_p2_hard_ckpt840,5_vs_5
809,6,6,m_sp_arch_longer_heads_bt_32_r201_m335,0,scon_e3_p2_hard_ckpt840,5_vs_5
810,8,8,m_sp_arch_longer_heads_bt_32_r201_m335,0,less_then_partially_randomized_checkpoints_bots_4_heads_38_ckpt108,5_vs_5
811,2,3,m_sp_arch_longer_heads_bt_32_r201_m335,1,less_then_partially_randomized_checkpoints_bots_4_heads_38_ckpt108,5_vs_5
812,5,5,m_sp_arch_longer_heads_bt_32_r201_m335,0,less_then_partially_randomized_entropy_checkpoints_bots_4_heads_39_ckpt109,5_vs_5
813,2,4,m_sp_arch_longer_heads_bt_32_r201_m335,2,less_then_partially_randomized_entropy_checkpoints_bots_4_heads_39_ckpt109,5_vs_5
814,8,9,m_sp_arch_longer_heads_bt_32_r201_m335,1,reward_shaping_checkpoints_bots_4_heads_1_ckpt360,5_vs_5
815,4,5,m_sp_arch_longer_heads_bt_32_r201_m335,1,reward_shaping_checkpoints_bots_4_heads_1_ckpt360,5_vs_5
816,2,3,m_sp_arch_longer_heads_bt_32_r201_m335,1,checkpoints_selfplay_e9_sp_ckpt274,5_vs_5
817,3,5,m_sp_arch_longer_heads_bt_32_r201_m335,2,checkpoints_selfplay_e9_sp_ckpt274,5_vs_5
818,-3,4,m_sp_arch_longer_heads_bt_32_r201_m335,7,checkpoints_sp_c_nb_e2_ckpt667,5_vs_5
819,-2,2,m_sp_arch_longer_heads_bt_32_r201_m335,4,checkpoints_sp_c_nb_e2_ckpt667,5_vs_5
820,1,2,m_sp_arch_longer_heads_bt_32_r201_m335,1,m_sp_arch_medium_heads_conv16_0_bt_32_r313_m335,5_vs_5
821,2,4,m_sp_arch_longer_heads_bt_32_r201_m335,2,m_sp_arch_medium_heads_conv16_0_bt_32_r313_m335,5_vs_5
822,1,2,m_sp_arch_longer_heads_bt_32_r201_m335,1,m_sp_arch_longer_heads_bt_32_r201_m335,5_vs_5
823,-1,1,m_sp_arch_longer_heads_bt_32_r201_m335,2,m_sp_arch_longer_heads_bt_32_r201_m335,5_vs_5
824,2,4,m_sp_arch_longer_heads_bt_32_r201_m335,2,m_sp_arch_medium_heads_bt_32_r201_m335,5_vs_5
825,1,3,m_sp_arch_longer_heads_bt_32_r201_m335,2,m_sp_arch_medium_heads_bt_32_r201_m335,5_vs_5
826,-2,1,m_sp_arch_longer_heads_bt_32_r201_m335,3,m_sp_arch_4x1_bt_32_r201_m335,5_vs_5
827,-5,2,m_sp_arch_longer_heads_bt_32_r201_m335,7,m_sp_arch_4x1_bt_32_r201_m335,5_vs_5
828,-5,0,m_sp_arch_longer_heads_bt_32_r201_m335,5,m_sp_arch_4x1_bt_32_r201_cont3_m650,5_vs_5
829,-6,0,m_sp_arch_longer_heads_bt_32_r201_m335,6,m_sp_arch_4x1_bt_32_r201_cont3_m650,5_vs_5
830,-1,2,m_sp_arch_longer_heads_bt_32_r201_m335,3,explt_v0_7_2_m54,5_vs_5
831,0,1,m_sp_arch_longer_heads_bt_32_r201_m335,1,explt_v0_7_2_m54,5_vs_5
832,-5,0,m_sp_arch_longer_heads_bt_32_r201_m335,5,m_sp_sc3v3_arch_2x1_32_r500_cont4x1_m224,5_vs_5
833,-4,1,m_sp_arch_longer_heads_bt_32_r201_m335,5,m_sp_sc3v3_arch_2x1_32_r500_cont4x1_m224,5_vs_5
834,-9,0,m_sp_arch_longer_heads_bt_32_r201_m335,9,m_sp_arch_4x1_bt_32_roles_r500_m335,5_vs_5
835,-2,1,m_sp_arch_longer_heads_bt_32_r201_m335,3,m_sp_arch_4x1_bt_32_roles_r500_m335,5_vs_5
836,-1,0,m_sp_arch_4x1_bt_32_r201_cont3_m650,1,easy_bots,5_vs_5
837,1,2,m_sp_arch_4x1_bt_32_r201_cont3_m650,1,easy_bots,5_vs_5
838,3,3,m_sp_arch_4x1_bt_32_r201_cont3_m650,0,easy_bots,5_vs_5
839,2,2,m_sp_arch_4x1_bt_32_r201_cont3_m650,0,easy_bots,5_vs_5
840,1,1,m_sp_arch_4x1_bt_32_r201_cont3_m650,0,medium_bots,5_vs_5_medium
841,1,2,m_sp_arch_4x1_bt_32_r201_cont3_m650,1,medium_bots,5_vs_5_medium
842,-2,0,m_sp_arch_4x1_bt_32_r201_cont3_m650,2,medium_bots,5_vs_5_medium
843,1,2,m_sp_arch_4x1_bt_32_r201_cont3_m650,1,medium_bots,5_vs_5_medium
844,1,2,m_sp_arch_4x1_bt_32_r201_cont3_m650,1,hard_bots,5_vs_5_hard
845,0,1,m_sp_arch_4x1_bt_32_r201_cont3_m650,1,hard_bots,5_vs_5_hard
846,2,2,m_sp_arch_4x1_bt_32_r201_cont3_m650,0,hard_bots,5_vs_5_hard
847,-3,0,m_sp_arch_4x1_bt_32_r201_cont3_m650,3,hard_bots,5_vs_5_hard
848,6,7,m_sp_arch_4x1_bt_32_r201_cont3_m650,1,f5v0to1to2t05_e2_ckpt291,5_vs_5
849,3,5,m_sp_arch_4x1_bt_32_r201_cont3_m650,2,f5v0to1to2t05_e2_ckpt291,5_vs_5
850,10,10,m_sp_arch_4x1_bt_32_r201_cont3_m650,0,f5v0to1to5_e2_ckpt252,5_vs_5
851,9,9,m_sp_arch_4x1_bt_32_r201_cont3_m650,0,f5v0to1to5_e2_ckpt252,5_vs_5
852,9,9,m_sp_arch_4x1_bt_32_r201_cont3_m650,0,scon_e3_p2_hard_ckpt840,5_vs_5
853,11,11,m_sp_arch_4x1_bt_32_r201_cont3_m650,0,scon_e3_p2_hard_ckpt840,5_vs_5
854,16,16,m_sp_arch_4x1_bt_32_r201_cont3_m650,0,less_then_partially_randomized_checkpoints_bots_4_heads_38_ckpt108,5_vs_5
855,19,19,m_sp_arch_4x1_bt_32_r201_cont3_m650,0,less_then_partially_randomized_checkpoints_bots_4_heads_38_ckpt108,5_vs_5
856,14,14,m_sp_arch_4x1_bt_32_r201_cont3_m650,0,less_then_partially_randomized_entropy_checkpoints_bots_4_heads_39_ckpt109,5_vs_5
857,5,5,m_sp_arch_4x1_bt_32_r201_cont3_m650,0,less_then_partially_randomized_entropy_checkpoints_bots_4_heads_39_ckpt109,5_vs_5
858,11,11,m_sp_arch_4x1_bt_32_r201_cont3_m650,0,reward_shaping_checkpoints_bots_4_heads_1_ckpt360,5_vs_5
859,9,9,m_sp_arch_4x1_bt_32_r201_cont3_m650,0,reward_shaping_checkpoints_bots_4_heads_1_ckpt360,5_vs_5
860,4,5,m_sp_arch_4x1_bt_32_r201_cont3_m650,1,checkpoints_selfplay_e9_sp_ckpt274,5_vs_5
861,3,6,m_sp_arch_4x1_bt_32_r201_cont3_m650,3,checkpoints_selfplay_e9_sp_ckpt274,5_vs_5
862,4,4,m_sp_arch_4x1_bt_32_r201_cont3_m650,0,checkpoints_sp_c_nb_e2_ckpt667,5_vs_5
863,3,3,m_sp_arch_4x1_bt_32_r201_cont3_m650,0,checkpoints_sp_c_nb_e2_ckpt667,5_vs_5
864,2,3,m_sp_arch_4x1_bt_32_r201_cont3_m650,1,m_sp_arch_medium_heads_conv16_0_bt_32_r313_m335,5_vs_5
865,6,7,m_sp_arch_4x1_bt_32_r201_cont3_m650,1,m_sp_arch_medium_heads_conv16_0_bt_32_r313_m335,5_vs_5
866,4,5,m_sp_arch_4x1_bt_32_r201_cont3_m650,1,m_sp_arch_longer_heads_bt_32_r201_m335,5_vs_5
867,6,7,m_sp_arch_4x1_bt_32_r201_cont3_m650,1,m_sp_arch_longer_heads_bt_32_r201_m335,5_vs_5
868,8,8,m_sp_arch_4x1_bt_32_r201_cont3_m650,0,m_sp_arch_medium_heads_bt_32_r201_m335,5_vs_5
869,4,4,m_sp_arch_4x1_bt_32_r201_cont3_m650,0,m_sp_arch_medium_heads_bt_32_r201_m335,5_vs_5
870,4,5,m_sp_arch_4x1_bt_32_r201_cont3_m650,1,m_sp_arch_4x1_bt_32_r201_m335,5_vs_5
871,2,3,m_sp_arch_4x1_bt_32_r201_cont3_m650,1,m_sp_arch_4x1_bt_32_r201_m335,5_vs_5
872,-2,0,m_sp_arch_4x1_bt_32_r201_cont3_m650,2,m_sp_arch_4x1_bt_32_r201_cont3_m650,5_vs_5
873,0,2,m_sp_arch_4x1_bt_32_r201_cont3_m650,2,m_sp_arch_4x1_bt_32_r201_cont3_m650,5_vs_5
874,-3,0,m_sp_arch_4x1_bt_32_r201_cont3_m650,3,explt_v0_7_2_m54,5_vs_5
875,-3,0,m_sp_arch_4x1_bt_32_r201_cont3_m650,3,explt_v0_7_2_m54,5_vs_5
876,4,4,m_sp_arch_4x1_bt_32_r201_cont3_m650,0,m_sp_sc3v3_arch_2x1_32_r500_cont4x1_m224,5_vs_5
877,2,5,m_sp_arch_4x1_bt_32_r201_cont3_m650,3,m_sp_sc3v3_arch_2x1_32_r500_cont4x1_m224,5_vs_5
878,1,3,m_sp_arch_4x1_bt_32_r201_cont3_m650,2,m_sp_arch_4x1_bt_32_roles_r500_m335,5_vs_5
879,2,3,m_sp_arch_4x1_bt_32_r201_cont3_m650,1,m_sp_arch_4x1_bt_32_roles_r500_m335,5_vs_5
880,3,6,checkpoints_selfplay_e9_sp_ckpt274,3,easy_bots,5_vs_5
881,1,2,checkpoints_selfplay_e9_sp_ckpt274,1,easy_bots,5_vs_5
882,2,2,checkpoints_selfplay_e9_sp_ckpt274,0,easy_bots,5_vs_5
883,4,4,checkpoints_selfplay_e9_sp_ckpt274,0,easy_bots,5_vs_5
884,1,3,checkpoints_selfplay_e9_sp_ckpt274,2,easy_bots,5_vs_5
885,4,4,checkpoints_selfplay_e9_sp_ckpt274,0,easy_bots,5_vs_5
886,-3,1,checkpoints_selfplay_e9_sp_ckpt274,4,easy_bots,5_vs_5
887,2,4,checkpoints_selfplay_e9_sp_ckpt274,2,easy_bots,5_vs_5
888,5,5,checkpoints_selfplay_e9_sp_ckpt274,0,easy_bots,5_vs_5
889,3,3,checkpoints_selfplay_e9_sp_ckpt274,0,easy_bots,5_vs_5
890,1,2,checkpoints_selfplay_e9_sp_ckpt274,1,medium_bots,5_vs_5_medium
891,-1,2,checkpoints_selfplay_e9_sp_ckpt274,3,medium_bots,5_vs_5_medium
892,0,2,checkpoints_selfplay_e9_sp_ckpt274,2,medium_bots,5_vs_5_medium
893,-3,1,checkpoints_selfplay_e9_sp_ckpt274,4,medium_bots,5_vs_5_medium
894,-1,4,checkpoints_selfplay_e9_sp_ckpt274,5,medium_bots,5_vs_5_medium
895,-4,2,checkpoints_selfplay_e9_sp_ckpt274,6,medium_bots,5_vs_5_medium
896,-2,1,checkpoints_selfplay_e9_sp_ckpt274,3,medium_bots,5_vs_5_medium
897,1,1,checkpoints_selfplay_e9_sp_ckpt274,0,medium_bots,5_vs_5_medium
898,0,3,checkpoints_selfplay_e9_sp_ckpt274,3,medium_bots,5_vs_5_medium
899,1,2,checkpoints_selfplay_e9_sp_ckpt274,1,medium_bots,5_vs_5_medium
900,-2,1,checkpoints_selfplay_e9_sp_ckpt274,3,hard_bots,5_vs_5_hard
901,-3,0,checkpoints_selfplay_e9_sp_ckpt274,3,hard_bots,5_vs_5_hard
902,-2,0,checkpoints_selfplay_e9_sp_ckpt274,2,hard_bots,5_vs_5_hard
903,0,2,checkpoints_selfplay_e9_sp_ckpt274,2,hard_bots,5_vs_5_hard
904,-2,0,checkpoints_selfplay_e9_sp_ckpt274,2,hard_bots,5_vs_5_hard
905,0,2,checkpoints_selfplay_e9_sp_ckpt274,2,hard_bots,5_vs_5_hard
906,-2,2,checkpoints_selfplay_e9_sp_ckpt274,4,hard_bots,5_vs_5_hard
907,-2,0,checkpoints_selfplay_e9_sp_ckpt274,2,hard_bots,5_vs_5_hard
908,-3,0,checkpoints_selfplay_e9_sp_ckpt274,3,hard_bots,5_vs_5_hard
909,-1,1,checkpoints_selfplay_e9_sp_ckpt274,2,hard_bots,5_vs_5_hard
910,5,7,checkpoints_selfplay_e9_sp_ckpt274,2,f5v0to1to2t05_e2_ckpt291,5_vs_5
911,3,5,checkpoints_selfplay_e9_sp_ckpt274,2,f5v0to1to2t05_e2_ckpt291,5_vs_5
912,15,16,checkpoints_selfplay_e9_sp_ckpt274,1,f5v0to1to2t05_e2_ckpt291,5_vs_5
913,6,7,checkpoints_selfplay_e9_sp_ckpt274,1,f5v0to1to2t05_e2_ckpt291,5_vs_5
914,10,11,checkpoints_selfplay_e9_sp_ckpt274,1,f5v0to1to2t05_e2_ckpt291,5_vs_5
915,7,9,checkpoints_selfplay_e9_sp_ckpt274,2,f5v0to1to5_e2_ckpt252,5_vs_5
916,7,10,checkpoints_selfplay_e9_sp_ckpt274,3,f5v0to1to5_e2_ckpt252,5_vs_5
917,3,8,checkpoints_selfplay_e9_sp_ckpt274,5,f5v0to1to5_e2_ckpt252,5_vs_5
918,3,5,checkpoints_selfplay_e9_sp_ckpt274,2,f5v0to1to5_e2_ckpt252,5_vs_5
919,3,5,checkpoints_selfplay_e9_sp_ckpt274,2,f5v0to1to5_e2_ckpt252,5_vs_5
920,9,9,checkpoints_selfplay_e9_sp_ckpt274,0,scon_e3_p2_hard_ckpt840,5_vs_5
921,5,9,checkpoints_selfplay_e9_sp_ckpt274,4,scon_e3_p2_hard_ckpt840,5_vs_5
922,7,8,checkpoints_selfplay_e9_sp_ckpt274,1,scon_e3_p2_hard_ckpt840,5_vs_5
923,7,8,checkpoints_selfplay_e9_sp_ckpt274,1,scon_e3_p2_hard_ckpt840,5_vs_5
924,4,6,checkpoints_selfplay_e9_sp_ckpt274,2,scon_e3_p2_hard_ckpt840,5_vs_5
925,11,13,checkpoints_selfplay_e9_sp_ckpt274,2,less_then_partially_randomized_checkpoints_bots_4_heads_38_ckpt108,5_vs_5
926,11,11,checkpoints_selfplay_e9_sp_ckpt274,0,less_then_partially_randomized_checkpoints_bots_4_heads_38_ckpt108,5_vs_5
927,5,8,checkpoints_selfplay_e9_sp_ckpt274,3,less_then_partially_randomized_checkpoints_bots_4_heads_38_ckpt108,5_vs_5
928,6,8,checkpoints_selfplay_e9_sp_ckpt274,2,less_then_partially_randomized_checkpoints_bots_4_heads_38_ckpt108,5_vs_5
929,4,7,checkpoints_selfplay_e9_sp_ckpt274,3,less_then_partially_randomized_checkpoints_bots_4_heads_38_ckpt108,5_vs_5
930,9,10,checkpoints_selfplay_e9_sp_ckpt274,1,less_then_partially_randomized_entropy_checkpoints_bots_4_heads_39_ckpt109,5_vs_5
931,9,11,checkpoints_selfplay_e9_sp_ckpt274,2,less_then_partially_randomized_entropy_checkpoints_bots_4_heads_39_ckpt109,5_vs_5
932,8,9,checkpoints_selfplay_e9_sp_ckpt274,1,less_then_partially_randomized_entropy_checkpoints_bots_4_heads_39_ckpt109,5_vs_5
933,9,9,checkpoints_selfplay_e9_sp_ckpt274,0,less_then_partially_randomized_entropy_checkpoints_bots_4_heads_39_ckpt109,5_vs_5
934,5,6,checkpoints_selfplay_e9_sp_ckpt274,1,less_then_partially_randomized_entropy_checkpoints_bots_4_heads_39_ckpt109,5_vs_5
935,12,12,checkpoints_selfplay_e9_sp_ckpt274,0,reward_shaping_checkpoints_bots_4_heads_1_ckpt360,5_vs_5
936,9,11,checkpoints_selfplay_e9_sp_ckpt274,2,reward_shaping_checkpoints_bots_4_heads_1_ckpt360,5_vs_5
937,5,6,checkpoints_selfplay_e9_sp_ckpt274,1,reward_shaping_checkpoints_bots_4_heads_1_ckpt360,5_vs_5
938,8,8,checkpoints_selfplay_e9_sp_ckpt274,0,reward_shaping_checkpoints_bots_4_heads_1_ckpt360,5_vs_5
939,5,7,checkpoints_selfplay_e9_sp_ckpt274,2,reward_shaping_checkpoints_bots_4_heads_1_ckpt360,5_vs_5
940,0,2,checkpoints_selfplay_e9_sp_ckpt274,2,checkpoints_selfplay_e9_sp_ckpt274,5_vs_5
941,0,5,checkpoints_selfplay_e9_sp_ckpt274,5,checkpoints_selfplay_e9_sp_ckpt274,5_vs_5
942,-2,2,checkpoints_selfplay_e9_sp_ckpt274,4,checkpoints_selfplay_e9_sp_ckpt274,5_vs_5
943,1,6,checkpoints_selfplay_e9_sp_ckpt274,5,checkpoints_selfplay_e9_sp_ckpt274,5_vs_5
944,1,5,checkpoints_selfplay_e9_sp_ckpt274,4,checkpoints_selfplay_e9_sp_ckpt274,5_vs_5
945,0,1,checkpoints_selfplay_e9_sp_ckpt274,1,checkpoints_sp_c_nb_e2_ckpt667,5_vs_5
946,-3,1,checkpoints_selfplay_e9_sp_ckpt274,4,checkpoints_sp_c_nb_e2_ckpt667,5_vs_5
947,-1,5,checkpoints_selfplay_e9_sp_ckpt274,6,checkpoints_sp_c_nb_e2_ckpt667,5_vs_5
948,-3,3,checkpoints_selfplay_e9_sp_ckpt274,6,checkpoints_sp_c_nb_e2_ckpt667,5_vs_5
949,-3,3,checkpoints_selfplay_e9_sp_ckpt274,6,checkpoints_sp_c_nb_e2_ckpt667,5_vs_5
950,-1,2,checkpoints_selfplay_e9_sp_ckpt274,3,m_sp_arch_medium_heads_conv16_0_bt_32_r313_m335,5_vs_5
951,-1,3,checkpoints_selfplay_e9_sp_ckpt274,4,m_sp_arch_medium_heads_conv16_0_bt_32_r313_m335,5_vs_5
952,-4,1,checkpoints_selfplay_e9_sp_ckpt274,5,m_sp_arch_medium_heads_conv16_0_bt_32_r313_m335,5_vs_5
953,4,6,checkpoints_selfplay_e9_sp_ckpt274,2,m_sp_arch_medium_heads_conv16_0_bt_32_r313_m335,5_vs_5
954,-2,3,checkpoints_selfplay_e9_sp_ckpt274,5,m_sp_arch_medium_heads_conv16_0_bt_32_r313_m335,5_vs_5
955,0,6,checkpoints_selfplay_e9_sp_ckpt274,6,m_sp_arch_longer_heads_bt_32_r201_m335,5_vs_5
956,1,2,checkpoints_selfplay_e9_sp_ckpt274,1,m_sp_arch_longer_heads_bt_32_r201_m335,5_vs_5
957,1,4,checkpoints_selfplay_e9_sp_ckpt274,3,m_sp_arch_longer_heads_bt_32_r201_m335,5_vs_5
958,-1,3,checkpoints_selfplay_e9_sp_ckpt274,4,m_sp_arch_longer_heads_bt_32_r201_m335,5_vs_5
959,1,3,checkpoints_selfplay_e9_sp_ckpt274,2,m_sp_arch_longer_heads_bt_32_r201_m335,5_vs_5
960,1,3,checkpoints_selfplay_e9_sp_ckpt274,2,m_sp_arch_medium_heads_bt_32_r201_m335,5_vs_5
961,0,5,checkpoints_selfplay_e9_sp_ckpt274,5,m_sp_arch_medium_heads_bt_32_r201_m335,5_vs_5
962,-2,0,checkpoints_selfplay_e9_sp_ckpt274,2,m_sp_arch_medium_heads_bt_32_r201_m335,5_vs_5
963,0,1,checkpoints_selfplay_e9_sp_ckpt274,1,m_sp_arch_medium_heads_bt_32_r201_m335,5_vs_5
964,1,5,checkpoints_selfplay_e9_sp_ckpt274,4,m_sp_arch_medium_heads_bt_32_r201_m335,5_vs_5
965,-2,2,checkpoints_selfplay_e9_sp_ckpt274,4,m_sp_arch_4x1_bt_32_r201_m335,5_vs_5
966,-2,2,checkpoints_selfplay_e9_sp_ckpt274,4,m_sp_arch_4x1_bt_32_r201_m335,5_vs_5
967,-7,1,checkpoints_selfplay_e9_sp_ckpt274,8,m_sp_arch_4x1_bt_32_r201_m335,5_vs_5
968,-9,0,checkpoints_selfplay_e9_sp_ckpt274,9,m_sp_arch_4x1_bt_32_r201_m335,5_vs_5
969,-8,0,checkpoints_selfplay_e9_sp_ckpt274,8,m_sp_arch_4x1_bt_32_r201_m335,5_vs_5
970,-8,1,checkpoints_selfplay_e9_sp_ckpt274,9,m_sp_arch_4x1_bt_32_r201_cont3_m650,5_vs_5
971,0,2,checkpoints_selfplay_e9_sp_ckpt274,2,m_sp_arch_4x1_bt_32_r201_cont3_m650,5_vs_5
972,-7,0,checkpoints_selfplay_e9_sp_ckpt274,7,m_sp_arch_4x1_bt_32_r201_cont3_m650,5_vs_5
973,-6,1,checkpoints_selfplay_e9_sp_ckpt274,7,m_sp_arch_4x1_bt_32_r201_cont3_m650,5_vs_5
974,-1,2,checkpoints_selfplay_e9_sp_ckpt274,3,m_sp_arch_4x1_bt_32_r201_cont3_m650,5_vs_5
975,-4,0,checkpoints_selfplay_e9_sp_ckpt274,4,explt_v0_7_2_m54,5_vs_5
976,-3,1,checkpoints_selfplay_e9_sp_ckpt274,4,explt_v0_7_2_m54,5_vs_5
977,-1,1,checkpoints_selfplay_e9_sp_ckpt274,2,explt_v0_7_2_m54,5_vs_5
978,0,1,checkpoints_selfplay_e9_sp_ckpt274,1,explt_v0_7_2_m54,5_vs_5
979,1,3,checkpoints_selfplay_e9_sp_ckpt274,2,explt_v0_7_2_m54,5_vs_5
980,-5,0,checkpoints_selfplay_e9_sp_ckpt274,5,m_sp_sc3v3_arch_2x1_32_r500_cont4x1_m224,5_vs_5
981,-1,4,checkpoints_selfplay_e9_sp_ckpt274,5,m_sp_sc3v3_arch_2x1_32_r500_cont4x1_m224,5_vs_5
982,-4,1,checkpoints_selfplay_e9_sp_ckpt274,5,m_sp_sc3v3_arch_2x1_32_r500_cont4x1_m224,5_vs_5
983,-3,2,checkpoints_selfplay_e9_sp_ckpt274,5,m_sp_sc3v3_arch_2x1_32_r500_cont4x1_m224,5_vs_5
984,-6,1,checkpoints_selfplay_e9_sp_ckpt274,7,m_sp_sc3v3_arch_2x1_32_r500_cont4x1_m224,5_vs_5
985,-2,3,checkpoints_selfplay_e9_sp_ckpt274,5,m_sp_arch_4x1_bt_32_roles_r500_m335,5_vs_5
986,-4,3,checkpoints_selfplay_e9_sp_ckpt274,7,m_sp_arch_4x1_bt_32_roles_r500_m335,5_vs_5
987,-5,3,checkpoints_selfplay_e9_sp_ckpt274,8,m_sp_arch_4x1_bt_32_roles_r500_m335,5_vs_5
988,-3,1,checkpoints_selfplay_e9_sp_ckpt274,4,m_sp_arch_4x1_bt_32_roles_r500_m335,5_vs_5
989,-7,0,checkpoints_selfplay_e9_sp_ckpt274,7,m_sp_arch_4x1_bt_32_roles_r500_m335,5_vs_5
990,2,3,checkpoints_selfplay_e9_sp_ckpt274,1,easy_bots,5_vs_5
991,1,4,checkpoints_selfplay_e9_sp_ckpt274,3,easy_bots,5_vs_5
992,3,3,checkpoints_selfplay_e9_sp_ckpt274,0,easy_bots,5_vs_5
993,0,1,checkpoints_selfplay_e9_sp_ckpt274,1,easy_bots,5_vs_5
994,0,3,checkpoints_selfplay_e9_sp_ckpt274,3,easy_bots,5_vs_5
995,1,4,checkpoints_selfplay_e9_sp_ckpt274,3,easy_bots,5_vs_5
996,-5,2,checkpoints_selfplay_e9_sp_ckpt274,7,medium_bots,5_vs_5_medium
997,-3,2,checkpoints_selfplay_e9_sp_ckpt274,5,medium_bots,5_vs_5_medium
998,0,3,checkpoints_selfplay_e9_sp_ckpt274,3,medium_bots,5_vs_5_medium
999,-1,2,checkpoints_selfplay_e9_sp_ckpt274,3,medium_bots,5_vs_5_medium
1000,-1,1,checkpoints_selfplay_e9_sp_ckpt274,2,medium_bots,5_vs_5_medium
1001,-1,2,checkpoints_selfplay_e9_sp_ckpt274,3,medium_bots,5_vs_5_medium
1002,-3,0,checkpoints_selfplay_e9_sp_ckpt274,3,hard_bots,5_vs_5_hard
1003,1,1,checkpoints_selfplay_e9_sp_ckpt274,0,hard_bots,5_vs_5_hard
1004,0,1,checkpoints_selfplay_e9_sp_ckpt274,1,hard_bots,5_vs_5_hard
1005,-3,0,checkpoints_selfplay_e9_sp_ckpt274,3,hard_bots,5_vs_5_hard
1006,1,1,checkpoints_selfplay_e9_sp_ckpt274,0,hard_bots,5_vs_5_hard
1007,-1,0,checkpoints_selfplay_e9_sp_ckpt274,1,hard_bots,5_vs_5_hard
1008,11,13,checkpoints_selfplay_e9_sp_ckpt274,2,f5v0to1to2t05_e2_ckpt291,5_vs_5
1009,8,12,checkpoints_selfplay_e9_sp_ckpt274,4,f5v0to1to2t05_e2_ckpt291,5_vs_5
1010,4,7,checkpoints_selfplay_e9_sp_ckpt274,3,f5v0to1to2t05_e2_ckpt291,5_vs_5
1011,7,7,checkpoints_selfplay_e9_sp_ckpt274,0,f5v0to1to5_e2_ckpt252,5_vs_5
1012,5,7,checkpoints_selfplay_e9_sp_ckpt274,2,f5v0to1to5_e2_ckpt252,5_vs_5
1013,2,5,checkpoints_selfplay_e9_sp_ckpt274,3,f5v0to1to5_e2_ckpt252,5_vs_5
1014,3,5,checkpoints_selfplay_e9_sp_ckpt274,2,scon_e3_p2_hard_ckpt840,5_vs_5
1015,9,9,checkpoints_selfplay_e9_sp_ckpt274,0,scon_e3_p2_hard_ckpt840,5_vs_5
1016,11,11,checkpoints_selfplay_e9_sp_ckpt274,0,scon_e3_p2_hard_ckpt840,5_vs_5
1017,7,9,checkpoints_selfplay_e9_sp_ckpt274,2,less_then_partially_randomized_checkpoints_bots_4_heads_38_ckpt108,5_vs_5
1018,10,11,checkpoints_selfplay_e9_sp_ckpt274,1,less_then_partially_randomized_checkpoints_bots_4_heads_38_ckpt108,5_vs_5
1019,8,11,checkpoints_selfplay_e9_sp_ckpt274,3,less_then_partially_randomized_checkpoints_bots_4_heads_38_ckpt108,5_vs_5
1020,3,8,checkpoints_selfplay_e9_sp_ckpt274,5,less_then_partially_randomized_entropy_checkpoints_bots_4_heads_39_ckpt109,5_vs_5
1021,3,7,checkpoints_selfplay_e9_sp_ckpt274,4,less_then_partially_randomized_entropy_checkpoints_bots_4_heads_39_ckpt109,5_vs_5
1022,9,9,checkpoints_selfplay_e9_sp_ckpt274,0,less_then_partially_randomized_entropy_checkpoints_bots_4_heads_39_ckpt109,5_vs_5
1023,11,11,checkpoints_selfplay_e9_sp_ckpt274,0,reward_shaping_checkpoints_bots_4_heads_1_ckpt360,5_vs_5
1024,8,11,checkpoints_selfplay_e9_sp_ckpt274,3,reward_shaping_checkpoints_bots_4_heads_1_ckpt360,5_vs_5
1025,4,7,checkpoints_selfplay_e9_sp_ckpt274,3,reward_shaping_checkpoints_bots_4_heads_1_ckpt360,5_vs_5
1026,0,1,checkpoints_selfplay_e9_sp_ckpt274,1,checkpoints_selfplay_e9_sp_ckpt274,5_vs_5
1027,2,4,checkpoints_selfplay_e9_sp_ckpt274,2,checkpoints_selfplay_e9_sp_ckpt274,5_vs_5
1028,-1,4,checkpoints_selfplay_e9_sp_ckpt274,5,checkpoints_selfplay_e9_sp_ckpt274,5_vs_5
1029,-7,0,checkpoints_selfplay_e9_sp_ckpt274,7,checkpoints_sp_c_nb_e2_ckpt667,5_vs_5
1030,-3,2,checkpoints_selfplay_e9_sp_ckpt274,5,checkpoints_sp_c_nb_e2_ckpt667,5_vs_5
1031,-9,0,checkpoints_selfplay_e9_sp_ckpt274,9,checkpoints_sp_c_nb_e2_ckpt667,5_vs_5
1032,3,6,checkpoints_selfplay_e9_sp_ckpt274,3,m_sp_arch_medium_heads_conv16_0_bt_32_r313_m335,5_vs_5
1033,5,7,checkpoints_selfplay_e9_sp_ckpt274,2,m_sp_arch_medium_heads_conv16_0_bt_32_r313_m335,5_vs_5
1034,1,3,checkpoints_selfplay_e9_sp_ckpt274,2,m_sp_arch_medium_heads_conv16_0_bt_32_r313_m335,5_vs_5
1035,0,2,checkpoints_selfplay_e9_sp_ckpt274,2,m_sp_arch_longer_heads_bt_32_r201_m335,5_vs_5
1036,0,2,checkpoints_selfplay_e9_sp_ckpt274,2,m_sp_arch_longer_heads_bt_32_r201_m335,5_vs_5
1037,0,1,checkpoints_selfplay_e9_sp_ckpt274,1,m_sp_arch_longer_heads_bt_32_r201_m335,5_vs_5
1038,-1,3,checkpoints_selfplay_e9_sp_ckpt274,4,m_sp_arch_medium_heads_bt_32_r201_m335,5_vs_5
1039,-1,3,checkpoints_selfplay_e9_sp_ckpt274,4,m_sp_arch_medium_heads_bt_32_r201_m335,5_vs_5
1040,0,2,checkpoints_selfplay_e9_sp_ckpt274,2,m_sp_arch_medium_heads_bt_32_r201_m335,5_vs_5
1041,0,4,checkpoints_selfplay_e9_sp_ckpt274,4,m_sp_arch_4x1_bt_32_r201_m335,5_vs_5
1042,-6,0,checkpoints_selfplay_e9_sp_ckpt274,6,m_sp_arch_4x1_bt_32_r201_m335,5_vs_5
1043,-4,2,checkpoints_selfplay_e9_sp_ckpt274,6,m_sp_arch_4x1_bt_32_r201_m335,5_vs_5
1044,-7,0,checkpoints_selfplay_e9_sp_ckpt274,7,m_sp_arch_4x1_bt_32_r201_cont3_m650,5_vs_5
1045,-6,0,checkpoints_selfplay_e9_sp_ckpt274,6,m_sp_arch_4x1_bt_32_r201_cont3_m650,5_vs_5
1046,-3,3,checkpoints_selfplay_e9_sp_ckpt274,6,m_sp_arch_4x1_bt_32_r201_cont3_m650,5_vs_5
1047,-1,2,checkpoints_selfplay_e9_sp_ckpt274,3,explt_v0_7_2_m54,5_vs_5
1048,-2,1,checkpoints_selfplay_e9_sp_ckpt274,3,explt_v0_7_2_m54,5_vs_5
1049,-2,2,checkpoints_selfplay_e9_sp_ckpt274,4,explt_v0_7_2_m54,5_vs_5
1050,-4,2,checkpoints_selfplay_e9_sp_ckpt274,6,m_sp_sc3v3_arch_2x1_32_r500_cont4x1_m224,5_vs_5
1051,1,3,checkpoints_selfplay_e9_sp_ckpt274,2,m_sp_sc3v3_arch_2x1_32_r500_cont4x1_m224,5_vs_5
1052,-1,4,checkpoints_selfplay_e9_sp_ckpt274,5,m_sp_sc3v3_arch_2x1_32_r500_cont4x1_m224,5_vs_5
1053,-2,1,checkpoints_selfplay_e9_sp_ckpt274,3,m_sp_arch_4x1_bt_32_roles_r500_m335,5_vs_5
1054,-4,1,checkpoints_selfplay_e9_sp_ckpt274,5,m_sp_arch_4x1_bt_32_roles_r500_m335,5_vs_5
1055,-5,2,checkpoints_selfplay_e9_sp_ckpt274,7,m_sp_arch_4x1_bt_32_roles_r500_m335,5_vs_5
1056,2,4,scon_e3_p2_hard_ckpt840,2,easy_bots,5_vs_5
1057,9,11,scon_e3_p2_hard_ckpt840,2,easy_bots,5_vs_5
1058,11,11,scon_e3_p2_hard_ckpt840,0,easy_bots,5_vs_5
1059,11,13,scon_e3_p2_hard_ckpt840,2,easy_bots,5_vs_5
1060,5,8,scon_e3_p2_hard_ckpt840,3,medium_bots,5_vs_5_medium
1061,9,11,scon_e3_p2_hard_ckpt840,2,medium_bots,5_vs_5_medium
1062,11,11,scon_e3_p2_hard_ckpt840,0,medium_bots,5_vs_5_medium
1063,3,9,scon_e3_p2_hard_ckpt840,6,medium_bots,5_vs_5_medium
1064,3,6,scon_e3_p2_hard_ckpt840,3,hard_bots,5_vs_5_hard
1065,10,11,scon_e3_p2_hard_ckpt840,1,hard_bots,5_vs_5_hard
1066,9,10,scon_e3_p2_hard_ckpt840,1,hard_bots,5_vs_5_hard
1067,8,9,scon_e3_p2_hard_ckpt840,1,hard_bots,5_vs_5_hard
1068,-2,0,scon_e3_p2_hard_ckpt840,2,f5v0to1to2t05_e2_ckpt291,5_vs_5
1069,-8,0,scon_e3_p2_hard_ckpt840,8,f5v0to1to2t05_e2_ckpt291,5_vs_5
1070,-1,2,scon_e3_p2_hard_ckpt840,3,f5v0to1to5_e2_ckpt252,5_vs_5
1071,-1,1,scon_e3_p2_hard_ckpt840,2,f5v0to1to5_e2_ckpt252,5_vs_5
1072,-4,2,scon_e3_p2_hard_ckpt840,6,scon_e3_p2_hard_ckpt840,5_vs_5
1073,1,1,scon_e3_p2_hard_ckpt840,0,scon_e3_p2_hard_ckpt840,5_vs_5
1074,4,5,scon_e3_p2_hard_ckpt840,1,less_then_partially_randomized_checkpoints_bots_4_heads_38_ckpt108,5_vs_5
1075,-2,3,scon_e3_p2_hard_ckpt840,5,less_then_partially_randomized_checkpoints_bots_4_heads_38_ckpt108,5_vs_5
1076,-2,3,scon_e3_p2_hard_ckpt840,5,less_then_partially_randomized_entropy_checkpoints_bots_4_heads_39_ckpt109,5_vs_5
1077,1,3,scon_e3_p2_hard_ckpt840,2,less_then_partially_randomized_entropy_checkpoints_bots_4_heads_39_ckpt109,5_vs_5
1078,2,3,scon_e3_p2_hard_ckpt840,1,reward_shaping_checkpoints_bots_4_heads_1_ckpt360,5_vs_5
1079,0,3,scon_e3_p2_hard_ckpt840,3,reward_shaping_checkpoints_bots_4_heads_1_ckpt360,5_vs_5
1080,-3,4,scon_e3_p2_hard_ckpt840,7,checkpoints_selfplay_e9_sp_ckpt274,5_vs_5
1081,-12,0,scon_e3_p2_hard_ckpt840,12,checkpoints_selfplay_e9_sp_ckpt274,5_vs_5
1082,-1,4,scon_e3_p2_hard_ckpt840,5,checkpoints_sp_c_nb_e2_ckpt667,5_vs_5
1083,-4,2,scon_e3_p2_hard_ckpt840,6,checkpoints_sp_c_nb_e2_ckpt667,5_vs_5
1084,-4,0,scon_e3_p2_hard_ckpt840,4,m_sp_arch_medium_heads_conv16_0_bt_32_r313_m335,5_vs_5
1085,-2,0,scon_e3_p2_hard_ckpt840,2,m_sp_arch_medium_heads_conv16_0_bt_32_r313_m335,5_vs_5
1086,-3,0,scon_e3_p2_hard_ckpt840,3,m_sp_arch_longer_heads_bt_32_r201_m335,5_vs_5
1087,-5,1,scon_e3_p2_hard_ckpt840,6,m_sp_arch_longer_heads_bt_32_r201_m335,5_vs_5
1088,-9,0,scon_e3_p2_hard_ckpt840,9,m_sp_arch_medium_heads_bt_32_r201_m335,5_vs_5
1089,-7,0,scon_e3_p2_hard_ckpt840,7,m_sp_arch_medium_heads_bt_32_r201_m335,5_vs_5
1090,-11,0,scon_e3_p2_hard_ckpt840,11,m_sp_arch_4x1_bt_32_r201_m335,5_vs_5
1091,-15,0,scon_e3_p2_hard_ckpt840,15,m_sp_arch_4x1_bt_32_r201_m335,5_vs_5
1092,-9,0,scon_e3_p2_hard_ckpt840,9,m_sp_arch_4x1_bt_32_r201_cont3_m650,5_vs_5
1093,-10,0,scon_e3_p2_hard_ckpt840,10,m_sp_arch_4x1_bt_32_r201_cont3_m650,5_vs_5
1094,-1,0,scon_e3_p2_hard_ckpt840,1,explt_v0_7_2_m54,5_vs_5
1095,-2,0,scon_e3_p2_hard_ckpt840,2,explt_v0_7_2_m54,5_vs_5
1096,-7,0,scon_e3_p2_hard_ckpt840,7,m_sp_sc3v3_arch_2x1_32_r500_cont4x1_m224,5_vs_5
1097,-11,1,scon_e3_p2_hard_ckpt840,12,m_sp_sc3v3_arch_2x1_32_r500_cont4x1_m224,5_vs_5
1098,-10,0,scon_e3_p2_hard_ckpt840,10,m_sp_arch_4x1_bt_32_roles_r500_m335,5_vs_5
1099,-14,1,scon_e3_p2_hard_ckpt840,15,m_sp_arch_4x1_bt_32_roles_r500_m335,5_vs_5
1100,6,6,checkpoints_selfplay_e9_sp_ckpt274,0,easy_bots,5_vs_5
1101,1,1,checkpoints_selfplay_e9_sp_ckpt274,0,easy_bots,5_vs_5
1102,3,5,checkpoints_selfplay_e9_sp_ckpt274,2,easy_bots,5_vs_5
1103,2,4,checkpoints_selfplay_e9_sp_ckpt274,2,easy_bots,5_vs_5
1104,-1,3,checkpoints_selfplay_e9_sp_ckpt274,4,medium_bots,5_vs_5_medium
1105,1,3,checkpoints_selfplay_e9_sp_ckpt274,2,medium_bots,5_vs_5_medium
1106,0,2,checkpoints_selfplay_e9_sp_ckpt274,2,medium_bots,5_vs_5_medium
1107,-1,1,checkpoints_selfplay_e9_sp_ckpt274,2,medium_bots,5_vs_5_medium
1108,0,1,checkpoints_selfplay_e9_sp_ckpt274,1,hard_bots,5_vs_5_hard
1109,-2,3,checkpoints_selfplay_e9_sp_ckpt274,5,hard_bots,5_vs_5_hard
1110,-5,1,checkpoints_selfplay_e9_sp_ckpt274,6,hard_bots,5_vs_5_hard
1111,0,1,checkpoints_selfplay_e9_sp_ckpt274,1,hard_bots,5_vs_5_hard
1112,11,12,checkpoints_selfplay_e9_sp_ckpt274,1,f5v0to1to2t05_e2_ckpt291,5_vs_5
1113,6,9,checkpoints_selfplay_e9_sp_ckpt274,3,f5v0to1to2t05_e2_ckpt291,5_vs_5
1114,7,10,checkpoints_selfplay_e9_sp_ckpt274,3,f5v0to1to5_e2_ckpt252,5_vs_5
1115,1,5,checkpoints_selfplay_e9_sp_ckpt274,4,f5v0to1to5_e2_ckpt252,5_vs_5
1116,7,7,checkpoints_selfplay_e9_sp_ckpt274,0,scon_e3_p2_hard_ckpt840,5_vs_5
1117,8,9,checkpoints_selfplay_e9_sp_ckpt274,1,scon_e3_p2_hard_ckpt840,5_vs_5
1118,9,9,checkpoints_selfplay_e9_sp_ckpt274,0,less_then_partially_randomized_checkpoints_bots_4_heads_38_ckpt108,5_vs_5
1119,8,11,checkpoints_selfplay_e9_sp_ckpt274,3,less_then_partially_randomized_checkpoints_bots_4_heads_38_ckpt108,5_vs_5
1120,5,8,checkpoints_selfplay_e9_sp_ckpt274,3,less_then_partially_randomized_entropy_checkpoints_bots_4_heads_39_ckpt109,5_vs_5
1121,9,9,checkpoints_selfplay_e9_sp_ckpt274,0,less_then_partially_randomized_entropy_checkpoints_bots_4_heads_39_ckpt109,5_vs_5
1122,6,6,checkpoints_selfplay_e9_sp_ckpt274,0,reward_shaping_checkpoints_bots_4_heads_1_ckpt360,5_vs_5
1123,9,10,checkpoints_selfplay_e9_sp_ckpt274,1,reward_shaping_checkpoints_bots_4_heads_1_ckpt360,5_vs_5
1124,4,7,checkpoints_selfplay_e9_sp_ckpt274,3,checkpoints_selfplay_e9_sp_ckpt274,5_vs_5
1125,2,6,checkpoints_selfplay_e9_sp_ckpt274,4,checkpoints_selfplay_e9_sp_ckpt274,5_vs_5
1126,0,3,checkpoints_selfplay_e9_sp_ckpt274,3,checkpoints_sp_c_nb_e2_ckpt667,5_vs_5
1127,-7,2,checkpoints_selfplay_e9_sp_ckpt274,9,checkpoints_sp_c_nb_e2_ckpt667,5_vs_5
1128,-2,2,checkpoints_selfplay_e9_sp_ckpt274,4,m_sp_arch_medium_heads_conv16_0_bt_32_r313_m335,5_vs_5
1129,0,4,checkpoints_selfplay_e9_sp_ckpt274,4,m_sp_arch_medium_heads_conv16_0_bt_32_r313_m335,5_vs_5
1130,-4,1,checkpoints_selfplay_e9_sp_ckpt274,5,m_sp_arch_longer_heads_bt_32_r201_m335,5_vs_5
1131,0,5,checkpoints_selfplay_e9_sp_ckpt274,5,m_sp_arch_longer_heads_bt_32_r201_m335,5_vs_5
1132,0,3,checkpoints_selfplay_e9_sp_ckpt274,3,m_sp_arch_medium_heads_bt_32_r201_m335,5_vs_5
1133,6,8,checkpoints_selfplay_e9_sp_ckpt274,2,m_sp_arch_medium_heads_bt_32_r201_m335,5_vs_5
1134,-3,3,checkpoints_selfplay_e9_sp_ckpt274,6,m_sp_arch_4x1_bt_32_r201_m335,5_vs_5
1135,-8,1,checkpoints_selfplay_e9_sp_ckpt274,9,m_sp_arch_4x1_bt_32_r201_m335,5_vs_5
1136,-10,1,checkpoints_selfplay_e9_sp_ckpt274,11,m_sp_arch_4x1_bt_32_r201_cont3_m650,5_vs_5
1137,-7,1,checkpoints_selfplay_e9_sp_ckpt274,8,m_sp_arch_4x1_bt_32_r201_cont3_m650,5_vs_5
1138,3,4,checkpoints_selfplay_e9_sp_ckpt274,1,explt_v0_7_2_m54,5_vs_5
1139,-1,1,checkpoints_selfplay_e9_sp_ckpt274,2,explt_v0_7_2_m54,5_vs_5
1140,-2,6,checkpoints_selfplay_e9_sp_ckpt274,8,m_sp_sc3v3_arch_2x1_32_r500_cont4x1_m224,5_vs_5
1141,-8,1,checkpoints_selfplay_e9_sp_ckpt274,9,m_sp_sc3v3_arch_2x1_32_r500_cont4x1_m224,5_vs_5
1142,-2,1,checkpoints_selfplay_e9_sp_ckpt274,3,m_sp_arch_4x1_bt_32_roles_r500_m335,5_vs_5
1143,-6,1,checkpoints_selfplay_e9_sp_ckpt274,7,m_sp_arch_4x1_bt_32_roles_r500_m335,5_vs_5
1144,1,1,m_sp_arch_4x1_bt_32_r201_m335,0,easy_bots,5_vs_5
1145,2,3,m_sp_arch_4x1_bt_32_r201_m335,1,easy_bots,5_vs_5
1146,4,5,m_sp_arch_4x1_bt_32_r201_m335,1,easy_bots,5_vs_5
1147,4,4,m_sp_arch_4x1_bt_32_r201_m335,0,easy_bots,5_vs_5
1148,2,3,m_sp_arch_4x1_bt_32_r201_m335,1,easy_bots,5_vs_5
1149,2,3,m_sp_arch_4x1_bt_32_r201_m335,1,easy_bots,5_vs_5
1150,3,4,m_sp_arch_4x1_bt_32_r201_m335,1,easy_bots,5_vs_5
1151,-2,1,m_sp_arch_4x1_bt_32_r201_m335,3,easy_bots,5_vs_5
1152,3,4,m_sp_arch_4x1_bt_32_r201_m335,1,easy_bots,5_vs_5
1153,2,2,m_sp_arch_4x1_bt_32_r201_m335,0,easy_bots,5_vs_5
1154,-2,0,m_sp_arch_4x1_bt_32_r201_m335,2,medium_bots,5_vs_5_medium
1155,0,0,m_sp_arch_4x1_bt_32_r201_m335,0,medium_bots,5_vs_5_medium
1156,2,2,m_sp_arch_4x1_bt_32_r201_m335,0,medium_bots,5_vs_5_medium
1157,-1,0,m_sp_arch_4x1_bt_32_r201_m335,1,medium_bots,5_vs_5_medium
1158,-1,1,m_sp_arch_4x1_bt_32_r201_m335,2,medium_bots,5_vs_5_medium
1159,0,0,m_sp_arch_4x1_bt_32_r201_m335,0,medium_bots,5_vs_5_medium
1160,0,2,m_sp_arch_4x1_bt_32_r201_m335,2,medium_bots,5_vs_5_medium
1161,-1,1,m_sp_arch_4x1_bt_32_r201_m335,2,medium_bots,5_vs_5_medium
1162,1,1,m_sp_arch_4x1_bt_32_r201_m335,0,medium_bots,5_vs_5_medium
1163,2,2,m_sp_arch_4x1_bt_32_r201_m335,0,medium_bots,5_vs_5_medium
1164,0,1,m_sp_arch_4x1_bt_32_r201_m335,1,hard_bots,5_vs_5_hard
1165,-1,3,m_sp_arch_4x1_bt_32_r201_m335,4,hard_bots,5_vs_5_hard
1166,1,1,m_sp_arch_4x1_bt_32_r201_m335,0,hard_bots,5_vs_5_hard
1167,-1,0,m_sp_arch_4x1_bt_32_r201_m335,1,hard_bots,5_vs_5_hard
1168,0,0,m_sp_arch_4x1_bt_32_r201_m335,0,hard_bots,5_vs_5_hard
1169,0,1,m_sp_arch_4x1_bt_32_r201_m335,1,hard_bots,5_vs_5_hard
1170,-1,0,m_sp_arch_4x1_bt_32_r201_m335,1,hard_bots,5_vs_5_hard
1171,0,0,m_sp_arch_4x1_bt_32_r201_m335,0,hard_bots,5_vs_5_hard
1172,-1,0,m_sp_arch_4x1_bt_32_r201_m335,1,hard_bots,5_vs_5_hard
1173,-3,0,m_sp_arch_4x1_bt_32_r201_m335,3,hard_bots,5_vs_5_hard
1174,8,9,m_sp_arch_4x1_bt_32_r201_m335,1,f5v0to1to2t05_e2_ckpt291,5_vs_5
1175,12,13,m_sp_arch_4x1_bt_32_r201_m335,1,f5v0to1to2t05_e2_ckpt291,5_vs_5
1176,7,7,m_sp_arch_4x1_bt_32_r201_m335,0,f5v0to1to2t05_e2_ckpt291,5_vs_5
1177,8,9,m_sp_arch_4x1_bt_32_r201_m335,1,f5v0to1to2t05_e2_ckpt291,5_vs_5
1178,8,9,m_sp_arch_4x1_bt_32_r201_m335,1,f5v0to1to2t05_e2_ckpt291,5_vs_5
1179,7,7,m_sp_arch_4x1_bt_32_r201_m335,0,f5v0to1to5_e2_ckpt252,5_vs_5
1180,8,8,m_sp_arch_4x1_bt_32_r201_m335,0,f5v0to1to5_e2_ckpt252,5_vs_5
1181,4,4,m_sp_arch_4x1_bt_32_r201_m335,0,f5v0to1to5_e2_ckpt252,5_vs_5
1182,5,6,m_sp_arch_4x1_bt_32_r201_m335,1,f5v0to1to5_e2_ckpt252,5_vs_5
1183,6,7,m_sp_arch_4x1_bt_32_r201_m335,1,f5v0to1to5_e2_ckpt252,5_vs_5
1184,11,11,m_sp_arch_4x1_bt_32_r201_m335,0,scon_e3_p2_hard_ckpt840,5_vs_5
1185,11,11,m_sp_arch_4x1_bt_32_r201_m335,0,scon_e3_p2_hard_ckpt840,5_vs_5
1186,11,11,m_sp_arch_4x1_bt_32_r201_m335,0,scon_e3_p2_hard_ckpt840,5_vs_5
1187,11,11,m_sp_arch_4x1_bt_32_r201_m335,0,scon_e3_p2_hard_ckpt840,5_vs_5
1188,11,11,m_sp_arch_4x1_bt_32_r201_m335,0,scon_e3_p2_hard_ckpt840,5_vs_5
1189,9,9,m_sp_arch_4x1_bt_32_r201_m335,0,less_then_partially_randomized_checkpoints_bots_4_heads_38_ckpt108,5_vs_5
1190,14,14,m_sp_arch_4x1_bt_32_r201_m335,0,less_then_partially_randomized_checkpoints_bots_4_heads_38_ckpt108,5_vs_5
1191,11,11,m_sp_arch_4x1_bt_32_r201_m335,0,less_then_partially_randomized_checkpoints_bots_4_heads_38_ckpt108,5_vs_5
1192,6,7,m_sp_arch_4x1_bt_32_r201_m335,1,less_then_partially_randomized_checkpoints_bots_4_heads_38_ckpt108,5_vs_5
1193,8,8,m_sp_arch_4x1_bt_32_r201_m335,0,less_then_partially_randomized_checkpoints_bots_4_heads_38_ckpt108,5_vs_5
1194,7,7,m_sp_arch_4x1_bt_32_r201_m335,0,less_then_partially_randomized_entropy_checkpoints_bots_4_heads_39_ckpt109,5_vs_5
1195,14,14,m_sp_arch_4x1_bt_32_r201_m335,0,less_then_partially_randomized_entropy_checkpoints_bots_4_heads_39_ckpt109,5_vs_5
1196,9,9,m_sp_arch_4x1_bt_32_r201_m335,0,less_then_partially_randomized_entropy_checkpoints_bots_4_heads_39_ckpt109,5_vs_5
1197,14,14,m_sp_arch_4x1_bt_32_r201_m335,0,less_then_partially_randomized_entropy_checkpoints_bots_4_heads_39_ckpt109,5_vs_5
1198,8,8,m_sp_arch_4x1_bt_32_r201_m335,0,less_then_partially_randomized_entropy_checkpoints_bots_4_heads_39_ckpt109,5_vs_5
1199,12,12,m_sp_arch_4x1_bt_32_r201_m335,0,reward_shaping_checkpoints_bots_4_heads_1_ckpt360,5_vs_5
1200,11,11,m_sp_arch_4x1_bt_32_r201_m335,0,reward_shaping_checkpoints_bots_4_heads_1_ckpt360,5_vs_5
1201,9,9,m_sp_arch_4x1_bt_32_r201_m335,0,reward_shaping_checkpoints_bots_4_heads_1_ckpt360,5_vs_5
1202,11,11,m_sp_arch_4x1_bt_32_r201_m335,0,reward_shaping_checkpoints_bots_4_heads_1_ckpt360,5_vs_5
1203,12,12,m_sp_arch_4x1_bt_32_r201_m335,0,reward_shaping_checkpoints_bots_4_heads_1_ckpt360,5_vs_5
1204,5,6,m_sp_arch_4x1_bt_32_r201_m335,1,checkpoints_selfplay_e9_sp_ckpt274,5_vs_5
1205,2,5,m_sp_arch_4x1_bt_32_r201_m335,3,checkpoints_selfplay_e9_sp_ckpt274,5_vs_5
1206,3,3,m_sp_arch_4x1_bt_32_r201_m335,0,checkpoints_selfplay_e9_sp_ckpt274,5_vs_5
1207,3,4,m_sp_arch_4x1_bt_32_r201_m335,1,checkpoints_selfplay_e9_sp_ckpt274,5_vs_5
1208,3,3,m_sp_arch_4x1_bt_32_r201_m335,0,checkpoints_selfplay_e9_sp_ckpt274,5_vs_5
1209,2,2,m_sp_arch_4x1_bt_32_r201_m335,0,checkpoints_sp_c_nb_e2_ckpt667,5_vs_5
1210,5,5,m_sp_arch_4x1_bt_32_r201_m335,0,checkpoints_sp_c_nb_e2_ckpt667,5_vs_5
1211,3,3,m_sp_arch_4x1_bt_32_r201_m335,0,checkpoints_sp_c_nb_e2_ckpt667,5_vs_5
1212,5,5,m_sp_arch_4x1_bt_32_r201_m335,0,checkpoints_sp_c_nb_e2_ckpt667,5_vs_5
1213,-2,1,m_sp_arch_4x1_bt_32_r201_m335,3,checkpoints_sp_c_nb_e2_ckpt667,5_vs_5
1214,3,6,m_sp_arch_4x1_bt_32_r201_m335,3,m_sp_arch_medium_heads_conv16_0_bt_32_r313_m335,5_vs_5
1215,6,8,m_sp_arch_4x1_bt_32_r201_m335,2,m_sp_arch_medium_heads_conv16_0_bt_32_r313_m335,5_vs_5
1216,5,6,m_sp_arch_4x1_bt_32_r201_m335,1,m_sp_arch_medium_heads_conv16_0_bt_32_r313_m335,5_vs_5
1217,8,8,m_sp_arch_4x1_bt_32_r201_m335,0,m_sp_arch_medium_heads_conv16_0_bt_32_r313_m335,5_vs_5
1218,10,10,m_sp_arch_4x1_bt_32_r201_m335,0,m_sp_arch_medium_heads_conv16_0_bt_32_r313_m335,5_vs_5
1219,4,6,m_sp_arch_4x1_bt_32_r201_m335,2,m_sp_arch_longer_heads_bt_32_r201_m335,5_vs_5
1220,4,4,m_sp_arch_4x1_bt_32_r201_m335,0,m_sp_arch_longer_heads_bt_32_r201_m335,5_vs_5
1221,3,4,m_sp_arch_4x1_bt_32_r201_m335,1,m_sp_arch_longer_heads_bt_32_r201_m335,5_vs_5
1222,1,3,m_sp_arch_4x1_bt_32_r201_m335,2,m_sp_arch_longer_heads_bt_32_r201_m335,5_vs_5
1223,4,4,m_sp_arch_4x1_bt_32_r201_m335,0,m_sp_arch_longer_heads_bt_32_r201_m335,5_vs_5
1224,5,5,m_sp_arch_4x1_bt_32_r201_m335,0,m_sp_arch_medium_heads_bt_32_r201_m335,5_vs_5
1225,8,10,m_sp_arch_4x1_bt_32_r201_m335,2,m_sp_arch_medium_heads_bt_32_r201_m335,5_vs_5
1226,7,7,m_sp_arch_4x1_bt_32_r201_m335,0,m_sp_arch_medium_heads_bt_32_r201_m335,5_vs_5
1227,4,4,m_sp_arch_4x1_bt_32_r201_m335,0,m_sp_arch_medium_heads_bt_32_r201_m335,5_vs_5
1228,5,6,m_sp_arch_4x1_bt_32_r201_m335,1,m_sp_arch_medium_heads_bt_32_r201_m335,5_vs_5
1229,2,2,m_sp_arch_4x1_bt_32_r201_m335,0,m_sp_arch_4x1_bt_32_r201_m335,5_vs_5
1230,-2,0,m_sp_arch_4x1_bt_32_r201_m335,2,m_sp_arch_4x1_bt_32_r201_m335,5_vs_5
1231,1,1,m_sp_arch_4x1_bt_32_r201_m335,0,m_sp_arch_4x1_bt_32_r201_m335,5_vs_5
1232,-2,0,m_sp_arch_4x1_bt_32_r201_m335,2,m_sp_arch_4x1_bt_32_r201_m335,5_vs_5
1233,1,1,m_sp_arch_4x1_bt_32_r201_m335,0,m_sp_arch_4x1_bt_32_r201_m335,5_vs_5
1234,-1,1,m_sp_arch_4x1_bt_32_r201_m335,2,m_sp_arch_4x1_bt_32_r201_cont3_m650,5_vs_5
1235,-1,1,m_sp_arch_4x1_bt_32_r201_m335,2,m_sp_arch_4x1_bt_32_r201_cont3_m650,5_vs_5
1236,-3,1,m_sp_arch_4x1_bt_32_r201_m335,4,m_sp_arch_4x1_bt_32_r201_cont3_m650,5_vs_5
1237,0,0,m_sp_arch_4x1_bt_32_r201_m335,0,m_sp_arch_4x1_bt_32_r201_cont3_m650,5_vs_5
1238,0,1,m_sp_arch_4x1_bt_32_r201_m335,1,m_sp_arch_4x1_bt_32_r201_cont3_m650,5_vs_5
1239,-2,0,m_sp_arch_4x1_bt_32_r201_m335,2,explt_v0_7_2_m54,5_vs_5
1240,-3,1,m_sp_arch_4x1_bt_32_r201_m335,4,explt_v0_7_2_m54,5_vs_5
1241,-3,1,m_sp_arch_4x1_bt_32_r201_m335,4,explt_v0_7_2_m54,5_vs_5
1242,1,4,m_sp_arch_4x1_bt_32_r201_m335,3,explt_v0_7_2_m54,5_vs_5
1243,0,2,m_sp_arch_4x1_bt_32_r201_m335,2,explt_v0_7_2_m54,5_vs_5
1244,-1,4,m_sp_arch_4x1_bt_32_r201_m335,5,m_sp_sc3v3_arch_2x1_32_r500_cont4x1_m224,5_vs_5
1245,-2,2,m_sp_arch_4x1_bt_32_r201_m335,4,m_sp_sc3v3_arch_2x1_32_r500_cont4x1_m224,5_vs_5
1246,3,6,m_sp_arch_4x1_bt_32_r201_m335,3,m_sp_sc3v3_arch_2x1_32_r500_cont4x1_m224,5_vs_5
1247,2,6,m_sp_arch_4x1_bt_32_r201_m335,4,m_sp_sc3v3_arch_2x1_32_r500_cont4x1_m224,5_vs_5
1248,0,2,m_sp_arch_4x1_bt_32_r201_m335,2,m_sp_sc3v3_arch_2x1_32_r500_cont4x1_m224,5_vs_5
1249,1,2,m_sp_arch_4x1_bt_32_r201_m335,1,m_sp_arch_4x1_bt_32_roles_r500_m335,5_vs_5
1250,-2,0,m_sp_arch_4x1_bt_32_r201_m335,2,m_sp_arch_4x1_bt_32_roles_r500_m335,5_vs_5
1251,0,3,m_sp_arch_4x1_bt_32_r201_m335,3,m_sp_arch_4x1_bt_32_roles_r500_m335,5_vs_5
1252,-2,2,m_sp_arch_4x1_bt_32_r201_m335,4,m_sp_arch_4x1_bt_32_roles_r500_m335,5_vs_5
1253,0,1,m_sp_arch_4x1_bt_32_r201_m335,1,m_sp_arch_4x1_bt_32_roles_r500_m335,5_vs_5
1254,0,1,m_sp_arch_medium_heads_conv16_0_bt_32_r313_m335,1,easy_bots,5_vs_5
1255,0,0,m_sp_arch_medium_heads_conv16_0_bt_32_r313_m335,0,easy_bots,5_vs_5
1256,0,1,m_sp_arch_medium_heads_conv16_0_bt_32_r313_m335,1,easy_bots,5_vs_5
1257,-1,0,m_sp_arch_medium_heads_conv16_0_bt_32_r313_m335,1,easy_bots,5_vs_5
1258,-1,0,m_sp_arch_medium_heads_conv16_0_bt_32_r313_m335,1,medium_bots,5_vs_5_medium
1259,-1,2,m_sp_arch_medium_heads_conv16_0_bt_32_r313_m335,3,medium_bots,5_vs_5_medium
1260,-1,0,m_sp_arch_medium_heads_conv16_0_bt_32_r313_m335,1,medium_bots,5_vs_5_medium
1261,0,1,m_sp_arch_medium_heads_conv16_0_bt_32_r313_m335,1,medium_bots,5_vs_5_medium
1262,-4,0,m_sp_arch_medium_heads_conv16_0_bt_32_r313_m335,4,hard_bots,5_vs_5_hard
1263,-1,0,m_sp_arch_medium_heads_conv16_0_bt_32_r313_m335,1,hard_bots,5_vs_5_hard
1264,-3,0,m_sp_arch_medium_heads_conv16_0_bt_32_r313_m335,3,hard_bots,5_vs_5_hard
1265,-1,0,m_sp_arch_medium_heads_conv16_0_bt_32_r313_m335,1,hard_bots,5_vs_5_hard
1266,2,4,m_sp_arch_medium_heads_conv16_0_bt_32_r313_m335,2,f5v0to1to2t05_e2_ckpt291,5_vs_5
1267,0,3,m_sp_arch_medium_heads_conv16_0_bt_32_r313_m335,3,f5v0to1to2t05_e2_ckpt291,5_vs_5
1268,2,3,m_sp_arch_medium_heads_conv16_0_bt_32_r313_m335,1,f5v0to1to5_e2_ckpt252,5_vs_5
1269,3,5,m_sp_arch_medium_heads_conv16_0_bt_32_r313_m335,2,f5v0to1to5_e2_ckpt252,5_vs_5
1270,0,1,m_sp_arch_medium_heads_conv16_0_bt_32_r313_m335,1,scon_e3_p2_hard_ckpt840,5_vs_5
1271,3,3,m_sp_arch_medium_heads_conv16_0_bt_32_r313_m335,0,scon_e3_p2_hard_ckpt840,5_vs_5
1272,-2,1,m_sp_arch_medium_heads_conv16_0_bt_32_r313_m335,3,less_then_partially_randomized_checkpoints_bots_4_heads_38_ckpt108,5_vs_5
1273,0,3,m_sp_arch_medium_heads_conv16_0_bt_32_r313_m335,3,less_then_partially_randomized_checkpoints_bots_4_heads_38_ckpt108,5_vs_5
1274,2,4,m_sp_arch_medium_heads_conv16_0_bt_32_r313_m335,2,less_then_partially_randomized_entropy_checkpoints_bots_4_heads_39_ckpt109,5_vs_5
1275,3,4,m_sp_arch_medium_heads_conv16_0_bt_32_r313_m335,1,less_then_partially_randomized_entropy_checkpoints_bots_4_heads_39_ckpt109,5_vs_5
1276,3,4,m_sp_arch_medium_heads_conv16_0_bt_32_r313_m335,1,reward_shaping_checkpoints_bots_4_heads_1_ckpt360,5_vs_5
1277,2,7,m_sp_arch_medium_heads_conv16_0_bt_32_r313_m335,5,reward_shaping_checkpoints_bots_4_heads_1_ckpt360,5_vs_5
1278,-3,1,m_sp_arch_medium_heads_conv16_0_bt_32_r313_m335,4,checkpoints_selfplay_e9_sp_ckpt274,5_vs_5
1279,0,2,m_sp_arch_medium_heads_conv16_0_bt_32_r313_m335,2,checkpoints_selfplay_e9_sp_ckpt274,5_vs_5
1280,-6,0,m_sp_arch_medium_heads_conv16_0_bt_32_r313_m335,6,checkpoints_sp_c_nb_e2_ckpt667,5_vs_5
1281,1,3,m_sp_arch_medium_heads_conv16_0_bt_32_r313_m335,2,checkpoints_sp_c_nb_e2_ckpt667,5_vs_5
1282,-1,1,m_sp_arch_medium_heads_conv16_0_bt_32_r313_m335,2,m_sp_arch_medium_heads_conv16_0_bt_32_r313_m335,5_vs_5
1283,-2,3,m_sp_arch_medium_heads_conv16_0_bt_32_r313_m335,5,m_sp_arch_medium_heads_conv16_0_bt_32_r313_m335,5_vs_5
1284,2,2,m_sp_arch_medium_heads_conv16_0_bt_32_r313_m335,0,m_sp_arch_longer_heads_bt_32_r201_m335,5_vs_5
1285,1,2,m_sp_arch_medium_heads_conv16_0_bt_32_r313_m335,1,m_sp_arch_longer_heads_bt_32_r201_m335,5_vs_5
1286,1,4,m_sp_arch_medium_heads_conv16_0_bt_32_r313_m335,3,m_sp_arch_medium_heads_bt_32_r201_m335,5_vs_5
1287,1,3,m_sp_arch_medium_heads_conv16_0_bt_32_r313_m335,2,m_sp_arch_medium_heads_bt_32_r201_m335,5_vs_5
1288,-4,1,m_sp_arch_medium_heads_conv16_0_bt_32_r313_m335,5,m_sp_arch_4x1_bt_32_r201_m335,5_vs_5
1289,-8,0,m_sp_arch_medium_heads_conv16_0_bt_32_r313_m335,8,m_sp_arch_4x1_bt_32_r201_m335,5_vs_5
1290,-3,1,m_sp_arch_medium_heads_conv16_0_bt_32_r313_m335,4,m_sp_arch_4x1_bt_32_r201_cont3_m650,5_vs_5
1291,-6,1,m_sp_arch_medium_heads_conv16_0_bt_32_r313_m335,7,m_sp_arch_4x1_bt_32_r201_cont3_m650,5_vs_5
1292,-3,0,m_sp_arch_medium_heads_conv16_0_bt_32_r313_m335,3,explt_v0_7_2_m54,5_vs_5
1293,1,2,m_sp_arch_medium_heads_conv16_0_bt_32_r313_m335,1,explt_v0_7_2_m54,5_vs_5
1294,-3,1,m_sp_arch_medium_heads_conv16_0_bt_32_r313_m335,4,m_sp_sc3v3_arch_2x1_32_r500_cont4x1_m224,5_vs_5
1295,-2,2,m_sp_arch_medium_heads_conv16_0_bt_32_r313_m335,4,m_sp_sc3v3_arch_2x1_32_r500_cont4x1_m224,5_vs_5
1296,-7,0,m_sp_arch_medium_heads_conv16_0_bt_32_r313_m335,7,m_sp_arch_4x1_bt_32_roles_r500_m335,5_vs_5
1297,-9,0,m_sp_arch_medium_heads_conv16_0_bt_32_r313_m335,9,m_sp_arch_4x1_bt_32_roles_r500_m335,5_vs_5
1298,0,3,checkpoints_sp_c_nb_e2_ckpt667,3,easy_bots,5_vs_5
1299,0,2,checkpoints_sp_c_nb_e2_ckpt667,2,easy_bots,5_vs_5
1300,1,3,checkpoints_sp_c_nb_e2_ckpt667,2,easy_bots,5_vs_5
1301,0,2,checkpoints_sp_c_nb_e2_ckpt667,2,easy_bots,5_vs_5
1302,2,4,checkpoints_sp_c_nb_e2_ckpt667,2,easy_bots,5_vs_5
1303,0,1,checkpoints_sp_c_nb_e2_ckpt667,1,easy_bots,5_vs_5
1304,0,3,checkpoints_sp_c_nb_e2_ckpt667,3,easy_bots,5_vs_5
1305,0,2,checkpoints_sp_c_nb_e2_ckpt667,2,easy_bots,5_vs_5
1306,1,2,checkpoints_sp_c_nb_e2_ckpt667,1,easy_bots,5_vs_5
1307,1,3,checkpoints_sp_c_nb_e2_ckpt667,2,easy_bots,5_vs_5
1308,1,1,checkpoints_sp_c_nb_e2_ckpt667,0,medium_bots,5_vs_5_medium
1309,1,1,checkpoints_sp_c_nb_e2_ckpt667,0,medium_bots,5_vs_5_medium
1310,1,3,checkpoints_sp_c_nb_e2_ckpt667,2,medium_bots,5_vs_5_medium
1311,-2,1,checkpoints_sp_c_nb_e2_ckpt667,3,medium_bots,5_vs_5_medium
1312,3,3,checkpoints_sp_c_nb_e2_ckpt667,0,medium_bots,5_vs_5_medium
1313,-2,0,checkpoints_sp_c_nb_e2_ckpt667,2,medium_bots,5_vs_5_medium
1314,1,4,checkpoints_sp_c_nb_e2_ckpt667,3,medium_bots,5_vs_5_medium
1315,0,1,checkpoints_sp_c_nb_e2_ckpt667,1,medium_bots,5_vs_5_medium
1316,-1,0,checkpoints_sp_c_nb_e2_ckpt667,1,medium_bots,5_vs_5_medium
1317,-2,0,checkpoints_sp_c_nb_e2_ckpt667,2,medium_bots,5_vs_5_medium
1318,-2,0,checkpoints_sp_c_nb_e2_ckpt667,2,hard_bots,5_vs_5_hard
1319,-3,0,checkpoints_sp_c_nb_e2_ckpt667,3,hard_bots,5_vs_5_hard
1320,2,2,checkpoints_sp_c_nb_e2_ckpt667,0,hard_bots,5_vs_5_hard
1321,1,3,checkpoints_sp_c_nb_e2_ckpt667,2,hard_bots,5_vs_5_hard
1322,2,2,checkpoints_sp_c_nb_e2_ckpt667,0,hard_bots,5_vs_5_hard
1323,-1,1,checkpoints_sp_c_nb_e2_ckpt667,2,hard_bots,5_vs_5_hard
1324,-2,0,checkpoints_sp_c_nb_e2_ckpt667,2,hard_bots,5_vs_5_hard
1325,0,3,checkpoints_sp_c_nb_e2_ckpt667,3,hard_bots,5_vs_5_hard
1326,-4,0,checkpoints_sp_c_nb_e2_ckpt667,4,hard_bots,5_vs_5_hard
1327,-3,0,checkpoints_sp_c_nb_e2_ckpt667,3,hard_bots,5_vs_5_hard
1328,5,6,checkpoints_sp_c_nb_e2_ckpt667,1,f5v0to1to2t05_e2_ckpt291,5_vs_5
1329,3,4,checkpoints_sp_c_nb_e2_ckpt667,1,f5v0to1to2t05_e2_ckpt291,5_vs_5
1330,7,9,checkpoints_sp_c_nb_e2_ckpt667,2,f5v0to1to2t05_e2_ckpt291,5_vs_5
1331,3,5,checkpoints_sp_c_nb_e2_ckpt667,2,f5v0to1to2t05_e2_ckpt291,5_vs_5
1332,4,5,checkpoints_sp_c_nb_e2_ckpt667,1,f5v0to1to2t05_e2_ckpt291,5_vs_5
1333,4,6,checkpoints_sp_c_nb_e2_ckpt667,2,f5v0to1to5_e2_ckpt252,5_vs_5
1334,0,2,checkpoints_sp_c_nb_e2_ckpt667,2,f5v0to1to5_e2_ckpt252,5_vs_5
1335,3,3,checkpoints_sp_c_nb_e2_ckpt667,0,f5v0to1to5_e2_ckpt252,5_vs_5
1336,7,7,checkpoints_sp_c_nb_e2_ckpt667,0,f5v0to1to5_e2_ckpt252,5_vs_5
1337,6,8,checkpoints_sp_c_nb_e2_ckpt667,2,f5v0to1to5_e2_ckpt252,5_vs_5
1338,4,6,checkpoints_sp_c_nb_e2_ckpt667,2,scon_e3_p2_hard_ckpt840,5_vs_5
1339,6,7,checkpoints_sp_c_nb_e2_ckpt667,1,scon_e3_p2_hard_ckpt840,5_vs_5
1340,2,2,checkpoints_sp_c_nb_e2_ckpt667,0,scon_e3_p2_hard_ckpt840,5_vs_5
1341,2,2,checkpoints_sp_c_nb_e2_ckpt667,0,scon_e3_p2_hard_ckpt840,5_vs_5
1342,7,9,checkpoints_sp_c_nb_e2_ckpt667,2,scon_e3_p2_hard_ckpt840,5_vs_5
1343,5,5,checkpoints_sp_c_nb_e2_ckpt667,0,less_then_partially_randomized_checkpoints_bots_4_heads_38_ckpt108,5_vs_5
1344,6,8,checkpoints_sp_c_nb_e2_ckpt667,2,less_then_partially_randomized_checkpoints_bots_4_heads_38_ckpt108,5_vs_5
1345,9,9,checkpoints_sp_c_nb_e2_ckpt667,0,less_then_partially_randomized_checkpoints_bots_4_heads_38_ckpt108,5_vs_5
1346,7,8,checkpoints_sp_c_nb_e2_ckpt667,1,less_then_partially_randomized_checkpoints_bots_4_heads_38_ckpt108,5_vs_5
1347,5,7,checkpoints_sp_c_nb_e2_ckpt667,2,less_then_partially_randomized_checkpoints_bots_4_heads_38_ckpt108,5_vs_5
1348,8,9,checkpoints_sp_c_nb_e2_ckpt667,1,less_then_partially_randomized_entropy_checkpoints_bots_4_heads_39_ckpt109,5_vs_5
1349,7,7,checkpoints_sp_c_nb_e2_ckpt667,0,less_then_partially_randomized_entropy_checkpoints_bots_4_heads_39_ckpt109,5_vs_5
1350,6,6,checkpoints_sp_c_nb_e2_ckpt667,0,less_then_partially_randomized_entropy_checkpoints_bots_4_heads_39_ckpt109,5_vs_5
1351,4,7,checkpoints_sp_c_nb_e2_ckpt667,3,less_then_partially_randomized_entropy_checkpoints_bots_4_heads_39_ckpt109,5_vs_5
1352,6,7,checkpoints_sp_c_nb_e2_ckpt667,1,less_then_partially_randomized_entropy_checkpoints_bots_4_heads_39_ckpt109,5_vs_5
1353,7,7,checkpoints_sp_c_nb_e2_ckpt667,0,reward_shaping_checkpoints_bots_4_heads_1_ckpt360,5_vs_5
1354,7,8,checkpoints_sp_c_nb_e2_ckpt667,1,reward_shaping_checkpoints_bots_4_heads_1_ckpt360,5_vs_5
1355,10,10,checkpoints_sp_c_nb_e2_ckpt667,0,reward_shaping_checkpoints_bots_4_heads_1_ckpt360,5_vs_5
1356,9,10,checkpoints_sp_c_nb_e2_ckpt667,1,reward_shaping_checkpoints_bots_4_heads_1_ckpt360,5_vs_5
1357,9,9,checkpoints_sp_c_nb_e2_ckpt667,0,reward_shaping_checkpoints_bots_4_heads_1_ckpt360,5_vs_5
1358,1,4,checkpoints_sp_c_nb_e2_ckpt667,3,checkpoints_selfplay_e9_sp_ckpt274,5_vs_5
1359,0,4,checkpoints_sp_c_nb_e2_ckpt667,4,checkpoints_selfplay_e9_sp_ckpt274,5_vs_5
1360,6,9,checkpoints_sp_c_nb_e2_ckpt667,3,checkpoints_selfplay_e9_sp_ckpt274,5_vs_5
1361,4,7,checkpoints_sp_c_nb_e2_ckpt667,3,checkpoints_selfplay_e9_sp_ckpt274,5_vs_5
1362,3,5,checkpoints_sp_c_nb_e2_ckpt667,2,checkpoints_selfplay_e9_sp_ckpt274,5_vs_5
1363,2,4,checkpoints_sp_c_nb_e2_ckpt667,2,checkpoints_sp_c_nb_e2_ckpt667,5_vs_5
1364,1,3,checkpoints_sp_c_nb_e2_ckpt667,2,checkpoints_sp_c_nb_e2_ckpt667,5_vs_5
1365,4,5,checkpoints_sp_c_nb_e2_ckpt667,1,checkpoints_sp_c_nb_e2_ckpt667,5_vs_5
1366,-1,2,checkpoints_sp_c_nb_e2_ckpt667,3,checkpoints_sp_c_nb_e2_ckpt667,5_vs_5
1367,-1,1,checkpoints_sp_c_nb_e2_ckpt667,2,checkpoints_sp_c_nb_e2_ckpt667,5_vs_5
1368,0,3,checkpoints_sp_c_nb_e2_ckpt667,3,m_sp_arch_medium_heads_conv16_0_bt_32_r313_m335,5_vs_5
1369,5,5,checkpoints_sp_c_nb_e2_ckpt667,0,m_sp_arch_medium_heads_conv16_0_bt_32_r313_m335,5_vs_5
1370,1,5,checkpoints_sp_c_nb_e2_ckpt667,4,m_sp_arch_medium_heads_conv16_0_bt_32_r313_m335,5_vs_5
1371,4,5,checkpoints_sp_c_nb_e2_ckpt667,1,m_sp_arch_medium_heads_conv16_0_bt_32_r313_m335,5_vs_5
1372,3,6,checkpoints_sp_c_nb_e2_ckpt667,3,m_sp_arch_medium_heads_conv16_0_bt_32_r313_m335,5_vs_5
1373,0,1,checkpoints_sp_c_nb_e2_ckpt667,1,m_sp_arch_longer_heads_bt_32_r201_m335,5_vs_5
1374,2,3,checkpoints_sp_c_nb_e2_ckpt667,1,m_sp_arch_longer_heads_bt_32_r201_m335,5_vs_5
1375,0,5,checkpoints_sp_c_nb_e2_ckpt667,5,m_sp_arch_longer_heads_bt_32_r201_m335,5_vs_5
1376,4,5,checkpoints_sp_c_nb_e2_ckpt667,1,m_sp_arch_longer_heads_bt_32_r201_m335,5_vs_5
1377,-2,0,checkpoints_sp_c_nb_e2_ckpt667,2,m_sp_arch_longer_heads_bt_32_r201_m335,5_vs_5
1378,7,8,checkpoints_sp_c_nb_e2_ckpt667,1,m_sp_arch_medium_heads_bt_32_r201_m335,5_vs_5
1379,9,10,checkpoints_sp_c_nb_e2_ckpt667,1,m_sp_arch_medium_heads_bt_32_r201_m335,5_vs_5
1380,5,6,checkpoints_sp_c_nb_e2_ckpt667,1,m_sp_arch_medium_heads_bt_32_r201_m335,5_vs_5
1381,7,7,checkpoints_sp_c_nb_e2_ckpt667,0,m_sp_arch_medium_heads_bt_32_r201_m335,5_vs_5
1382,7,8,checkpoints_sp_c_nb_e2_ckpt667,1,m_sp_arch_medium_heads_bt_32_r201_m335,5_vs_5
1383,-7,1,checkpoints_sp_c_nb_e2_ckpt667,8,m_sp_arch_4x1_bt_32_r201_m335,5_vs_5
1384,-6,2,checkpoints_sp_c_nb_e2_ckpt667,8,m_sp_arch_4x1_bt_32_r201_m335,5_vs_5
1385,-1,0,checkpoints_sp_c_nb_e2_ckpt667,1,m_sp_arch_4x1_bt_32_r201_m335,5_vs_5
1386,-7,0,checkpoints_sp_c_nb_e2_ckpt667,7,m_sp_arch_4x1_bt_32_r201_m335,5_vs_5
1387,-4,1,checkpoints_sp_c_nb_e2_ckpt667,5,m_sp_arch_4x1_bt_32_r201_m335,5_vs_5
1388,-5,0,checkpoints_sp_c_nb_e2_ckpt667,5,m_sp_arch_4x1_bt_32_r201_cont3_m650,5_vs_5
1389,-4,0,checkpoints_sp_c_nb_e2_ckpt667,4,m_sp_arch_4x1_bt_32_r201_cont3_m650,5_vs_5
1390,-3,1,checkpoints_sp_c_nb_e2_ckpt667,4,m_sp_arch_4x1_bt_32_r201_cont3_m650,5_vs_5
1391,-1,1,checkpoints_sp_c_nb_e2_ckpt667,2,m_sp_arch_4x1_bt_32_r201_cont3_m650,5_vs_5
1392,-3,0,checkpoints_sp_c_nb_e2_ckpt667,3,m_sp_arch_4x1_bt_32_r201_cont3_m650,5_vs_5
1393,1,3,checkpoints_sp_c_nb_e2_ckpt667,2,explt_v0_7_2_m54,5_vs_5
1394,-3,1,checkpoints_sp_c_nb_e2_ckpt667,4,explt_v0_7_2_m54,5_vs_5
1395,-1,0,checkpoints_sp_c_nb_e2_ckpt667,1,explt_v0_7_2_m54,5_vs_5
1396,-1,2,checkpoints_sp_c_nb_e2_ckpt667,3,explt_v0_7_2_m54,5_vs_5
1397,-2,1,checkpoints_sp_c_nb_e2_ckpt667,3,explt_v0_7_2_m54,5_vs_5
1398,0,4,checkpoints_sp_c_nb_e2_ckpt667,4,m_sp_sc3v3_arch_2x1_32_r500_cont4x1_m224,5_vs_5
1399,-5,2,checkpoints_sp_c_nb_e2_ckpt667,7,m_sp_sc3v3_arch_2x1_32_r500_cont4x1_m224,5_vs_5
1400,-2,1,checkpoints_sp_c_nb_e2_ckpt667,3,m_sp_sc3v3_arch_2x1_32_r500_cont4x1_m224,5_vs_5
1401,-1,4,checkpoints_sp_c_nb_e2_ckpt667,5,m_sp_sc3v3_arch_2x1_32_r500_cont4x1_m224,5_vs_5
1402,-3,3,checkpoints_sp_c_nb_e2_ckpt667,6,m_sp_sc3v3_arch_2x1_32_r500_cont4x1_m224,5_vs_5
1403,-7,1,checkpoints_sp_c_nb_e2_ckpt667,8,m_sp_arch_4x1_bt_32_roles_r500_m335,5_vs_5
1404,-7,0,checkpoints_sp_c_nb_e2_ckpt667,7,m_sp_arch_4x1_bt_32_roles_r500_m335,5_vs_5
1405,-4,0,checkpoints_sp_c_nb_e2_ckpt667,4,m_sp_arch_4x1_bt_32_roles_r500_m335,5_vs_5
1406,-2,3,checkpoints_sp_c_nb_e2_ckpt667,5,m_sp_arch_4x1_bt_32_roles_r500_m335,5_vs_5
1407,-1,3,checkpoints_sp_c_nb_e2_ckpt667,4,m_sp_arch_4x1_bt_32_roles_r500_m335,5_vs_5
1408,3,3,m_sp_arch_4x1_bt_32_r201_m335,0,easy_bots,5_vs_5
1409,-1,0,m_sp_arch_4x1_bt_32_r201_m335,1,easy_bots,5_vs_5
1410,1,2,m_sp_arch_4x1_bt_32_r201_m335,1,easy_bots,5_vs_5
1411,2,3,m_sp_arch_4x1_bt_32_r201_m335,1,easy_bots,5_vs_5
1412,1,2,m_sp_arch_4x1_bt_32_r201_m335,1,medium_bots,5_vs_5_medium
1413,-3,0,m_sp_arch_4x1_bt_32_r201_m335,3,medium_bots,5_vs_5_medium
1414,0,0,m_sp_arch_4x1_bt_32_r201_m335,0,medium_bots,5_vs_5_medium
1415,-2,0,m_sp_arch_4x1_bt_32_r201_m335,2,medium_bots,5_vs_5_medium
1416,-2,0,m_sp_arch_4x1_bt_32_r201_m335,2,hard_bots,5_vs_5_hard
1417,1,1,m_sp_arch_4x1_bt_32_r201_m335,0,hard_bots,5_vs_5_hard
1418,2,2,m_sp_arch_4x1_bt_32_r201_m335,0,hard_bots,5_vs_5_hard
1419,-1,0,m_sp_arch_4x1_bt_32_r201_m335,1,hard_bots,5_vs_5_hard
1420,12,12,m_sp_arch_4x1_bt_32_r201_m335,0,f5v0to1to2t05_e2_ckpt291,5_vs_5
1421,9,9,m_sp_arch_4x1_bt_32_r201_m335,0,f5v0to1to2t05_e2_ckpt291,5_vs_5
1422,9,10,m_sp_arch_4x1_bt_32_r201_m335,1,f5v0to1to5_e2_ckpt252,5_vs_5
1423,6,7,m_sp_arch_4x1_bt_32_r201_m335,1,f5v0to1to5_e2_ckpt252,5_vs_5
1424,12,12,m_sp_arch_4x1_bt_32_r201_m335,0,scon_e3_p2_hard_ckpt840,5_vs_5
1425,11,12,m_sp_arch_4x1_bt_32_r201_m335,1,scon_e3_p2_hard_ckpt840,5_vs_5
1426,10,11,m_sp_arch_4x1_bt_32_r201_m335,1,less_then_partially_randomized_checkpoints_bots_4_heads_38_ckpt108,5_vs_5
1427,8,9,m_sp_arch_4x1_bt_32_r201_m335,1,less_then_partially_randomized_checkpoints_bots_4_heads_38_ckpt108,5_vs_5
1428,10,11,m_sp_arch_4x1_bt_32_r201_m335,1,less_then_partially_randomized_entropy_checkpoints_bots_4_heads_39_ckpt109,5_vs_5
1429,12,12,m_sp_arch_4x1_bt_32_r201_m335,0,less_then_partially_randomized_entropy_checkpoints_bots_4_heads_39_ckpt109,5_vs_5
1430,13,13,m_sp_arch_4x1_bt_32_r201_m335,0,reward_shaping_checkpoints_bots_4_heads_1_ckpt360,5_vs_5
1431,10,10,m_sp_arch_4x1_bt_32_r201_m335,0,reward_shaping_checkpoints_bots_4_heads_1_ckpt360,5_vs_5
1432,5,7,m_sp_arch_4x1_bt_32_r201_m335,2,checkpoints_selfplay_e9_sp_ckpt274,5_vs_5
1433,1,2,m_sp_arch_4x1_bt_32_r201_m335,1,checkpoints_selfplay_e9_sp_ckpt274,5_vs_5
1434,-1,1,m_sp_arch_4x1_bt_32_r201_m335,2,checkpoints_sp_c_nb_e2_ckpt667,5_vs_5
1435,1,4,m_sp_arch_4x1_bt_32_r201_m335,3,checkpoints_sp_c_nb_e2_ckpt667,5_vs_5
1436,6,6,m_sp_arch_4x1_bt_32_r201_m335,0,m_sp_arch_medium_heads_conv16_0_bt_32_r313_m335,5_vs_5
1437,2,4,m_sp_arch_4x1_bt_32_r201_m335,2,m_sp_arch_medium_heads_conv16_0_bt_32_r313_m335,5_vs_5
1438,6,7,m_sp_arch_4x1_bt_32_r201_m335,1,m_sp_arch_longer_heads_bt_32_r201_m335,5_vs_5
1439,8,11,m_sp_arch_4x1_bt_32_r201_m335,3,m_sp_arch_longer_heads_bt_32_r201_m335,5_vs_5
1440,5,5,m_sp_arch_4x1_bt_32_r201_m335,0,m_sp_arch_medium_heads_bt_32_r201_m335,5_vs_5
1441,6,7,m_sp_arch_4x1_bt_32_r201_m335,1,m_sp_arch_medium_heads_bt_32_r201_m335,5_vs_5
1442,2,3,m_sp_arch_4x1_bt_32_r201_m335,1,m_sp_arch_4x1_bt_32_r201_m335,5_vs_5
1443,1,1,m_sp_arch_4x1_bt_32_r201_m335,0,m_sp_arch_4x1_bt_32_r201_m335,5_vs_5
1444,-1,1,m_sp_arch_4x1_bt_32_r201_m335,2,m_sp_arch_4x1_bt_32_r201_cont3_m650,5_vs_5
1445,1,1,m_sp_arch_4x1_bt_32_r201_m335,0,m_sp_arch_4x1_bt_32_r201_cont3_m650,5_vs_5
1446,1,3,m_sp_arch_4x1_bt_32_r201_m335,2,explt_v0_7_2_m54,5_vs_5
1447,-1,1,m_sp_arch_4x1_bt_32_r201_m335,2,explt_v0_7_2_m54,5_vs_5
1448,-1,0,m_sp_arch_4x1_bt_32_r201_m335,1,m_sp_sc3v3_arch_2x1_32_r500_cont4x1_m224,5_vs_5
1449,4,7,m_sp_arch_4x1_bt_32_r201_m335,3,m_sp_sc3v3_arch_2x1_32_r500_cont4x1_m224,5_vs_5
1450,1,2,m_sp_arch_4x1_bt_32_r201_m335,1,m_sp_arch_4x1_bt_32_roles_r500_m335,5_vs_5
1451,-2,2,m_sp_arch_4x1_bt_32_r201_m335,4,m_sp_arch_4x1_bt_32_roles_r500_m335,5_vs_5
1452,1,2,m_sp_arch_medium_heads_conv16_0_bt_32_r313_m335,1,easy_bots,5_vs_5
1453,1,2,m_sp_arch_medium_heads_conv16_0_bt_32_r313_m335,1,easy_bots,5_vs_5
1454,0,2,m_sp_arch_medium_heads_conv16_0_bt_32_r313_m335,2,easy_bots,5_vs_5
1455,1,1,m_sp_arch_medium_heads_conv16_0_bt_32_r313_m335,0,easy_bots,5_vs_5
1456,1,1,m_sp_arch_medium_heads_conv16_0_bt_32_r313_m335,0,easy_bots,5_vs_5
1457,0,0,m_sp_arch_medium_heads_conv16_0_bt_32_r313_m335,0,easy_bots,5_vs_5
1458,-1,1,m_sp_arch_medium_heads_conv16_0_bt_32_r313_m335,2,medium_bots,5_vs_5_medium
1459,-1,2,m_sp_arch_medium_heads_conv16_0_bt_32_r313_m335,3,medium_bots,5_vs_5_medium
1460,-5,0,m_sp_arch_medium_heads_conv16_0_bt_32_r313_m335,5,medium_bots,5_vs_5_medium
1461,1,2,m_sp_arch_medium_heads_conv16_0_bt_32_r313_m335,1,medium_bots,5_vs_5_medium
1462,-3,1,m_sp_arch_medium_heads_conv16_0_bt_32_r313_m335,4,medium_bots,5_vs_5_medium
1463,-2,1,m_sp_arch_medium_heads_conv16_0_bt_32_r313_m335,3,medium_bots,5_vs_5_medium
1464,-3,1,m_sp_arch_medium_heads_conv16_0_bt_32_r313_m335,4,hard_bots,5_vs_5_hard
1465,-2,1,m_sp_arch_medium_heads_conv16_0_bt_32_r313_m335,3,hard_bots,5_vs_5_hard
1466,-1,0,m_sp_arch_medium_heads_conv16_0_bt_32_r313_m335,1,hard_bots,5_vs_5_hard
1467,-6,0,m_sp_arch_medium_heads_conv16_0_bt_32_r313_m335,6,hard_bots,5_vs_5_hard
1468,-4,0,m_sp_arch_medium_heads_conv16_0_bt_32_r313_m335,4,hard_bots,5_vs_5_hard
1469,-3,0,m_sp_arch_medium_heads_conv16_0_bt_32_r313_m335,3,hard_bots,5_vs_5_hard
1470,0,3,m_sp_arch_medium_heads_conv16_0_bt_32_r313_m335,3,f5v0to1to2t05_e2_ckpt291,5_vs_5
1471,-1,3,m_sp_arch_medium_heads_conv16_0_bt_32_r313_m335,4,f5v0to1to2t05_e2_ckpt291,5_vs_5
1472,1,3,m_sp_arch_medium_heads_conv16_0_bt_32_r313_m335,2,f5v0to1to2t05_e2_ckpt291,5_vs_5
1473,4,5,m_sp_arch_medium_heads_conv16_0_bt_32_r313_m335,1,f5v0to1to5_e2_ckpt252,5_vs_5
1474,2,2,m_sp_arch_medium_heads_conv16_0_bt_32_r313_m335,0,f5v0to1to5_e2_ckpt252,5_vs_5
1475,-1,3,m_sp_arch_medium_heads_conv16_0_bt_32_r313_m335,4,f5v0to1to5_e2_ckpt252,5_vs_5
1476,5,5,m_sp_arch_medium_heads_conv16_0_bt_32_r313_m335,0,scon_e3_p2_hard_ckpt840,5_vs_5
1477,3,4,m_sp_arch_medium_heads_conv16_0_bt_32_r313_m335,1,scon_e3_p2_hard_ckpt840,5_vs_5
1478,0,0,m_sp_arch_medium_heads_conv16_0_bt_32_r313_m335,0,scon_e3_p2_hard_ckpt840,5_vs_5
1479,1,4,m_sp_arch_medium_heads_conv16_0_bt_32_r313_m335,3,less_then_partially_randomized_checkpoints_bots_4_heads_38_ckpt108,5_vs_5
1480,-1,2,m_sp_arch_medium_heads_conv16_0_bt_32_r313_m335,3,less_then_partially_randomized_checkpoints_bots_4_heads_38_ckpt108,5_vs_5
1481,1,2,m_sp_arch_medium_heads_conv16_0_bt_32_r313_m335,1,less_then_partially_randomized_checkpoints_bots_4_heads_38_ckpt108,5_vs_5
1482,0,3,m_sp_arch_medium_heads_conv16_0_bt_32_r313_m335,3,less_then_partially_randomized_entropy_checkpoints_bots_4_heads_39_ckpt109,5_vs_5
1483,5,6,m_sp_arch_medium_heads_conv16_0_bt_32_r313_m335,1,less_then_partially_randomized_entropy_checkpoints_bots_4_heads_39_ckpt109,5_vs_5
1484,3,5,m_sp_arch_medium_heads_conv16_0_bt_32_r313_m335,2,less_then_partially_randomized_entropy_checkpoints_bots_4_heads_39_ckpt109,5_vs_5
1485,2,4,m_sp_arch_medium_heads_conv16_0_bt_32_r313_m335,2,reward_shaping_checkpoints_bots_4_heads_1_ckpt360,5_vs_5
1486,4,5,m_sp_arch_medium_heads_conv16_0_bt_32_r313_m335,1,reward_shaping_checkpoints_bots_4_heads_1_ckpt360,5_vs_5
1487,5,6,m_sp_arch_medium_heads_conv16_0_bt_32_r313_m335,1,reward_shaping_checkpoints_bots_4_heads_1_ckpt360,5_vs_5
1488,1,2,m_sp_arch_medium_heads_conv16_0_bt_32_r313_m335,1,checkpoints_selfplay_e9_sp_ckpt274,5_vs_5
1489,4,4,m_sp_arch_medium_heads_conv16_0_bt_32_r313_m335,0,checkpoints_selfplay_e9_sp_ckpt274,5_vs_5
1490,3,4,m_sp_arch_medium_heads_conv16_0_bt_32_r313_m335,1,checkpoints_selfplay_e9_sp_ckpt274,5_vs_5
1491,-4,2,m_sp_arch_medium_heads_conv16_0_bt_32_r313_m335,6,checkpoints_sp_c_nb_e2_ckpt667,5_vs_5
1492,-4,2,m_sp_arch_medium_heads_conv16_0_bt_32_r313_m335,6,checkpoints_sp_c_nb_e2_ckpt667,5_vs_5
1493,-1,2,m_sp_arch_medium_heads_conv16_0_bt_32_r313_m335,3,checkpoints_sp_c_nb_e2_ckpt667,5_vs_5
1494,2,3,m_sp_arch_medium_heads_conv16_0_bt_32_r313_m335,1,m_sp_arch_medium_heads_conv16_0_bt_32_r313_m335,5_vs_5
1495,1,1,m_sp_arch_medium_heads_conv16_0_bt_32_r313_m335,0,m_sp_arch_medium_heads_conv16_0_bt_32_r313_m335,5_vs_5
1496,4,5,m_sp_arch_medium_heads_conv16_0_bt_32_r313_m335,1,m_sp_arch_medium_heads_conv16_0_bt_32_r313_m335,5_vs_5
1497,0,1,m_sp_arch_medium_heads_conv16_0_bt_32_r313_m335,1,m_sp_arch_longer_heads_bt_32_r201_m335,5_vs_5
1498,0,2,m_sp_arch_medium_heads_conv16_0_bt_32_r313_m335,2,m_sp_arch_longer_heads_bt_32_r201_m335,5_vs_5
1499,1,3,m_sp_arch_medium_heads_conv16_0_bt_32_r313_m335,2,m_sp_arch_longer_heads_bt_32_r201_m335,5_vs_5
1500,1,2,m_sp_arch_medium_heads_conv16_0_bt_32_r313_m335,1,m_sp_arch_medium_heads_bt_32_r201_m335,5_vs_5
1501,3,5,m_sp_arch_medium_heads_conv16_0_bt_32_r313_m335,2,m_sp_arch_medium_heads_bt_32_r201_m335,5_vs_5
1502,2,3,m_sp_arch_medium_heads_conv16_0_bt_32_r313_m335,1,m_sp_arch_medium_heads_bt_32_r201_m335,5_vs_5
1503,-5,1,m_sp_arch_medium_heads_conv16_0_bt_32_r313_m335,6,m_sp_arch_4x1_bt_32_r201_m335,5_vs_5
1504,-6,0,m_sp_arch_medium_heads_conv16_0_bt_32_r313_m335,6,m_sp_arch_4x1_bt_32_r201_m335,5_vs_5
1505,-5,0,m_sp_arch_medium_heads_conv16_0_bt_32_r313_m335,5,m_sp_arch_4x1_bt_32_r201_m335,5_vs_5
1506,-7,0,m_sp_arch_medium_heads_conv16_0_bt_32_r313_m335,7,m_sp_arch_4x1_bt_32_r201_cont3_m650,5_vs_5
1507,-6,0,m_sp_arch_medium_heads_conv16_0_bt_32_r313_m335,6,m_sp_arch_4x1_bt_32_r201_cont3_m650,5_vs_5
1508,-4,0,m_sp_arch_medium_heads_conv16_0_bt_32_r313_m335,4,m_sp_arch_4x1_bt_32_r201_cont3_m650,5_vs_5
1509,-3,1,m_sp_arch_medium_heads_conv16_0_bt_32_r313_m335,4,explt_v0_7_2_m54,5_vs_5
1510,-2,0,m_sp_arch_medium_heads_conv16_0_bt_32_r313_m335,2,explt_v0_7_2_m54,5_vs_5
1511,0,1,m_sp_arch_medium_heads_conv16_0_bt_32_r313_m335,1,explt_v0_7_2_m54,5_vs_5
1512,-2,1,m_sp_arch_medium_heads_conv16_0_bt_32_r313_m335,3,m_sp_sc3v3_arch_2x1_32_r500_cont4x1_m224,5_vs_5
1513,-8,0,m_sp_arch_medium_heads_conv16_0_bt_32_r313_m335,8,m_sp_sc3v3_arch_2x1_32_r500_cont4x1_m224,5_vs_5
1514,-4,0,m_sp_arch_medium_heads_conv16_0_bt_32_r313_m335,4,m_sp_sc3v3_arch_2x1_32_r500_cont4x1_m224,5_vs_5
1515,-11,1,m_sp_arch_medium_heads_conv16_0_bt_32_r313_m335,12,m_sp_arch_4x1_bt_32_roles_r500_m335,5_vs_5
1516,-6,1,m_sp_arch_medium_heads_conv16_0_bt_32_r313_m335,7,m_sp_arch_4x1_bt_32_roles_r500_m335,5_vs_5
1517,-7,2,m_sp_arch_medium_heads_conv16_0_bt_32_r313_m335,9,m_sp_arch_4x1_bt_32_roles_r500_m335,5_vs_5
1518,3,4,explt_v0_7_2_m54,1,easy_bots,5_vs_5
1519,0,1,explt_v0_7_2_m54,1,easy_bots,5_vs_5
1520,2,2,explt_v0_7_2_m54,0,easy_bots,5_vs_5
1521,2,2,explt_v0_7_2_m54,0,easy_bots,5_vs_5
1522,4,4,explt_v0_7_2_m54,0,easy_bots,5_vs_5
1523,1,2,explt_v0_7_2_m54,1,easy_bots,5_vs_5
1524,-1,2,explt_v0_7_2_m54,3,medium_bots,5_vs_5_medium
1525,-2,1,explt_v0_7_2_m54,3,medium_bots,5_vs_5_medium
1526,0,0,explt_v0_7_2_m54,0,medium_bots,5_vs_5_medium
1527,1,1,explt_v0_7_2_m54,0,medium_bots,5_vs_5_medium
1528,0,1,explt_v0_7_2_m54,1,medium_bots,5_vs_5_medium
1529,1,1,explt_v0_7_2_m54,0,medium_bots,5_vs_5_medium
1530,-1,0,explt_v0_7_2_m54,1,hard_bots,5_vs_5_hard
1531,0,0,explt_v0_7_2_m54,0,hard_bots,5_vs_5_hard
1532,0,0,explt_v0_7_2_m54,0,hard_bots,5_vs_5_hard
1533,-1,0,explt_v0_7_2_m54,1,hard_bots,5_vs_5_hard
1534,-1,1,explt_v0_7_2_m54,2,hard_bots,5_vs_5_hard
1535,-2,0,explt_v0_7_2_m54,2,hard_bots,5_vs_5_hard
1536,4,4,explt_v0_7_2_m54,0,f5v0to1to2t05_e2_ckpt291,5_vs_5
1537,4,4,explt_v0_7_2_m54,0,f5v0to1to2t05_e2_ckpt291,5_vs_5
1538,2,3,explt_v0_7_2_m54,1,f5v0to1to2t05_e2_ckpt291,5_vs_5
1539,2,3,explt_v0_7_2_m54,1,f5v0to1to5_e2_ckpt252,5_vs_5
1540,3,3,explt_v0_7_2_m54,0,f5v0to1to5_e2_ckpt252,5_vs_5
1541,4,5,explt_v0_7_2_m54,1,f5v0to1to5_e2_ckpt252,5_vs_5
1542,2,2,explt_v0_7_2_m54,0,scon_e3_p2_hard_ckpt840,5_vs_5
1543,3,3,explt_v0_7_2_m54,0,scon_e3_p2_hard_ckpt840,5_vs_5
1544,1,1,explt_v0_7_2_m54,0,scon_e3_p2_hard_ckpt840,5_vs_5
1545,1,2,explt_v0_7_2_m54,1,less_then_partially_randomized_checkpoints_bots_4_heads_38_ckpt108,5_vs_5
1546,3,4,explt_v0_7_2_m54,1,less_then_partially_randomized_checkpoints_bots_4_heads_38_ckpt108,5_vs_5
1547,-1,0,explt_v0_7_2_m54,1,less_then_partially_randomized_checkpoints_bots_4_heads_38_ckpt108,5_vs_5
1548,1,1,explt_v0_7_2_m54,0,less_then_partially_randomized_entropy_checkpoints_bots_4_heads_39_ckpt109,5_vs_5
1549,1,2,explt_v0_7_2_m54,1,less_then_partially_randomized_entropy_checkpoints_bots_4_heads_39_ckpt109,5_vs_5
1550,1,2,explt_v0_7_2_m54,1,less_then_partially_randomized_entropy_checkpoints_bots_4_heads_39_ckpt109,5_vs_5
1551,2,3,explt_v0_7_2_m54,1,reward_shaping_checkpoints_bots_4_heads_1_ckpt360,5_vs_5
1552,1,1,explt_v0_7_2_m54,0,reward_shaping_checkpoints_bots_4_heads_1_ckpt360,5_vs_5
1553,4,4,explt_v0_7_2_m54,0,reward_shaping_checkpoints_bots_4_heads_1_ckpt360,5_vs_5
1554,1,2,explt_v0_7_2_m54,1,checkpoints_selfplay_e9_sp_ckpt274,5_vs_5
1555,2,3,explt_v0_7_2_m54,1,checkpoints_selfplay_e9_sp_ckpt274,5_vs_5
1556,0,2,explt_v0_7_2_m54,2,checkpoints_selfplay_e9_sp_ckpt274,5_vs_5
1557,0,1,explt_v0_7_2_m54,1,checkpoints_sp_c_nb_e2_ckpt667,5_vs_5
1558,6,7,explt_v0_7_2_m54,1,checkpoints_sp_c_nb_e2_ckpt667,5_vs_5
1559,0,3,explt_v0_7_2_m54,3,checkpoints_sp_c_nb_e2_ckpt667,5_vs_5
1560,-1,1,explt_v0_7_2_m54,2,m_sp_arch_medium_heads_conv16_0_bt_32_r313_m335,5_vs_5
1561,2,2,explt_v0_7_2_m54,0,m_sp_arch_medium_heads_conv16_0_bt_32_r313_m335,5_vs_5
1562,3,3,explt_v0_7_2_m54,0,m_sp_arch_medium_heads_conv16_0_bt_32_r313_m335,5_vs_5
1563,0,2,explt_v0_7_2_m54,2,m_sp_arch_longer_heads_bt_32_r201_m335,5_vs_5
1564,5,5,explt_v0_7_2_m54,0,m_sp_arch_longer_heads_bt_32_r201_m335,5_vs_5
1565,2,2,explt_v0_7_2_m54,0,m_sp_arch_longer_heads_bt_32_r201_m335,5_vs_5
1566,1,3,explt_v0_7_2_m54,2,m_sp_arch_medium_heads_bt_32_r201_m335,5_vs_5
1567,3,3,explt_v0_7_2_m54,0,m_sp_arch_medium_heads_bt_32_r201_m335,5_vs_5
1568,0,1,explt_v0_7_2_m54,1,m_sp_arch_medium_heads_bt_32_r201_m335,5_vs_5
1569,3,3,explt_v0_7_2_m54,0,m_sp_arch_4x1_bt_32_r201_m335,5_vs_5
1570,0,1,explt_v0_7_2_m54,1,m_sp_arch_4x1_bt_32_r201_m335,5_vs_5
1571,1,2,explt_v0_7_2_m54,1,m_sp_arch_4x1_bt_32_r201_m335,5_vs_5
1572,0,1,explt_v0_7_2_m54,1,m_sp_arch_4x1_bt_32_r201_cont3_m650,5_vs_5
1573,-1,3,explt_v0_7_2_m54,4,m_sp_arch_4x1_bt_32_r201_cont3_m650,5_vs_5
1574,1,2,explt_v0_7_2_m54,1,m_sp_arch_4x1_bt_32_r201_cont3_m650,5_vs_5
1575,0,1,explt_v0_7_2_m54,1,explt_v0_7_2_m54,5_vs_5
1576,-2,1,explt_v0_7_2_m54,3,explt_v0_7_2_m54,5_vs_5
1577,0,2,explt_v0_7_2_m54,2,explt_v0_7_2_m54,5_vs_5
1578,0,2,explt_v0_7_2_m54,2,m_sp_sc3v3_arch_2x1_32_r500_cont4x1_m224,5_vs_5
1579,0,1,explt_v0_7_2_m54,1,m_sp_sc3v3_arch_2x1_32_r500_cont4x1_m224,5_vs_5
1580,-2,1,explt_v0_7_2_m54,3,m_sp_sc3v3_arch_2x1_32_r500_cont4x1_m224,5_vs_5
1581,-2,1,explt_v0_7_2_m54,3,m_sp_arch_4x1_bt_32_roles_r500_m335,5_vs_5
1582,0,1,explt_v0_7_2_m54,1,m_sp_arch_4x1_bt_32_roles_r500_m335,5_vs_5
1583,0,2,explt_v0_7_2_m54,2,m_sp_arch_4x1_bt_32_roles_r500_m335,5_vs_5
1584,5,5,explt_v0_7_2_m54,0,easy_bots,5_vs_5
1585,5,5,explt_v0_7_2_m54,0,easy_bots,5_vs_5
1586,2,2,explt_v0_7_2_m54,0,easy_bots,5_vs_5
1587,2,3,explt_v0_7_2_m54,1,easy_bots,5_vs_5
1588,-2,0,explt_v0_7_2_m54,2,medium_bots,5_vs_5_medium
1589,1,2,explt_v0_7_2_m54,1,medium_bots,5_vs_5_medium
1590,-1,0,explt_v0_7_2_m54,1,medium_bots,5_vs_5_medium
1591,0,2,explt_v0_7_2_m54,2,medium_bots,5_vs_5_medium
1592,0,1,explt_v0_7_2_m54,1,hard_bots,5_vs_5_hard
1593,-3,0,explt_v0_7_2_m54,3,hard_bots,5_vs_5_hard
1594,-1,0,explt_v0_7_2_m54,1,hard_bots,5_vs_5_hard
1595,-2,0,explt_v0_7_2_m54,2,hard_bots,5_vs_5_hard
1596,3,3,explt_v0_7_2_m54,0,f5v0to1to2t05_e2_ckpt291,5_vs_5
1597,-1,0,explt_v0_7_2_m54,1,f5v0to1to2t05_e2_ckpt291,5_vs_5
1598,7,7,explt_v0_7_2_m54,0,f5v0to1to5_e2_ckpt252,5_vs_5
1599,2,4,explt_v0_7_2_m54,2,f5v0to1to5_e2_ckpt252,5_vs_5
1600,2,2,explt_v0_7_2_m54,0,scon_e3_p2_hard_ckpt840,5_vs_5
1601,3,3,explt_v0_7_2_m54,0,scon_e3_p2_hard_ckpt840,5_vs_5
1602,2,4,explt_v0_7_2_m54,2,less_then_partially_randomized_checkpoints_bots_4_heads_38_ckpt108,5_vs_5
1603,6,6,explt_v0_7_2_m54,0,less_then_partially_randomized_checkpoints_bots_4_heads_38_ckpt108,5_vs_5
1604,4,5,explt_v0_7_2_m54,1,less_then_partially_randomized_entropy_checkpoints_bots_4_heads_39_ckpt109,5_vs_5
1605,3,4,explt_v0_7_2_m54,1,less_then_partially_randomized_entropy_checkpoints_bots_4_heads_39_ckpt109,5_vs_5
1606,3,3,explt_v0_7_2_m54,0,reward_shaping_checkpoints_bots_4_heads_1_ckpt360,5_vs_5
1607,1,1,explt_v0_7_2_m54,0,reward_shaping_checkpoints_bots_4_heads_1_ckpt360,5_vs_5
1608,1,2,explt_v0_7_2_m54,1,checkpoints_selfplay_e9_sp_ckpt274,5_vs_5
1609,1,1,explt_v0_7_2_m54,0,checkpoints_selfplay_e9_sp_ckpt274,5_vs_5
1610,0,1,explt_v0_7_2_m54,1,checkpoints_sp_c_nb_e2_ckpt667,5_vs_5
1611,1,4,explt_v0_7_2_m54,3,checkpoints_sp_c_nb_e2_ckpt667,5_vs_5
1612,7,7,explt_v0_7_2_m54,0,m_sp_arch_medium_heads_conv16_0_bt_32_r313_m335,5_vs_5
1613,1,1,explt_v0_7_2_m54,0,m_sp_arch_medium_heads_conv16_0_bt_32_r313_m335,5_vs_5
1614,1,2,explt_v0_7_2_m54,1,m_sp_arch_longer_heads_bt_32_r201_m335,5_vs_5
1615,4,4,explt_v0_7_2_m54,0,m_sp_arch_longer_heads_bt_32_r201_m335,5_vs_5
1616,2,3,explt_v0_7_2_m54,1,m_sp_arch_medium_heads_bt_32_r201_m335,5_vs_5
1617,2,3,explt_v0_7_2_m54,1,m_sp_arch_medium_heads_bt_32_r201_m335,5_vs_5
1618,0,3,explt_v0_7_2_m54,3,m_sp_arch_4x1_bt_32_r201_m335,5_vs_5
1619,1,2,explt_v0_7_2_m54,1,m_sp_arch_4x1_bt_32_r201_m335,5_vs_5
1620,1,2,explt_v0_7_2_m54,1,m_sp_arch_4x1_bt_32_r201_cont3_m650,5_vs_5
1621,3,4,explt_v0_7_2_m54,1,m_sp_arch_4x1_bt_32_r201_cont3_m650,5_vs_5
1622,1,2,explt_v0_7_2_m54,1,explt_v0_7_2_m54,5_vs_5
1623,1,3,explt_v0_7_2_m54,2,explt_v0_7_2_m54,5_vs_5
1624,-3,0,explt_v0_7_2_m54,3,m_sp_sc3v3_arch_2x1_32_r500_cont4x1_m224,5_vs_5
1625,-1,3,explt_v0_7_2_m54,4,m_sp_sc3v3_arch_2x1_32_r500_cont4x1_m224,5_vs_5
1626,-2,3,explt_v0_7_2_m54,5,m_sp_arch_4x1_bt_32_roles_r500_m335,5_vs_5
1627,-1,2,explt_v0_7_2_m54,3,m_sp_arch_4x1_bt_32_roles_r500_m335,5_vs_5
1628,0,1,m_sp_arch_medium_heads_bt_32_r201_m335,1,easy_bots,5_vs_5
1629,0,0,m_sp_arch_medium_heads_bt_32_r201_m335,0,easy_bots,5_vs_5
1630,-1,1,m_sp_arch_medium_heads_bt_32_r201_m335,2,easy_bots,5_vs_5
1631,-2,0,m_sp_arch_medium_heads_bt_32_r201_m335,2,easy_bots,5_vs_5
1632,-1,1,m_sp_arch_medium_heads_bt_32_r201_m335,2,easy_bots,5_vs_5
1633,-2,1,m_sp_arch_medium_heads_bt_32_r201_m335,3,easy_bots,5_vs_5
1634,1,1,m_sp_arch_medium_heads_bt_32_r201_m335,0,easy_bots,5_vs_5
1635,1,1,m_sp_arch_medium_heads_bt_32_r201_m335,0,easy_bots,5_vs_5
1636,1,3,m_sp_arch_medium_heads_bt_32_r201_m335,2,easy_bots,5_vs_5
1637,-1,1,m_sp_arch_medium_heads_bt_32_r201_m335,2,easy_bots,5_vs_5
1638,-2,0,m_sp_arch_medium_heads_bt_32_r201_m335,2,medium_bots,5_vs_5_medium
1639,0,1,m_sp_arch_medium_heads_bt_32_r201_m335,1,medium_bots,5_vs_5_medium
1640,-2,1,m_sp_arch_medium_heads_bt_32_r201_m335,3,medium_bots,5_vs_5_medium
1641,-1,0,m_sp_arch_medium_heads_bt_32_r201_m335,1,medium_bots,5_vs_5_medium
1642,-1,0,m_sp_arch_medium_heads_bt_32_r201_m335,1,medium_bots,5_vs_5_medium
1643,-2,0,m_sp_arch_medium_heads_bt_32_r201_m335,2,medium_bots,5_vs_5_medium
1644,-2,1,m_sp_arch_medium_heads_bt_32_r201_m335,3,medium_bots,5_vs_5_medium
1645,-2,1,m_sp_arch_medium_heads_bt_32_r201_m335,3,medium_bots,5_vs_5_medium
1646,-1,0,m_sp_arch_medium_heads_bt_32_r201_m335,1,medium_bots,5_vs_5_medium
1647,-6,2,m_sp_arch_medium_heads_bt_32_r201_m335,8,medium_bots,5_vs_5_medium
1648,-2,0,m_sp_arch_medium_heads_bt_32_r201_m335,2,hard_bots,5_vs_5_hard
1649,-2,0,m_sp_arch_medium_heads_bt_32_r201_m335,2,hard_bots,5_vs_5_hard
1650,-5,0,m_sp_arch_medium_heads_bt_32_r201_m335,5,hard_bots,5_vs_5_hard
1651,-4,0,m_sp_arch_medium_heads_bt_32_r201_m335,4,hard_bots,5_vs_5_hard
1652,-4,0,m_sp_arch_medium_heads_bt_32_r201_m335,4,hard_bots,5_vs_5_hard
1653,-3,0,m_sp_arch_medium_heads_bt_32_r201_m335,3,hard_bots,5_vs_5_hard
1654,-3,0,m_sp_arch_medium_heads_bt_32_r201_m335,3,hard_bots,5_vs_5_hard
1655,-6,0,m_sp_arch_medium_heads_bt_32_r201_m335,6,hard_bots,5_vs_5_hard
1656,-3,1,m_sp_arch_medium_heads_bt_32_r201_m335,4,hard_bots,5_vs_5_hard
1657,0,0,m_sp_arch_medium_heads_bt_32_r201_m335,0,hard_bots,5_vs_5_hard
1658,6,6,m_sp_arch_medium_heads_bt_32_r201_m335,0,f5v0to1to2t05_e2_ckpt291,5_vs_5
1659,5,7,m_sp_arch_medium_heads_bt_32_r201_m335,2,f5v0to1to2t05_e2_ckpt291,5_vs_5
1660,6,7,m_sp_arch_medium_heads_bt_32_r201_m335,1,f5v0to1to2t05_e2_ckpt291,5_vs_5
1661,5,7,m_sp_arch_medium_heads_bt_32_r201_m335,2,f5v0to1to2t05_e2_ckpt291,5_vs_5
1662,4,5,m_sp_arch_medium_heads_bt_32_r201_m335,1,f5v0to1to2t05_e2_ckpt291,5_vs_5
1663,3,5,m_sp_arch_medium_heads_bt_32_r201_m335,2,f5v0to1to5_e2_ckpt252,5_vs_5
1664,2,3,m_sp_arch_medium_heads_bt_32_r201_m335,1,f5v0to1to5_e2_ckpt252,5_vs_5
1665,4,5,m_sp_arch_medium_heads_bt_32_r201_m335,1,f5v0to1to5_e2_ckpt252,5_vs_5
1666,3,4,m_sp_arch_medium_heads_bt_32_r201_m335,1,f5v0to1to5_e2_ckpt252,5_vs_5
1667,2,2,m_sp_arch_medium_heads_bt_32_r201_m335,0,f5v0to1to5_e2_ckpt252,5_vs_5
1668,8,8,m_sp_arch_medium_heads_bt_32_r201_m335,0,scon_e3_p2_hard_ckpt840,5_vs_5
1669,10,10,m_sp_arch_medium_heads_bt_32_r201_m335,0,scon_e3_p2_hard_ckpt840,5_vs_5
1670,10,10,m_sp_arch_medium_heads_bt_32_r201_m335,0,scon_e3_p2_hard_ckpt840,5_vs_5
1671,6,7,m_sp_arch_medium_heads_bt_32_r201_m335,1,scon_e3_p2_hard_ckpt840,5_vs_5
1672,7,7,m_sp_arch_medium_heads_bt_32_r201_m335,0,scon_e3_p2_hard_ckpt840,5_vs_5
1673,1,4,m_sp_arch_medium_heads_bt_32_r201_m335,3,less_then_partially_randomized_checkpoints_bots_4_heads_38_ckpt108,5_vs_5
1674,5,5,m_sp_arch_medium_heads_bt_32_r201_m335,0,less_then_partially_randomized_checkpoints_bots_4_heads_38_ckpt108,5_vs_5
1675,8,9,m_sp_arch_medium_heads_bt_32_r201_m335,1,less_then_partially_randomized_checkpoints_bots_4_heads_38_ckpt108,5_vs_5
1676,7,10,m_sp_arch_medium_heads_bt_32_r201_m335,3,less_then_partially_randomized_checkpoints_bots_4_heads_38_ckpt108,5_vs_5
1677,4,5,m_sp_arch_medium_heads_bt_32_r201_m335,1,less_then_partially_randomized_checkpoints_bots_4_heads_38_ckpt108,5_vs_5
1678,3,7,m_sp_arch_medium_heads_bt_32_r201_m335,4,less_then_partially_randomized_entropy_checkpoints_bots_4_heads_39_ckpt109,5_vs_5
1679,11,12,m_sp_arch_medium_heads_bt_32_r201_m335,1,less_then_partially_randomized_entropy_checkpoints_bots_4_heads_39_ckpt109,5_vs_5
1680,7,9,m_sp_arch_medium_heads_bt_32_r201_m335,2,less_then_partially_randomized_entropy_checkpoints_bots_4_heads_39_ckpt109,5_vs_5
1681,4,5,m_sp_arch_medium_heads_bt_32_r201_m335,1,less_then_partially_randomized_entropy_checkpoints_bots_4_heads_39_ckpt109,5_vs_5
1682,4,8,m_sp_arch_medium_heads_bt_32_r201_m335,4,less_then_partially_randomized_entropy_checkpoints_bots_4_heads_39_ckpt109,5_vs_5
1683,6,8,m_sp_arch_medium_heads_bt_32_r201_m335,2,reward_shaping_checkpoints_bots_4_heads_1_ckpt360,5_vs_5
1684,6,7,m_sp_arch_medium_heads_bt_32_r201_m335,1,reward_shaping_checkpoints_bots_4_heads_1_ckpt360,5_vs_5
1685,7,8,m_sp_arch_medium_heads_bt_32_r201_m335,1,reward_shaping_checkpoints_bots_4_heads_1_ckpt360,5_vs_5
1686,8,9,m_sp_arch_medium_heads_bt_32_r201_m335,1,reward_shaping_checkpoints_bots_4_heads_1_ckpt360,5_vs_5
1687,8,9,m_sp_arch_medium_heads_bt_32_r201_m335,1,reward_shaping_checkpoints_bots_4_heads_1_ckpt360,5_vs_5
1688,-1,2,m_sp_arch_medium_heads_bt_32_r201_m335,3,checkpoints_selfplay_e9_sp_ckpt274,5_vs_5
1689,0,4,m_sp_arch_medium_heads_bt_32_r201_m335,4,checkpoints_selfplay_e9_sp_ckpt274,5_vs_5
1690,1,4,m_sp_arch_medium_heads_bt_32_r201_m335,3,checkpoints_selfplay_e9_sp_ckpt274,5_vs_5
1691,1,3,m_sp_arch_medium_heads_bt_32_r201_m335,2,checkpoints_selfplay_e9_sp_ckpt274,5_vs_5
1692,2,5,m_sp_arch_medium_heads_bt_32_r201_m335,3,checkpoints_selfplay_e9_sp_ckpt274,5_vs_5
1693,-6,0,m_sp_arch_medium_heads_bt_32_r201_m335,6,checkpoints_sp_c_nb_e2_ckpt667,5_vs_5
1694,-6,0,m_sp_arch_medium_heads_bt_32_r201_m335,6,checkpoints_sp_c_nb_e2_ckpt667,5_vs_5
1695,-6,0,m_sp_arch_medium_heads_bt_32_r201_m335,6,checkpoints_sp_c_nb_e2_ckpt667,5_vs_5
1696,-4,0,m_sp_arch_medium_heads_bt_32_r201_m335,4,checkpoints_sp_c_nb_e2_ckpt667,5_vs_5
1697,-4,2,m_sp_arch_medium_heads_bt_32_r201_m335,6,checkpoints_sp_c_nb_e2_ckpt667,5_vs_5
1698,2,5,m_sp_arch_medium_heads_bt_32_r201_m335,3,m_sp_arch_medium_heads_conv16_0_bt_32_r313_m335,5_vs_5
1699,-3,1,m_sp_arch_medium_heads_bt_32_r201_m335,4,m_sp_arch_medium_heads_conv16_0_bt_32_r313_m335,5_vs_5
1700,-2,0,m_sp_arch_medium_heads_bt_32_r201_m335,2,m_sp_arch_medium_heads_conv16_0_bt_32_r313_m335,5_vs_5
1701,0,2,m_sp_arch_medium_heads_bt_32_r201_m335,2,m_sp_arch_medium_heads_conv16_0_bt_32_r313_m335,5_vs_5
1702,-1,0,m_sp_arch_medium_heads_bt_32_r201_m335,1,m_sp_arch_medium_heads_conv16_0_bt_32_r313_m335,5_vs_5
1703,-4,1,m_sp_arch_medium_heads_bt_32_r201_m335,5,m_sp_arch_longer_heads_bt_32_r201_m335,5_vs_5
1704,-3,1,m_sp_arch_medium_heads_bt_32_r201_m335,4,m_sp_arch_longer_heads_bt_32_r201_m335,5_vs_5
1705,0,1,m_sp_arch_medium_heads_bt_32_r201_m335,1,m_sp_arch_longer_heads_bt_32_r201_m335,5_vs_5
1706,-5,1,m_sp_arch_medium_heads_bt_32_r201_m335,6,m_sp_arch_longer_heads_bt_32_r201_m335,5_vs_5
1707,2,3,m_sp_arch_medium_heads_bt_32_r201_m335,1,m_sp_arch_longer_heads_bt_32_r201_m335,5_vs_5
1708,-1,1,m_sp_arch_medium_heads_bt_32_r201_m335,2,m_sp_arch_medium_heads_bt_32_r201_m335,5_vs_5
1709,4,4,m_sp_arch_medium_heads_bt_32_r201_m335,0,m_sp_arch_medium_heads_bt_32_r201_m335,5_vs_5
1710,-1,0,m_sp_arch_medium_heads_bt_32_r201_m335,1,m_sp_arch_medium_heads_bt_32_r201_m335,5_vs_5
1711,1,2,m_sp_arch_medium_heads_bt_32_r201_m335,1,m_sp_arch_medium_heads_bt_32_r201_m335,5_vs_5
1712,0,2,m_sp_arch_medium_heads_bt_32_r201_m335,2,m_sp_arch_medium_heads_bt_32_r201_m335,5_vs_5
1713,-4,1,m_sp_arch_medium_heads_bt_32_r201_m335,5,m_sp_arch_4x1_bt_32_r201_m335,5_vs_5
1714,-6,0,m_sp_arch_medium_heads_bt_32_r201_m335,6,m_sp_arch_4x1_bt_32_r201_m335,5_vs_5
1715,-10,0,m_sp_arch_medium_heads_bt_32_r201_m335,10,m_sp_arch_4x1_bt_32_r201_m335,5_vs_5
1716,-8,0,m_sp_arch_medium_heads_bt_32_r201_m335,8,m_sp_arch_4x1_bt_32_r201_m335,5_vs_5
1717,-4,0,m_sp_arch_medium_heads_bt_32_r201_m335,4,m_sp_arch_4x1_bt_32_r201_m335,5_vs_5
1718,-4,1,m_sp_arch_medium_heads_bt_32_r201_m335,5,m_sp_arch_4x1_bt_32_r201_cont3_m650,5_vs_5
1719,-4,0,m_sp_arch_medium_heads_bt_32_r201_m335,4,m_sp_arch_4x1_bt_32_r201_cont3_m650,5_vs_5
1720,-6,0,m_sp_arch_medium_heads_bt_32_r201_m335,6,m_sp_arch_4x1_bt_32_r201_cont3_m650,5_vs_5
1721,-5,0,m_sp_arch_medium_heads_bt_32_r201_m335,5,m_sp_arch_4x1_bt_32_r201_cont3_m650,5_vs_5
1722,-8,0,m_sp_arch_medium_heads_bt_32_r201_m335,8,m_sp_arch_4x1_bt_32_r201_cont3_m650,5_vs_5
1723,0,2,m_sp_arch_medium_heads_bt_32_r201_m335,2,explt_v0_7_2_m54,5_vs_5
1724,-3,1,m_sp_arch_medium_heads_bt_32_r201_m335,4,explt_v0_7_2_m54,5_vs_5
1725,-1,0,m_sp_arch_medium_heads_bt_32_r201_m335,1,explt_v0_7_2_m54,5_vs_5
1726,-1,0,m_sp_arch_medium_heads_bt_32_r201_m335,1,explt_v0_7_2_m54,5_vs_5
1727,1,1,m_sp_arch_medium_heads_bt_32_r201_m335,0,explt_v0_7_2_m54,5_vs_5
1728,-4,1,m_sp_arch_medium_heads_bt_32_r201_m335,5,m_sp_sc3v3_arch_2x1_32_r500_cont4x1_m224,5_vs_5
1729,-3,2,m_sp_arch_medium_heads_bt_32_r201_m335,5,m_sp_sc3v3_arch_2x1_32_r500_cont4x1_m224,5_vs_5
1730,-6,2,m_sp_arch_medium_heads_bt_32_r201_m335,8,m_sp_sc3v3_arch_2x1_32_r500_cont4x1_m224,5_vs_5
1731,-3,2,m_sp_arch_medium_heads_bt_32_r201_m335,5,m_sp_sc3v3_arch_2x1_32_r500_cont4x1_m224,5_vs_5
1732,-7,1,m_sp_arch_medium_heads_bt_32_r201_m335,8,m_sp_sc3v3_arch_2x1_32_r500_cont4x1_m224,5_vs_5
1733,-4,0,m_sp_arch_medium_heads_bt_32_r201_m335,4,m_sp_arch_4x1_bt_32_roles_r500_m335,5_vs_5
1734,-3,0,m_sp_arch_medium_heads_bt_32_r201_m335,3,m_sp_arch_4x1_bt_32_roles_r500_m335,5_vs_5
1735,-8,0,m_sp_arch_medium_heads_bt_32_r201_m335,8,m_sp_arch_4x1_bt_32_roles_r500_m335,5_vs_5
1736,-6,0,m_sp_arch_medium_heads_bt_32_r201_m335,6,m_sp_arch_4x1_bt_32_roles_r500_m335,5_vs_5
1737,-4,2,m_sp_arch_medium_heads_bt_32_r201_m335,6,m_sp_arch_4x1_bt_32_roles_r500_m335,5_vs_5
1738,3,3,m_sp_arch_4x1_bt_32_roles_r500_m335,0,easy_bots,5_vs_5
1739,2,4,m_sp_arch_4x1_bt_32_roles_r500_m335,2,easy_bots,5_vs_5
1740,2,3,m_sp_arch_4x1_bt_32_roles_r500_m335,1,easy_bots,5_vs_5
1741,1,1,m_sp_arch_4x1_bt_32_roles_r500_m335,0,easy_bots,5_vs_5
1742,1,2,m_sp_arch_4x1_bt_32_roles_r500_m335,1,medium_bots,5_vs_5_medium
1743,0,0,m_sp_arch_4x1_bt_32_roles_r500_m335,0,medium_bots,5_vs_5_medium
1744,1,1,m_sp_arch_4x1_bt_32_roles_r500_m335,0,medium_bots,5_vs_5_medium
1745,0,1,m_sp_arch_4x1_bt_32_roles_r500_m335,1,medium_bots,5_vs_5_medium
1746,0,3,m_sp_arch_4x1_bt_32_roles_r500_m335,3,hard_bots,5_vs_5_hard
1747,1,2,m_sp_arch_4x1_bt_32_roles_r500_m335,1,hard_bots,5_vs_5_hard
1748,0,2,m_sp_arch_4x1_bt_32_roles_r500_m335,2,hard_bots,5_vs_5_hard
1749,-1,1,m_sp_arch_4x1_bt_32_roles_r500_m335,2,hard_bots,5_vs_5_hard
1750,11,12,m_sp_arch_4x1_bt_32_roles_r500_m335,1,f5v0to1to2t05_e2_ckpt291,5_vs_5
1751,10,10,m_sp_arch_4x1_bt_32_roles_r500_m335,0,f5v0to1to2t05_e2_ckpt291,5_vs_5
1752,11,13,m_sp_arch_4x1_bt_32_roles_r500_m335,2,f5v0to1to5_e2_ckpt252,5_vs_5
1753,9,9,m_sp_arch_4x1_bt_32_roles_r500_m335,0,f5v0to1to5_e2_ckpt252,5_vs_5
1754,16,17,m_sp_arch_4x1_bt_32_roles_r500_m335,1,scon_e3_p2_hard_ckpt840,5_vs_5
1755,10,10,m_sp_arch_4x1_bt_32_roles_r500_m335,0,scon_e3_p2_hard_ckpt840,5_vs_5
1756,12,12,m_sp_arch_4x1_bt_32_roles_r500_m335,0,less_then_partially_randomized_checkpoints_bots_4_heads_38_ckpt108,5_vs_5
1757,12,12,m_sp_arch_4x1_bt_32_roles_r500_m335,0,less_then_partially_randomized_checkpoints_bots_4_heads_38_ckpt108,5_vs_5
1758,11,13,m_sp_arch_4x1_bt_32_roles_r500_m335,2,less_then_partially_randomized_entropy_checkpoints_bots_4_heads_39_ckpt109,5_vs_5
1759,12,13,m_sp_arch_4x1_bt_32_roles_r500_m335,1,less_then_partially_randomized_entropy_checkpoints_bots_4_heads_39_ckpt109,5_vs_5
1760,15,15,m_sp_arch_4x1_bt_32_roles_r500_m335,0,reward_shaping_checkpoints_bots_4_heads_1_ckpt360,5_vs_5
1761,10,10,m_sp_arch_4x1_bt_32_roles_r500_m335,0,reward_shaping_checkpoints_bots_4_heads_1_ckpt360,5_vs_5
1762,4,6,m_sp_arch_4x1_bt_32_roles_r500_m335,2,checkpoints_selfplay_e9_sp_ckpt274,5_vs_5
1763,5,8,m_sp_arch_4x1_bt_32_roles_r500_m335,3,checkpoints_selfplay_e9_sp_ckpt274,5_vs_5
1764,-1,2,m_sp_arch_4x1_bt_32_roles_r500_m335,3,checkpoints_sp_c_nb_e2_ckpt667,5_vs_5
1765,3,5,m_sp_arch_4x1_bt_32_roles_r500_m335,2,checkpoints_sp_c_nb_e2_ckpt667,5_vs_5
1766,6,7,m_sp_arch_4x1_bt_32_roles_r500_m335,1,m_sp_arch_medium_heads_conv16_0_bt_32_r313_m335,5_vs_5
1767,10,10,m_sp_arch_4x1_bt_32_roles_r500_m335,0,m_sp_arch_medium_heads_conv16_0_bt_32_r313_m335,5_vs_5
1768,7,7,m_sp_arch_4x1_bt_32_roles_r500_m335,0,m_sp_arch_longer_heads_bt_32_r201_m335,5_vs_5
1769,7,8,m_sp_arch_4x1_bt_32_roles_r500_m335,1,m_sp_arch_longer_heads_bt_32_r201_m335,5_vs_5
1770,5,5,m_sp_arch_4x1_bt_32_roles_r500_m335,0,m_sp_arch_medium_heads_bt_32_r201_m335,5_vs_5
1771,7,7,m_sp_arch_4x1_bt_32_roles_r500_m335,0,m_sp_arch_medium_heads_bt_32_r201_m335,5_vs_5
1772,1,2,m_sp_arch_4x1_bt_32_roles_r500_m335,1,m_sp_arch_4x1_bt_32_r201_m335,5_vs_5
1773,-2,1,m_sp_arch_4x1_bt_32_roles_r500_m335,3,m_sp_arch_4x1_bt_32_r201_m335,5_vs_5
1774,2,3,m_sp_arch_4x1_bt_32_roles_r500_m335,1,m_sp_arch_4x1_bt_32_r201_cont3_m650,5_vs_5
1775,0,2,m_sp_arch_4x1_bt_32_roles_r500_m335,2,m_sp_arch_4x1_bt_32_r201_cont3_m650,5_vs_5
1776,4,4,m_sp_arch_4x1_bt_32_roles_r500_m335,0,explt_v0_7_2_m54,5_vs_5
1777,2,2,m_sp_arch_4x1_bt_32_roles_r500_m335,0,explt_v0_7_2_m54,5_vs_5
1778,3,4,m_sp_arch_4x1_bt_32_roles_r500_m335,1,m_sp_sc3v3_arch_2x1_32_r500_cont4x1_m224,5_vs_5
1779,-1,3,m_sp_arch_4x1_bt_32_roles_r500_m335,4,m_sp_sc3v3_arch_2x1_32_r500_cont4x1_m224,5_vs_5
1780,1,4,m_sp_arch_4x1_bt_32_roles_r500_m335,3,m_sp_arch_4x1_bt_32_roles_r500_m335,5_vs_5
1781,2,2,m_sp_arch_4x1_bt_32_roles_r500_m335,0,m_sp_arch_4x1_bt_32_roles_r500_m335,5_vs_5
1782,-1,1,m_sp_arch_longer_heads_bt_32_r201_m335,2,easy_bots,5_vs_5
1783,-1,0,m_sp_arch_longer_heads_bt_32_r201_m335,1,easy_bots,5_vs_5
1784,0,1,m_sp_arch_longer_heads_bt_32_r201_m335,1,easy_bots,5_vs_5
1785,-1,0,m_sp_arch_longer_heads_bt_32_r201_m335,1,easy_bots,5_vs_5
1786,-2,1,m_sp_arch_longer_heads_bt_32_r201_m335,3,easy_bots,5_vs_5
1787,2,2,m_sp_arch_longer_heads_bt_32_r201_m335,0,easy_bots,5_vs_5
1788,-1,1,m_sp_arch_longer_heads_bt_32_r201_m335,2,easy_bots,5_vs_5
1789,-2,0,m_sp_arch_longer_heads_bt_32_r201_m335,2,easy_bots,5_vs_5
1790,-1,0,m_sp_arch_longer_heads_bt_32_r201_m335,1,easy_bots,5_vs_5
1791,0,2,m_sp_arch_longer_heads_bt_32_r201_m335,2,easy_bots,5_vs_5
1792,-1,1,m_sp_arch_longer_heads_bt_32_r201_m335,2,medium_bots,5_vs_5_medium
1793,-1,0,m_sp_arch_longer_heads_bt_32_r201_m335,1,medium_bots,5_vs_5_medium
1794,-2,0,m_sp_arch_longer_heads_bt_32_r201_m335,2,medium_bots,5_vs_5_medium
1795,-2,0,m_sp_arch_longer_heads_bt_32_r201_m335,2,medium_bots,5_vs_5_medium
1796,0,1,m_sp_arch_longer_heads_bt_32_r201_m335,1,medium_bots,5_vs_5_medium
1797,-3,1,m_sp_arch_longer_heads_bt_32_r201_m335,4,medium_bots,5_vs_5_medium
1798,-1,0,m_sp_arch_longer_heads_bt_32_r201_m335,1,medium_bots,5_vs_5_medium
1799,0,2,m_sp_arch_longer_heads_bt_32_r201_m335,2,medium_bots,5_vs_5_medium
1800,-2,0,m_sp_arch_longer_heads_bt_32_r201_m335,2,medium_bots,5_vs_5_medium
1801,-3,0,m_sp_arch_longer_heads_bt_32_r201_m335,3,medium_bots,5_vs_5_medium
1802,0,1,m_sp_arch_longer_heads_bt_32_r201_m335,1,hard_bots,5_vs_5_hard
1803,-5,0,m_sp_arch_longer_heads_bt_32_r201_m335,5,hard_bots,5_vs_5_hard
1804,-2,0,m_sp_arch_longer_heads_bt_32_r201_m335,2,hard_bots,5_vs_5_hard
1805,-3,0,m_sp_arch_longer_heads_bt_32_r201_m335,3,hard_bots,5_vs_5_hard
1806,-1,0,m_sp_arch_longer_heads_bt_32_r201_m335,1,hard_bots,5_vs_5_hard
1807,-2,1,m_sp_arch_longer_heads_bt_32_r201_m335,3,hard_bots,5_vs_5_hard
1808,-1,0,m_sp_arch_longer_heads_bt_32_r201_m335,1,hard_bots,5_vs_5_hard
1809,-1,0,m_sp_arch_longer_heads_bt_32_r201_m335,1,hard_bots,5_vs_5_hard
1810,0,0,m_sp_arch_longer_heads_bt_32_r201_m335,0,hard_bots,5_vs_5_hard
1811,0,0,m_sp_arch_longer_heads_bt_32_r201_m335,0,hard_bots,5_vs_5_hard
1812,5,7,m_sp_arch_longer_heads_bt_32_r201_m335,2,f5v0to1to2t05_e2_ckpt291,5_vs_5
1813,2,4,m_sp_arch_longer_heads_bt_32_r201_m335,2,f5v0to1to2t05_e2_ckpt291,5_vs_5
1814,9,9,m_sp_arch_longer_heads_bt_32_r201_m335,0,f5v0to1to2t05_e2_ckpt291,5_vs_5
1815,5,6,m_sp_arch_longer_heads_bt_32_r201_m335,1,f5v0to1to2t05_e2_ckpt291,5_vs_5
1816,-1,1,m_sp_arch_longer_heads_bt_32_r201_m335,2,f5v0to1to2t05_e2_ckpt291,5_vs_5
1817,3,6,m_sp_arch_longer_heads_bt_32_r201_m335,3,f5v0to1to5_e2_ckpt252,5_vs_5
1818,7,8,m_sp_arch_longer_heads_bt_32_r201_m335,1,f5v0to1to5_e2_ckpt252,5_vs_5
1819,4,4,m_sp_arch_longer_heads_bt_32_r201_m335,0,f5v0to1to5_e2_ckpt252,5_vs_5
1820,3,3,m_sp_arch_longer_heads_bt_32_r201_m335,0,f5v0to1to5_e2_ckpt252,5_vs_5
1821,5,6,m_sp_arch_longer_heads_bt_32_r201_m335,1,f5v0to1to5_e2_ckpt252,5_vs_5
1822,5,6,m_sp_arch_longer_heads_bt_32_r201_m335,1,scon_e3_p2_hard_ckpt840,5_vs_5
1823,2,3,m_sp_arch_longer_heads_bt_32_r201_m335,1,scon_e3_p2_hard_ckpt840,5_vs_5
1824,1,3,m_sp_arch_longer_heads_bt_32_r201_m335,2,scon_e3_p2_hard_ckpt840,5_vs_5
1825,6,6,m_sp_arch_longer_heads_bt_32_r201_m335,0,scon_e3_p2_hard_ckpt840,5_vs_5
1826,4,4,m_sp_arch_longer_heads_bt_32_r201_m335,0,scon_e3_p2_hard_ckpt840,5_vs_5
1827,7,8,m_sp_arch_longer_heads_bt_32_r201_m335,1,less_then_partially_randomized_checkpoints_bots_4_heads_38_ckpt108,5_vs_5
1828,2,3,m_sp_arch_longer_heads_bt_32_r201_m335,1,less_then_partially_randomized_checkpoints_bots_4_heads_38_ckpt108,5_vs_5
1829,4,5,m_sp_arch_longer_heads_bt_32_r201_m335,1,less_then_partially_randomized_checkpoints_bots_4_heads_38_ckpt108,5_vs_5
1830,3,3,m_sp_arch_longer_heads_bt_32_r201_m335,0,less_then_partially_randomized_checkpoints_bots_4_heads_38_ckpt108,5_vs_5
1831,6,7,m_sp_arch_longer_heads_bt_32_r201_m335,1,less_then_partially_randomized_checkpoints_bots_4_heads_38_ckpt108,5_vs_5
1832,1,2,m_sp_arch_longer_heads_bt_32_r201_m335,1,less_then_partially_randomized_entropy_checkpoints_bots_4_heads_39_ckpt109,5_vs_5
1833,5,5,m_sp_arch_longer_heads_bt_32_r201_m335,0,less_then_partially_randomized_entropy_checkpoints_bots_4_heads_39_ckpt109,5_vs_5
1834,4,5,m_sp_arch_longer_heads_bt_32_r201_m335,1,less_then_partially_randomized_entropy_checkpoints_bots_4_heads_39_ckpt109,5_vs_5
1835,3,4,m_sp_arch_longer_heads_bt_32_r201_m335,1,less_then_partially_randomized_entropy_checkpoints_bots_4_heads_39_ckpt109,5_vs_5
1836,6,6,m_sp_arch_longer_heads_bt_32_r201_m335,0,less_then_partially_randomized_entropy_checkpoints_bots_4_heads_39_ckpt109,5_vs_5
1837,2,4,m_sp_arch_longer_heads_bt_32_r201_m335,2,reward_shaping_checkpoints_bots_4_heads_1_ckpt360,5_vs_5
1838,6,6,m_sp_arch_longer_heads_bt_32_r201_m335,0,reward_shaping_checkpoints_bots_4_heads_1_ckpt360,5_vs_5
1839,4,5,m_sp_arch_longer_heads_bt_32_r201_m335,1,reward_shaping_checkpoints_bots_4_heads_1_ckpt360,5_vs_5
1840,4,4,m_sp_arch_longer_heads_bt_32_r201_m335,0,reward_shaping_checkpoints_bots_4_heads_1_ckpt360,5_vs_5
1841,5,6,m_sp_arch_longer_heads_bt_32_r201_m335,1,reward_shaping_checkpoints_bots_4_heads_1_ckpt360,5_vs_5
1842,4,7,m_sp_arch_longer_heads_bt_32_r201_m335,3,checkpoints_selfplay_e9_sp_ckpt274,5_vs_5
1843,3,5,m_sp_arch_longer_heads_bt_32_r201_m335,2,checkpoints_selfplay_e9_sp_ckpt274,5_vs_5
1844,2,5,m_sp_arch_longer_heads_bt_32_r201_m335,3,checkpoints_selfplay_e9_sp_ckpt274,5_vs_5
1845,2,4,m_sp_arch_longer_heads_bt_32_r201_m335,2,checkpoints_selfplay_e9_sp_ckpt274,5_vs_5
1846,6,7,m_sp_arch_longer_heads_bt_32_r201_m335,1,checkpoints_selfplay_e9_sp_ckpt274,5_vs_5
1847,-5,0,m_sp_arch_longer_heads_bt_32_r201_m335,5,checkpoints_sp_c_nb_e2_ckpt667,5_vs_5
1848,-2,3,m_sp_arch_longer_heads_bt_32_r201_m335,5,checkpoints_sp_c_nb_e2_ckpt667,5_vs_5
1849,-1,4,m_sp_arch_longer_heads_bt_32_r201_m335,5,checkpoints_sp_c_nb_e2_ckpt667,5_vs_5
1850,-7,1,m_sp_arch_longer_heads_bt_32_r201_m335,8,checkpoints_sp_c_nb_e2_ckpt667,5_vs_5
1851,-7,0,m_sp_arch_longer_heads_bt_32_r201_m335,7,checkpoints_sp_c_nb_e2_ckpt667,5_vs_5
1852,-3,0,m_sp_arch_longer_heads_bt_32_r201_m335,3,m_sp_arch_medium_heads_conv16_0_bt_32_r313_m335,5_vs_5
1853,0,3,m_sp_arch_longer_heads_bt_32_r201_m335,3,m_sp_arch_medium_heads_conv16_0_bt_32_r313_m335,5_vs_5
1854,2,3,m_sp_arch_longer_heads_bt_32_r201_m335,1,m_sp_arch_medium_heads_conv16_0_bt_32_r313_m335,5_vs_5
1855,-5,1,m_sp_arch_longer_heads_bt_32_r201_m335,6,m_sp_arch_medium_heads_conv16_0_bt_32_r313_m335,5_vs_5
1856,6,6,m_sp_arch_longer_heads_bt_32_r201_m335,0,m_sp_arch_medium_heads_conv16_0_bt_32_r313_m335,5_vs_5
1857,2,2,m_sp_arch_longer_heads_bt_32_r201_m335,0,m_sp_arch_longer_heads_bt_32_r201_m335,5_vs_5
1858,-2,2,m_sp_arch_longer_heads_bt_32_r201_m335,4,m_sp_arch_longer_heads_bt_32_r201_m335,5_vs_5
1859,-2,1,m_sp_arch_longer_heads_bt_32_r201_m335,3,m_sp_arch_longer_heads_bt_32_r201_m335,5_vs_5
1860,-1,1,m_sp_arch_longer_heads_bt_32_r201_m335,2,m_sp_arch_longer_heads_bt_32_r201_m335,5_vs_5
1861,1,1,m_sp_arch_longer_heads_bt_32_r201_m335,0,m_sp_arch_longer_heads_bt_32_r201_m335,5_vs_5
1862,1,3,m_sp_arch_longer_heads_bt_32_r201_m335,2,m_sp_arch_medium_heads_bt_32_r201_m335,5_vs_5
1863,0,1,m_sp_arch_longer_heads_bt_32_r201_m335,1,m_sp_arch_medium_heads_bt_32_r201_m335,5_vs_5
1864,2,4,m_sp_arch_longer_heads_bt_32_r201_m335,2,m_sp_arch_medium_heads_bt_32_r201_m335,5_vs_5
1865,1,3,m_sp_arch_longer_heads_bt_32_r201_m335,2,m_sp_arch_medium_heads_bt_32_r201_m335,5_vs_5
1866,0,2,m_sp_arch_longer_heads_bt_32_r201_m335,2,m_sp_arch_medium_heads_bt_32_r201_m335,5_vs_5
1867,0,2,m_sp_arch_longer_heads_bt_32_r201_m335,2,m_sp_arch_4x1_bt_32_r201_m335,5_vs_5
1868,-8,1,m_sp_arch_longer_heads_bt_32_r201_m335,9,m_sp_arch_4x1_bt_32_r201_m335,5_vs_5
1869,-7,0,m_sp_arch_longer_heads_bt_32_r201_m335,7,m_sp_arch_4x1_bt_32_r201_m335,5_vs_5
1870,-2,0,m_sp_arch_longer_heads_bt_32_r201_m335,2,m_sp_arch_4x1_bt_32_r201_m335,5_vs_5
1871,-8,0,m_sp_arch_longer_heads_bt_32_r201_m335,8,m_sp_arch_4x1_bt_32_r201_m335,5_vs_5
1872,-4,0,m_sp_arch_longer_heads_bt_32_r201_m335,4,m_sp_arch_4x1_bt_32_r201_cont3_m650,5_vs_5
1873,-7,0,m_sp_arch_longer_heads_bt_32_r201_m335,7,m_sp_arch_4x1_bt_32_r201_cont3_m650,5_vs_5
1874,-5,0,m_sp_arch_longer_heads_bt_32_r201_m335,5,m_sp_arch_4x1_bt_32_r201_cont3_m650,5_vs_5
1875,-7,0,m_sp_arch_longer_heads_bt_32_r201_m335,7,m_sp_arch_4x1_bt_32_r201_cont3_m650,5_vs_5
1876,-3,2,m_sp_arch_longer_heads_bt_32_r201_m335,5,m_sp_arch_4x1_bt_32_r201_cont3_m650,5_vs_5
1877,-2,1,m_sp_arch_longer_heads_bt_32_r201_m335,3,explt_v0_7_2_m54,5_vs_5
1878,-3,0,m_sp_arch_longer_heads_bt_32_r201_m335,3,explt_v0_7_2_m54,5_vs_5
1879,-3,0,m_sp_arch_longer_heads_bt_32_r201_m335,3,explt_v0_7_2_m54,5_vs_5
1880,-3,0,m_sp_arch_longer_heads_bt_32_r201_m335,3,explt_v0_7_2_m54,5_vs_5
1881,-1,1,m_sp_arch_longer_heads_bt_32_r201_m335,2,explt_v0_7_2_m54,5_vs_5
1882,-3,1,m_sp_arch_longer_heads_bt_32_r201_m335,4,m_sp_sc3v3_arch_2x1_32_r500_cont4x1_m224,5_vs_5
1883,-4,1,m_sp_arch_longer_heads_bt_32_r201_m335,5,m_sp_sc3v3_arch_2x1_32_r500_cont4x1_m224,5_vs_5
1884,-8,0,m_sp_arch_longer_heads_bt_32_r201_m335,8,m_sp_sc3v3_arch_2x1_32_r500_cont4x1_m224,5_vs_5
1885,-5,0,m_sp_arch_longer_heads_bt_32_r201_m335,5,m_sp_sc3v3_arch_2x1_32_r500_cont4x1_m224,5_vs_5
1886,-7,0,m_sp_arch_longer_heads_bt_32_r201_m335,7,m_sp_sc3v3_arch_2x1_32_r500_cont4x1_m224,5_vs_5
1887,-6,0,m_sp_arch_longer_heads_bt_32_r201_m335,6,m_sp_arch_4x1_bt_32_roles_r500_m335,5_vs_5
1888,-4,0,m_sp_arch_longer_heads_bt_32_r201_m335,4,m_sp_arch_4x1_bt_32_roles_r500_m335,5_vs_5
1889,-3,2,m_sp_arch_longer_heads_bt_32_r201_m335,5,m_sp_arch_4x1_bt_32_roles_r500_m335,5_vs_5
1890,-4,1,m_sp_arch_longer_heads_bt_32_r201_m335,5,m_sp_arch_4x1_bt_32_roles_r500_m335,5_vs_5
1891,-4,0,m_sp_arch_longer_heads_bt_32_r201_m335,4,m_sp_arch_4x1_bt_32_roles_r500_m335,5_vs_5
1892,6,9,reward_shaping_checkpoints_bots_4_heads_1_ckpt360,3,easy_bots,5_vs_5
1893,4,7,reward_shaping_checkpoints_bots_4_heads_1_ckpt360,3,easy_bots,5_vs_5
1894,3,4,reward_shaping_checkpoints_bots_4_heads_1_ckpt360,1,easy_bots,5_vs_5
1895,7,8,reward_shaping_checkpoints_bots_4_heads_1_ckpt360,1,easy_bots,5_vs_5
1896,2,5,reward_shaping_checkpoints_bots_4_heads_1_ckpt360,3,medium_bots,5_vs_5_medium
1897,7,7,reward_shaping_checkpoints_bots_4_heads_1_ckpt360,0,medium_bots,5_vs_5_medium
1898,1,5,reward_shaping_checkpoints_bots_4_heads_1_ckpt360,4,medium_bots,5_vs_5_medium
1899,4,5,reward_shaping_checkpoints_bots_4_heads_1_ckpt360,1,medium_bots,5_vs_5_medium
1900,2,3,reward_shaping_checkpoints_bots_4_heads_1_ckpt360,1,hard_bots,5_vs_5_hard
1901,2,5,reward_shaping_checkpoints_bots_4_heads_1_ckpt360,3,hard_bots,5_vs_5_hard
1902,-1,1,reward_shaping_checkpoints_bots_4_heads_1_ckpt360,2,hard_bots,5_vs_5_hard
1903,1,3,reward_shaping_checkpoints_bots_4_heads_1_ckpt360,2,hard_bots,5_vs_5_hard
1904,-4,2,reward_shaping_checkpoints_bots_4_heads_1_ckpt360,6,f5v0to1to2t05_e2_ckpt291,5_vs_5
1905,-2,0,reward_shaping_checkpoints_bots_4_heads_1_ckpt360,2,f5v0to1to2t05_e2_ckpt291,5_vs_5
1906,-4,1,reward_shaping_checkpoints_bots_4_heads_1_ckpt360,5,f5v0to1to5_e2_ckpt252,5_vs_5
1907,-5,0,reward_shaping_checkpoints_bots_4_heads_1_ckpt360,5,f5v0to1to5_e2_ckpt252,5_vs_5
1908,-2,1,reward_shaping_checkpoints_bots_4_heads_1_ckpt360,3,scon_e3_p2_hard_ckpt840,5_vs_5
1909,-3,1,reward_shaping_checkpoints_bots_4_heads_1_ckpt360,4,scon_e3_p2_hard_ckpt840,5_vs_5
1910,1,2,reward_shaping_checkpoints_bots_4_heads_1_ckpt360,1,less_then_partially_randomized_checkpoints_bots_4_heads_38_ckpt108,5_vs_5
1911,-1,4,reward_shaping_checkpoints_bots_4_heads_1_ckpt360,5,less_then_partially_randomized_checkpoints_bots_4_heads_38_ckpt108,5_vs_5
1912,-2,1,reward_shaping_checkpoints_bots_4_heads_1_ckpt360,3,less_then_partially_randomized_entropy_checkpoints_bots_4_heads_39_ckpt109,5_vs_5
1913,-4,3,reward_shaping_checkpoints_bots_4_heads_1_ckpt360,7,less_then_partially_randomized_entropy_checkpoints_bots_4_heads_39_ckpt109,5_vs_5
1914,3,3,reward_shaping_checkpoints_bots_4_heads_1_ckpt360,0,reward_shaping_checkpoints_bots_4_heads_1_ckpt360,5_vs_5
1915,1,3,reward_shaping_checkpoints_bots_4_heads_1_ckpt360,2,reward_shaping_checkpoints_bots_4_heads_1_ckpt360,5_vs_5
1916,-13,1,reward_shaping_checkpoints_bots_4_heads_1_ckpt360,14,checkpoints_selfplay_e9_sp_ckpt274,5_vs_5
1917,-11,0,reward_shaping_checkpoints_bots_4_heads_1_ckpt360,11,checkpoints_selfplay_e9_sp_ckpt274,5_vs_5
1918,-5,1,reward_shaping_checkpoints_bots_4_heads_1_ckpt360,6,checkpoints_sp_c_nb_e2_ckpt667,5_vs_5
1919,-3,1,reward_shaping_checkpoints_bots_4_heads_1_ckpt360,4,checkpoints_sp_c_nb_e2_ckpt667,5_vs_5
1920,-2,1,reward_shaping_checkpoints_bots_4_heads_1_ckpt360,3,m_sp_arch_medium_heads_conv16_0_bt_32_r313_m335,5_vs_5
1921,-3,2,reward_shaping_checkpoints_bots_4_heads_1_ckpt360,5,m_sp_arch_medium_heads_conv16_0_bt_32_r313_m335,5_vs_5
1922,-7,0,reward_shaping_checkpoints_bots_4_heads_1_ckpt360,7,m_sp_arch_longer_heads_bt_32_r201_m335,5_vs_5
1923,-7,0,reward_shaping_checkpoints_bots_4_heads_1_ckpt360,7,m_sp_arch_longer_heads_bt_32_r201_m335,5_vs_5
1924,-8,1,reward_shaping_checkpoints_bots_4_heads_1_ckpt360,9,m_sp_arch_medium_heads_bt_32_r201_m335,5_vs_5
1925,-10,1,reward_shaping_checkpoints_bots_4_heads_1_ckpt360,11,m_sp_arch_medium_heads_bt_32_r201_m335,5_vs_5
1926,-10,0,reward_shaping_checkpoints_bots_4_heads_1_ckpt360,10,m_sp_arch_4x1_bt_32_r201_m335,5_vs_5
1927,-6,0,reward_shaping_checkpoints_bots_4_heads_1_ckpt360,6,m_sp_arch_4x1_bt_32_r201_m335,5_vs_5
1928,-12,0,reward_shaping_checkpoints_bots_4_heads_1_ckpt360,12,m_sp_arch_4x1_bt_32_r201_cont3_m650,5_vs_5
1929,-13,1,reward_shaping_checkpoints_bots_4_heads_1_ckpt360,14,m_sp_arch_4x1_bt_32_r201_cont3_m650,5_vs_5
1930,-4,0,reward_shaping_checkpoints_bots_4_heads_1_ckpt360,4,explt_v0_7_2_m54,5_vs_5
1931,0,1,reward_shaping_checkpoints_bots_4_heads_1_ckpt360,1,explt_v0_7_2_m54,5_vs_5
1932,-12,0,reward_shaping_checkpoints_bots_4_heads_1_ckpt360,12,m_sp_sc3v3_arch_2x1_32_r500_cont4x1_m224,5_vs_5
1933,-14,0,reward_shaping_checkpoints_bots_4_heads_1_ckpt360,14,m_sp_sc3v3_arch_2x1_32_r500_cont4x1_m224,5_vs_5
1934,-11,1,reward_shaping_checkpoints_bots_4_heads_1_ckpt360,12,m_sp_arch_4x1_bt_32_roles_r500_m335,5_vs_5
1935,-15,0,reward_shaping_checkpoints_bots_4_heads_1_ckpt360,15,m_sp_arch_4x1_bt_32_roles_r500_m335,5_vs_5
1936,1,1,m_sp_arch_longer_heads_bt_32_r201_m335,0,easy_bots,5_vs_5
1937,-2,0,m_sp_arch_longer_heads_bt_32_r201_m335,2,easy_bots,5_vs_5
1938,-1,1,m_sp_arch_longer_heads_bt_32_r201_m335,2,easy_bots,5_vs_5
1939,-1,0,m_sp_arch_longer_heads_bt_32_r201_m335,1,easy_bots,5_vs_5
1940,2,2,m_sp_arch_longer_heads_bt_32_r201_m335,0,easy_bots,5_vs_5
1941,-1,0,m_sp_arch_longer_heads_bt_32_r201_m335,1,easy_bots,5_vs_5
1942,-1,1,m_sp_arch_longer_heads_bt_32_r201_m335,2,medium_bots,5_vs_5_medium
1943,-3,0,m_sp_arch_longer_heads_bt_32_r201_m335,3,medium_bots,5_vs_5_medium
1944,-1,1,m_sp_arch_longer_heads_bt_32_r201_m335,2,medium_bots,5_vs_5_medium
1945,-2,0,m_sp_arch_longer_heads_bt_32_r201_m335,2,medium_bots,5_vs_5_medium
1946,-1,1,m_sp_arch_longer_heads_bt_32_r201_m335,2,medium_bots,5_vs_5_medium
1947,-2,1,m_sp_arch_longer_heads_bt_32_r201_m335,3,medium_bots,5_vs_5_medium
1948,-2,0,m_sp_arch_longer_heads_bt_32_r201_m335,2,hard_bots,5_vs_5_hard
1949,0,0,m_sp_arch_longer_heads_bt_32_r201_m335,0,hard_bots,5_vs_5_hard
1950,-3,0,m_sp_arch_longer_heads_bt_32_r201_m335,3,hard_bots,5_vs_5_hard
1951,0,0,m_sp_arch_longer_heads_bt_32_r201_m335,0,hard_bots,5_vs_5_hard
1952,-1,0,m_sp_arch_longer_heads_bt_32_r201_m335,1,hard_bots,5_vs_5_hard
1953,-2,0,m_sp_arch_longer_heads_bt_32_r201_m335,2,hard_bots,5_vs_5_hard
1954,5,5,m_sp_arch_longer_heads_bt_32_r201_m335,0,f5v0to1to2t05_e2_ckpt291,5_vs_5
1955,4,4,m_sp_arch_longer_heads_bt_32_r201_m335,0,f5v0to1to2t05_e2_ckpt291,5_vs_5
1956,7,8,m_sp_arch_longer_heads_bt_32_r201_m335,1,f5v0to1to2t05_e2_ckpt291,5_vs_5
1957,4,6,m_sp_arch_longer_heads_bt_32_r201_m335,2,f5v0to1to5_e2_ckpt252,5_vs_5
1958,4,5,m_sp_arch_longer_heads_bt_32_r201_m335,1,f5v0to1to5_e2_ckpt252,5_vs_5
1959,3,5,m_sp_arch_longer_heads_bt_32_r201_m335,2,f5v0to1to5_e2_ckpt252,5_vs_5
1960,3,4,m_sp_arch_longer_heads_bt_32_r201_m335,1,scon_e3_p2_hard_ckpt840,5_vs_5
1961,4,4,m_sp_arch_longer_heads_bt_32_r201_m335,0,scon_e3_p2_hard_ckpt840,5_vs_5
1962,6,8,m_sp_arch_longer_heads_bt_32_r201_m335,2,scon_e3_p2_hard_ckpt840,5_vs_5
1963,5,6,m_sp_arch_longer_heads_bt_32_r201_m335,1,less_then_partially_randomized_checkpoints_bots_4_heads_38_ckpt108,5_vs_5
1964,5,5,m_sp_arch_longer_heads_bt_32_r201_m335,0,less_then_partially_randomized_checkpoints_bots_4_heads_38_ckpt108,5_vs_5
1965,5,5,m_sp_arch_longer_heads_bt_32_r201_m335,0,less_then_partially_randomized_checkpoints_bots_4_heads_38_ckpt108,5_vs_5
1966,2,4,m_sp_arch_longer_heads_bt_32_r201_m335,2,less_then_partially_randomized_entropy_checkpoints_bots_4_heads_39_ckpt109,5_vs_5
1967,2,3,m_sp_arch_longer_heads_bt_32_r201_m335,1,less_then_partially_randomized_entropy_checkpoints_bots_4_heads_39_ckpt109,5_vs_5
1968,1,3,m_sp_arch_longer_heads_bt_32_r201_m335,2,less_then_partially_randomized_entropy_checkpoints_bots_4_heads_39_ckpt109,5_vs_5
1969,1,1,m_sp_arch_longer_heads_bt_32_r201_m335,0,reward_shaping_checkpoints_bots_4_heads_1_ckpt360,5_vs_5
1970,5,6,m_sp_arch_longer_heads_bt_32_r201_m335,1,reward_shaping_checkpoints_bots_4_heads_1_ckpt360,5_vs_5
1971,4,5,m_sp_arch_longer_heads_bt_32_r201_m335,1,reward_shaping_checkpoints_bots_4_heads_1_ckpt360,5_vs_5
1972,1,3,m_sp_arch_longer_heads_bt_32_r201_m335,2,checkpoints_selfplay_e9_sp_ckpt274,5_vs_5
1973,0,2,m_sp_arch_longer_heads_bt_32_r201_m335,2,checkpoints_selfplay_e9_sp_ckpt274,5_vs_5
1974,-1,3,m_sp_arch_longer_heads_bt_32_r201_m335,4,checkpoints_selfplay_e9_sp_ckpt274,5_vs_5
1975,-2,1,m_sp_arch_longer_heads_bt_32_r201_m335,3,checkpoints_sp_c_nb_e2_ckpt667,5_vs_5
1976,-3,4,m_sp_arch_longer_heads_bt_32_r201_m335,7,checkpoints_sp_c_nb_e2_ckpt667,5_vs_5
1977,-3,1,m_sp_arch_longer_heads_bt_32_r201_m335,4,checkpoints_sp_c_nb_e2_ckpt667,5_vs_5
1978,0,0,m_sp_arch_longer_heads_bt_32_r201_m335,0,m_sp_arch_medium_heads_conv16_0_bt_32_r313_m335,5_vs_5
1979,0,0,m_sp_arch_longer_heads_bt_32_r201_m335,0,m_sp_arch_medium_heads_conv16_0_bt_32_r313_m335,5_vs_5
1980,1,3,m_sp_arch_longer_heads_bt_32_r201_m335,2,m_sp_arch_medium_heads_conv16_0_bt_32_r313_m335,5_vs_5
1981,-5,0,m_sp_arch_longer_heads_bt_32_r201_m335,5,m_sp_arch_longer_heads_bt_32_r201_m335,5_vs_5
1982,-2,2,m_sp_arch_longer_heads_bt_32_r201_m335,4,m_sp_arch_longer_heads_bt_32_r201_m335,5_vs_5
1983,2,4,m_sp_arch_longer_heads_bt_32_r201_m335,2,m_sp_arch_longer_heads_bt_32_r201_m335,5_vs_5
1984,3,4,m_sp_arch_longer_heads_bt_32_r201_m335,1,m_sp_arch_medium_heads_bt_32_r201_m335,5_vs_5
1985,0,3,m_sp_arch_longer_heads_bt_32_r201_m335,3,m_sp_arch_medium_heads_bt_32_r201_m335,5_vs_5
1986,-1,2,m_sp_arch_longer_heads_bt_32_r201_m335,3,m_sp_arch_medium_heads_bt_32_r201_m335,5_vs_5
1987,-4,0,m_sp_arch_longer_heads_bt_32_r201_m335,4,m_sp_arch_4x1_bt_32_r201_m335,5_vs_5
1988,-7,0,m_sp_arch_longer_heads_bt_32_r201_m335,7,m_sp_arch_4x1_bt_32_r201_m335,5_vs_5
1989,-5,2,m_sp_arch_longer_heads_bt_32_r201_m335,7,m_sp_arch_4x1_bt_32_r201_m335,5_vs_5
1990,-4,0,m_sp_arch_longer_heads_bt_32_r201_m335,4,m_sp_arch_4x1_bt_32_r201_cont3_m650,5_vs_5
1991,-7,0,m_sp_arch_longer_heads_bt_32_r201_m335,7,m_sp_arch_4x1_bt_32_r201_cont3_m650,5_vs_5
1992,-4,1,m_sp_arch_longer_heads_bt_32_r201_m335,5,m_sp_arch_4x1_bt_32_r201_cont3_m650,5_vs_5
1993,-1,1,m_sp_arch_longer_heads_bt_32_r201_m335,2,explt_v0_7_2_m54,5_vs_5
1994,-1,1,m_sp_arch_longer_heads_bt_32_r201_m335,2,explt_v0_7_2_m54,5_vs_5
1995,0,0,m_sp_arch_longer_heads_bt_32_r201_m335,0,explt_v0_7_2_m54,5_vs_5
1996,-5,1,m_sp_arch_longer_heads_bt_32_r201_m335,6,m_sp_sc3v3_arch_2x1_32_r500_cont4x1_m224,5_vs_5
1997,-3,1,m_sp_arch_longer_heads_bt_32_r201_m335,4,m_sp_sc3v3_arch_2x1_32_r500_cont4x1_m224,5_vs_5
1998,-5,1,m_sp_arch_longer_heads_bt_32_r201_m335,6,m_sp_sc3v3_arch_2x1_32_r500_cont4x1_m224,5_vs_5
1999,-3,1,m_sp_arch_longer_heads_bt_32_r201_m335,4,m_sp_arch_4x1_bt_32_roles_r500_m335,5_vs_5
2000,-6,0,m_sp_arch_longer_heads_bt_32_r201_m335,6,m_sp_arch_4x1_bt_32_roles_r500_m335,5_vs_5
2001,-9,2,m_sp_arch_longer_heads_bt_32_r201_m335,11,m_sp_arch_4x1_bt_32_roles_r500_m335,5_vs_5
2002,1,2,m_sp_arch_medium_heads_bt_32_r201_m335,1,easy_bots,5_vs_5
2003,0,4,m_sp_arch_medium_heads_bt_32_r201_m335,4,easy_bots,5_vs_5
2004,0,1,m_sp_arch_medium_heads_bt_32_r201_m335,1,easy_bots,5_vs_5
2005,0,0,m_sp_arch_medium_heads_bt_32_r201_m335,0,easy_bots,5_vs_5
2006,-2,0,m_sp_arch_medium_heads_bt_32_r201_m335,2,medium_bots,5_vs_5_medium
2007,0,2,m_sp_arch_medium_heads_bt_32_r201_m335,2,medium_bots,5_vs_5_medium
2008,-2,0,m_sp_arch_medium_heads_bt_32_r201_m335,2,medium_bots,5_vs_5_medium
2009,-2,1,m_sp_arch_medium_heads_bt_32_r201_m335,3,medium_bots,5_vs_5_medium
2010,-1,1,m_sp_arch_medium_heads_bt_32_r201_m335,2,hard_bots,5_vs_5_hard
2011,-1,1,m_sp_arch_medium_heads_bt_32_r201_m335,2,hard_bots,5_vs_5_hard
2012,0,0,m_sp_arch_medium_heads_bt_32_r201_m335,0,hard_bots,5_vs_5_hard
2013,-2,0,m_sp_arch_medium_heads_bt_32_r201_m335,2,hard_bots,5_vs_5_hard
2014,5,8,m_sp_arch_medium_heads_bt_32_r201_m335,3,f5v0to1to2t05_e2_ckpt291,5_vs_5
2015,8,10,m_sp_arch_medium_heads_bt_32_r201_m335,2,f5v0to1to2t05_e2_ckpt291,5_vs_5
2016,5,5,m_sp_arch_medium_heads_bt_32_r201_m335,0,f5v0to1to5_e2_ckpt252,5_vs_5
2017,1,4,m_sp_arch_medium_heads_bt_32_r201_m335,3,f5v0to1to5_e2_ckpt252,5_vs_5
2018,3,5,m_sp_arch_medium_heads_bt_32_r201_m335,2,scon_e3_p2_hard_ckpt840,5_vs_5
2019,4,6,m_sp_arch_medium_heads_bt_32_r201_m335,2,scon_e3_p2_hard_ckpt840,5_vs_5
2020,2,5,m_sp_arch_medium_heads_bt_32_r201_m335,3,less_then_partially_randomized_checkpoints_bots_4_heads_38_ckpt108,5_vs_5
2021,4,4,m_sp_arch_medium_heads_bt_32_r201_m335,0,less_then_partially_randomized_checkpoints_bots_4_heads_38_ckpt108,5_vs_5
2022,10,10,m_sp_arch_medium_heads_bt_32_r201_m335,0,less_then_partially_randomized_entropy_checkpoints_bots_4_heads_39_ckpt109,5_vs_5
2023,7,10,m_sp_arch_medium_heads_bt_32_r201_m335,3,less_then_partially_randomized_entropy_checkpoints_bots_4_heads_39_ckpt109,5_vs_5
2024,7,7,m_sp_arch_medium_heads_bt_32_r201_m335,0,reward_shaping_checkpoints_bots_4_heads_1_ckpt360,5_vs_5
2025,4,5,m_sp_arch_medium_heads_bt_32_r201_m335,1,reward_shaping_checkpoints_bots_4_heads_1_ckpt360,5_vs_5
2026,-2,3,m_sp_arch_medium_heads_bt_32_r201_m335,5,checkpoints_selfplay_e9_sp_ckpt274,5_vs_5
2027,0,3,m_sp_arch_medium_heads_bt_32_r201_m335,3,checkpoints_selfplay_e9_sp_ckpt274,5_vs_5
2028,-2,2,m_sp_arch_medium_heads_bt_32_r201_m335,4,checkpoints_sp_c_nb_e2_ckpt667,5_vs_5
2029,-4,1,m_sp_arch_medium_heads_bt_32_r201_m335,5,checkpoints_sp_c_nb_e2_ckpt667,5_vs_5
2030,-1,2,m_sp_arch_medium_heads_bt_32_r201_m335,3,m_sp_arch_medium_heads_conv16_0_bt_32_r313_m335,5_vs_5
2031,-3,2,m_sp_arch_medium_heads_bt_32_r201_m335,5,m_sp_arch_medium_heads_conv16_0_bt_32_r313_m335,5_vs_5
2032,-4,0,m_sp_arch_medium_heads_bt_32_r201_m335,4,m_sp_arch_longer_heads_bt_32_r201_m335,5_vs_5
2033,-4,0,m_sp_arch_medium_heads_bt_32_r201_m335,4,m_sp_arch_longer_heads_bt_32_r201_m335,5_vs_5
2034,1,2,m_sp_arch_medium_heads_bt_32_r201_m335,1,m_sp_arch_medium_heads_bt_32_r201_m335,5_vs_5
2035,-2,1,m_sp_arch_medium_heads_bt_32_r201_m335,3,m_sp_arch_medium_heads_bt_32_r201_m335,5_vs_5
2036,-5,1,m_sp_arch_medium_heads_bt_32_r201_m335,6,m_sp_arch_4x1_bt_32_r201_m335,5_vs_5
2037,-5,0,m_sp_arch_medium_heads_bt_32_r201_m335,5,m_sp_arch_4x1_bt_32_r201_m335,5_vs_5
2038,-1,2,m_sp_arch_medium_heads_bt_32_r201_m335,3,m_sp_arch_4x1_bt_32_r201_cont3_m650,5_vs_5
2039,-5,0,m_sp_arch_medium_heads_bt_32_r201_m335,5,m_sp_arch_4x1_bt_32_r201_cont3_m650,5_vs_5
2040,1,1,m_sp_arch_medium_heads_bt_32_r201_m335,0,explt_v0_7_2_m54,5_vs_5
2041,-3,0,m_sp_arch_medium_heads_bt_32_r201_m335,3,explt_v0_7_2_m54,5_vs_5
2042,-1,4,m_sp_arch_medium_heads_bt_32_r201_m335,5,m_sp_sc3v3_arch_2x1_32_r500_cont4x1_m224,5_vs_5
2043,-5,1,m_sp_arch_medium_heads_bt_32_r201_m335,6,m_sp_sc3v3_arch_2x1_32_r500_cont4x1_m224,5_vs_5
2044,-4,0,m_sp_arch_medium_heads_bt_32_r201_m335,4,m_sp_arch_4x1_bt_32_roles_r500_m335,5_vs_5
2045,-8,1,m_sp_arch_medium_heads_bt_32_r201_m335,9,m_sp_arch_4x1_bt_32_roles_r500_m335,5_vs_5
2046,1,1,m_sp_sc3v3_arch_2x1_32_r500_cont4x1_m224,0,easy_bots,5_vs_5
2047,1,2,m_sp_sc3v3_arch_2x1_32_r500_cont4x1_m224,1,easy_bots,5_vs_5
2048,0,0,m_sp_sc3v3_arch_2x1_32_r500_cont4x1_m224,0,easy_bots,5_vs_5
2049,1,2,m_sp_sc3v3_arch_2x1_32_r500_cont4x1_m224,1,easy_bots,5_vs_5
2050,0,1,m_sp_sc3v3_arch_2x1_32_r500_cont4x1_m224,1,easy_bots,5_vs_5
2051,2,2,m_sp_sc3v3_arch_2x1_32_r500_cont4x1_m224,0,easy_bots,5_vs_5
2052,-1,0,m_sp_sc3v3_arch_2x1_32_r500_cont4x1_m224,1,medium_bots,5_vs_5_medium
2053,-2,0,m_sp_sc3v3_arch_2x1_32_r500_cont4x1_m224,2,medium_bots,5_vs_5_medium
2054,0,1,m_sp_sc3v3_arch_2x1_32_r500_cont4x1_m224,1,medium_bots,5_vs_5_medium
2055,2,2,m_sp_sc3v3_arch_2x1_32_r500_cont4x1_m224,0,medium_bots,5_vs_5_medium
2056,-1,0,m_sp_sc3v3_arch_2x1_32_r500_cont4x1_m224,1,medium_bots,5_vs_5_medium
2057,0,0,m_sp_sc3v3_arch_2x1_32_r500_cont4x1_m224,0,medium_bots,5_vs_5_medium
2058,-4,0,m_sp_sc3v3_arch_2x1_32_r500_cont4x1_m224,4,hard_bots,5_vs_5_hard
2059,-1,1,m_sp_sc3v3_arch_2x1_32_r500_cont4x1_m224,2,hard_bots,5_vs_5_hard
2060,0,1,m_sp_sc3v3_arch_2x1_32_r500_cont4x1_m224,1,hard_bots,5_vs_5_hard
2061,0,0,m_sp_sc3v3_arch_2x1_32_r500_cont4x1_m224,0,hard_bots,5_vs_5_hard
2062,0,0,m_sp_sc3v3_arch_2x1_32_r500_cont4x1_m224,0,hard_bots,5_vs_5_hard
2063,0,0,m_sp_sc3v3_arch_2x1_32_r500_cont4x1_m224,0,hard_bots,5_vs_5_hard
2064,11,11,m_sp_sc3v3_arch_2x1_32_r500_cont4x1_m224,0,f5v0to1to2t05_e2_ckpt291,5_vs_5
2065,10,11,m_sp_sc3v3_arch_2x1_32_r500_cont4x1_m224,1,f5v0to1to2t05_e2_ckpt291,5_vs_5
2066,11,12,m_sp_sc3v3_arch_2x1_32_r500_cont4x1_m224,1,f5v0to1to2t05_e2_ckpt291,5_vs_5
2067,12,12,m_sp_sc3v3_arch_2x1_32_r500_cont4x1_m224,0,f5v0to1to5_e2_ckpt252,5_vs_5
2068,7,7,m_sp_sc3v3_arch_2x1_32_r500_cont4x1_m224,0,f5v0to1to5_e2_ckpt252,5_vs_5
2069,8,9,m_sp_sc3v3_arch_2x1_32_r500_cont4x1_m224,1,f5v0to1to5_e2_ckpt252,5_vs_5
2070,10,10,m_sp_sc3v3_arch_2x1_32_r500_cont4x1_m224,0,scon_e3_p2_hard_ckpt840,5_vs_5
2071,13,13,m_sp_sc3v3_arch_2x1_32_r500_cont4x1_m224,0,scon_e3_p2_hard_ckpt840,5_vs_5
2072,13,13,m_sp_sc3v3_arch_2x1_32_r500_cont4x1_m224,0,scon_e3_p2_hard_ckpt840,5_vs_5
2073,9,9,m_sp_sc3v3_arch_2x1_32_r500_cont4x1_m224,0,less_then_partially_randomized_checkpoints_bots_4_heads_38_ckpt108,5_vs_5
2074,17,17,m_sp_sc3v3_arch_2x1_32_r500_cont4x1_m224,0,less_then_partially_randomized_checkpoints_bots_4_heads_38_ckpt108,5_vs_5
2075,11,11,m_sp_sc3v3_arch_2x1_32_r500_cont4x1_m224,0,less_then_partially_randomized_checkpoints_bots_4_heads_38_ckpt108,5_vs_5
2076,12,12,m_sp_sc3v3_arch_2x1_32_r500_cont4x1_m224,0,less_then_partially_randomized_entropy_checkpoints_bots_4_heads_39_ckpt109,5_vs_5
2077,11,11,m_sp_sc3v3_arch_2x1_32_r500_cont4x1_m224,0,less_then_partially_randomized_entropy_checkpoints_bots_4_heads_39_ckpt109,5_vs_5
2078,9,9,m_sp_sc3v3_arch_2x1_32_r500_cont4x1_m224,0,less_then_partially_randomized_entropy_checkpoints_bots_4_heads_39_ckpt109,5_vs_5
2079,9,9,m_sp_sc3v3_arch_2x1_32_r500_cont4x1_m224,0,reward_shaping_checkpoints_bots_4_heads_1_ckpt360,5_vs_5
2080,11,11,m_sp_sc3v3_arch_2x1_32_r500_cont4x1_m224,0,reward_shaping_checkpoints_bots_4_heads_1_ckpt360,5_vs_5
2081,11,11,m_sp_sc3v3_arch_2x1_32_r500_cont4x1_m224,0,reward_shaping_checkpoints_bots_4_heads_1_ckpt360,5_vs_5
2082,5,6,m_sp_sc3v3_arch_2x1_32_r500_cont4x1_m224,1,checkpoints_selfplay_e9_sp_ckpt274,5_vs_5
2083,6,7,m_sp_sc3v3_arch_2x1_32_r500_cont4x1_m224,1,checkpoints_selfplay_e9_sp_ckpt274,5_vs_5
2084,5,6,m_sp_sc3v3_arch_2x1_32_r500_cont4x1_m224,1,checkpoints_selfplay_e9_sp_ckpt274,5_vs_5
2085,1,4,m_sp_sc3v3_arch_2x1_32_r500_cont4x1_m224,3,checkpoints_sp_c_nb_e2_ckpt667,5_vs_5
2086,4,5,m_sp_sc3v3_arch_2x1_32_r500_cont4x1_m224,1,checkpoints_sp_c_nb_e2_ckpt667,5_vs_5
2087,3,4,m_sp_sc3v3_arch_2x1_32_r500_cont4x1_m224,1,checkpoints_sp_c_nb_e2_ckpt667,5_vs_5
2088,3,5,m_sp_sc3v3_arch_2x1_32_r500_cont4x1_m224,2,m_sp_arch_medium_heads_conv16_0_bt_32_r313_m335,5_vs_5
2089,5,6,m_sp_sc3v3_arch_2x1_32_r500_cont4x1_m224,1,m_sp_arch_medium_heads_conv16_0_bt_32_r313_m335,5_vs_5
2090,4,4,m_sp_sc3v3_arch_2x1_32_r500_cont4x1_m224,0,m_sp_arch_medium_heads_conv16_0_bt_32_r313_m335,5_vs_5
2091,7,7,m_sp_sc3v3_arch_2x1_32_r500_cont4x1_m224,0,m_sp_arch_longer_heads_bt_32_r201_m335,5_vs_5
2092,4,4,m_sp_sc3v3_arch_2x1_32_r500_cont4x1_m224,0,m_sp_arch_longer_heads_bt_32_r201_m335,5_vs_5
2093,6,6,m_sp_sc3v3_arch_2x1_32_r500_cont4x1_m224,0,m_sp_arch_longer_heads_bt_32_r201_m335,5_vs_5
2094,5,6,m_sp_sc3v3_arch_2x1_32_r500_cont4x1_m224,1,m_sp_arch_medium_heads_bt_32_r201_m335,5_vs_5
2095,3,5,m_sp_sc3v3_arch_2x1_32_r500_cont4x1_m224,2,m_sp_arch_medium_heads_bt_32_r201_m335,5_vs_5
2096,2,5,m_sp_sc3v3_arch_2x1_32_r500_cont4x1_m224,3,m_sp_arch_medium_heads_bt_32_r201_m335,5_vs_5
2097,-3,2,m_sp_sc3v3_arch_2x1_32_r500_cont4x1_m224,5,m_sp_arch_4x1_bt_32_r201_m335,5_vs_5
2098,-1,3,m_sp_sc3v3_arch_2x1_32_r500_cont4x1_m224,4,m_sp_arch_4x1_bt_32_r201_m335,5_vs_5
2099,-3,2,m_sp_sc3v3_arch_2x1_32_r500_cont4x1_m224,5,m_sp_arch_4x1_bt_32_r201_m335,5_vs_5
2100,-3,0,m_sp_sc3v3_arch_2x1_32_r500_cont4x1_m224,3,m_sp_arch_4x1_bt_32_r201_cont3_m650,5_vs_5
2101,-5,1,m_sp_sc3v3_arch_2x1_32_r500_cont4x1_m224,6,m_sp_arch_4x1_bt_32_r201_cont3_m650,5_vs_5
2102,0,4,m_sp_sc3v3_arch_2x1_32_r500_cont4x1_m224,4,m_sp_arch_4x1_bt_32_r201_cont3_m650,5_vs_5
2103,0,2,m_sp_sc3v3_arch_2x1_32_r500_cont4x1_m224,2,explt_v0_7_2_m54,5_vs_5
2104,0,1,m_sp_sc3v3_arch_2x1_32_r500_cont4x1_m224,1,explt_v0_7_2_m54,5_vs_5
2105,3,4,m_sp_sc3v3_arch_2x1_32_r500_cont4x1_m224,1,explt_v0_7_2_m54,5_vs_5
2106,-1,0,m_sp_sc3v3_arch_2x1_32_r500_cont4x1_m224,1,m_sp_sc3v3_arch_2x1_32_r500_cont4x1_m224,5_vs_5
2107,3,4,m_sp_sc3v3_arch_2x1_32_r500_cont4x1_m224,1,m_sp_sc3v3_arch_2x1_32_r500_cont4x1_m224,5_vs_5
2108,1,1,m_sp_sc3v3_arch_2x1_32_r500_cont4x1_m224,0,m_sp_sc3v3_arch_2x1_32_r500_cont4x1_m224,5_vs_5
2109,-3,3,m_sp_sc3v3_arch_2x1_32_r500_cont4x1_m224,6,m_sp_arch_4x1_bt_32_roles_r500_m335,5_vs_5
2110,-4,1,m_sp_sc3v3_arch_2x1_32_r500_cont4x1_m224,5,m_sp_arch_4x1_bt_32_roles_r500_m335,5_vs_5
2111,1,3,m_sp_sc3v3_arch_2x1_32_r500_cont4x1_m224,2,m_sp_arch_4x1_bt_32_roles_r500_m335,5_vs_5
2112,1,2,explt_v0_7_2_m54,1,easy_bots,5_vs_5
2113,1,1,explt_v0_7_2_m54,0,easy_bots,5_vs_5
2114,1,2,explt_v0_7_2_m54,1,easy_bots,5_vs_5
2115,3,3,explt_v0_7_2_m54,0,easy_bots,5_vs_5
2116,-1,0,explt_v0_7_2_m54,1,easy_bots,5_vs_5
2117,0,1,explt_v0_7_2_m54,1,easy_bots,5_vs_5
2118,-1,0,explt_v0_7_2_m54,1,easy_bots,5_vs_5
2119,1,2,explt_v0_7_2_m54,1,easy_bots,5_vs_5
2120,1,2,explt_v0_7_2_m54,1,easy_bots,5_vs_5
2121,0,0,explt_v0_7_2_m54,0,easy_bots,5_vs_5
2122,0,0,explt_v0_7_2_m54,0,medium_bots,5_vs_5_medium
2123,-1,0,explt_v0_7_2_m54,1,medium_bots,5_vs_5_medium
2124,1,2,explt_v0_7_2_m54,1,medium_bots,5_vs_5_medium
2125,0,2,explt_v0_7_2_m54,2,medium_bots,5_vs_5_medium
2126,1,1,explt_v0_7_2_m54,0,medium_bots,5_vs_5_medium
2127,0,0,explt_v0_7_2_m54,0,medium_bots,5_vs_5_medium
2128,-2,0,explt_v0_7_2_m54,2,medium_bots,5_vs_5_medium
2129,-2,0,explt_v0_7_2_m54,2,medium_bots,5_vs_5_medium
2130,0,0,explt_v0_7_2_m54,0,medium_bots,5_vs_5_medium
2131,2,2,explt_v0_7_2_m54,0,medium_bots,5_vs_5_medium
2132,-2,0,explt_v0_7_2_m54,2,hard_bots,5_vs_5_hard
2133,-2,0,explt_v0_7_2_m54,2,hard_bots,5_vs_5_hard
2134,-2,0,explt_v0_7_2_m54,2,hard_bots,5_vs_5_hard
2135,0,1,explt_v0_7_2_m54,1,hard_bots,5_vs_5_hard
2136,-4,0,explt_v0_7_2_m54,4,hard_bots,5_vs_5_hard
2137,-3,0,explt_v0_7_2_m54,3,hard_bots,5_vs_5_hard
2138,-2,0,explt_v0_7_2_m54,2,hard_bots,5_vs_5_hard
2139,1,1,explt_v0_7_2_m54,0,hard_bots,5_vs_5_hard
2140,1,1,explt_v0_7_2_m54,0,hard_bots,5_vs_5_hard
2141,2,2,explt_v0_7_2_m54,0,hard_bots,5_vs_5_hard
2142,-2,1,explt_v0_7_2_m54,3,f5v0to1to2t05_e2_ckpt291,5_vs_5
2143,1,3,explt_v0_7_2_m54,2,f5v0to1to2t05_e2_ckpt291,5_vs_5
2144,-1,1,explt_v0_7_2_m54,2,f5v0to1to2t05_e2_ckpt291,5_vs_5
2145,3,3,explt_v0_7_2_m54,0,f5v0to1to2t05_e2_ckpt291,5_vs_5
2146,1,2,explt_v0_7_2_m54,1,f5v0to1to2t05_e2_ckpt291,5_vs_5
2147,4,4,explt_v0_7_2_m54,0,f5v0to1to5_e2_ckpt252,5_vs_5
2148,2,3,explt_v0_7_2_m54,1,f5v0to1to5_e2_ckpt252,5_vs_5
2149,2,3,explt_v0_7_2_m54,1,f5v0to1to5_e2_ckpt252,5_vs_5
2150,0,1,explt_v0_7_2_m54,1,f5v0to1to5_e2_ckpt252,5_vs_5
2151,0,2,explt_v0_7_2_m54,2,f5v0to1to5_e2_ckpt252,5_vs_5
2152,3,3,explt_v0_7_2_m54,0,scon_e3_p2_hard_ckpt840,5_vs_5
2153,1,1,explt_v0_7_2_m54,0,scon_e3_p2_hard_ckpt840,5_vs_5
2154,2,2,explt_v0_7_2_m54,0,scon_e3_p2_hard_ckpt840,5_vs_5
2155,0,0,explt_v0_7_2_m54,0,scon_e3_p2_hard_ckpt840,5_vs_5
2156,2,2,explt_v0_7_2_m54,0,scon_e3_p2_hard_ckpt840,5_vs_5
2157,2,3,explt_v0_7_2_m54,1,less_then_partially_randomized_checkpoints_bots_4_heads_38_ckpt108,5_vs_5
2158,3,3,explt_v0_7_2_m54,0,less_then_partially_randomized_checkpoints_bots_4_heads_38_ckpt108,5_vs_5
2159,1,1,explt_v0_7_2_m54,0,less_then_partially_randomized_checkpoints_bots_4_heads_38_ckpt108,5_vs_5
2160,5,5,explt_v0_7_2_m54,0,less_then_partially_randomized_checkpoints_bots_4_heads_38_ckpt108,5_vs_5
2161,6,6,explt_v0_7_2_m54,0,less_then_partially_randomized_checkpoints_bots_4_heads_38_ckpt108,5_vs_5
2162,0,0,explt_v0_7_2_m54,0,less_then_partially_randomized_entropy_checkpoints_bots_4_heads_39_ckpt109,5_vs_5
2163,0,1,explt_v0_7_2_m54,1,less_then_partially_randomized_entropy_checkpoints_bots_4_heads_39_ckpt109,5_vs_5
2164,-1,1,explt_v0_7_2_m54,2,less_then_partially_randomized_entropy_checkpoints_bots_4_heads_39_ckpt109,5_vs_5
2165,1,1,explt_v0_7_2_m54,0,less_then_partially_randomized_entropy_checkpoints_bots_4_heads_39_ckpt109,5_vs_5
2166,1,2,explt_v0_7_2_m54,1,less_then_partially_randomized_entropy_checkpoints_bots_4_heads_39_ckpt109,5_vs_5
2167,2,2,explt_v0_7_2_m54,0,reward_shaping_checkpoints_bots_4_heads_1_ckpt360,5_vs_5
2168,3,3,explt_v0_7_2_m54,0,reward_shaping_checkpoints_bots_4_heads_1_ckpt360,5_vs_5
2169,3,4,explt_v0_7_2_m54,1,reward_shaping_checkpoints_bots_4_heads_1_ckpt360,5_vs_5
2170,4,4,explt_v0_7_2_m54,0,reward_shaping_checkpoints_bots_4_heads_1_ckpt360,5_vs_5
2171,5,5,explt_v0_7_2_m54,0,reward_shaping_checkpoints_bots_4_heads_1_ckpt360,5_vs_5
2172,0,2,explt_v0_7_2_m54,2,checkpoints_selfplay_e9_sp_ckpt274,5_vs_5
2173,1,1,explt_v0_7_2_m54,0,checkpoints_selfplay_e9_sp_ckpt274,5_vs_5
2174,0,1,explt_v0_7_2_m54,1,checkpoints_selfplay_e9_sp_ckpt274,5_vs_5
2175,2,2,explt_v0_7_2_m54,0,checkpoints_selfplay_e9_sp_ckpt274,5_vs_5
2176,1,2,explt_v0_7_2_m54,1,checkpoints_selfplay_e9_sp_ckpt274,5_vs_5
2177,1,3,explt_v0_7_2_m54,2,checkpoints_sp_c_nb_e2_ckpt667,5_vs_5
2178,2,4,explt_v0_7_2_m54,2,checkpoints_sp_c_nb_e2_ckpt667,5_vs_5
2179,0,0,explt_v0_7_2_m54,0,checkpoints_sp_c_nb_e2_ckpt667,5_vs_5
2180,3,3,explt_v0_7_2_m54,0,checkpoints_sp_c_nb_e2_ckpt667,5_vs_5
2181,1,2,explt_v0_7_2_m54,1,checkpoints_sp_c_nb_e2_ckpt667,5_vs_5
2182,7,7,explt_v0_7_2_m54,0,m_sp_arch_medium_heads_conv16_0_bt_32_r313_m335,5_vs_5
2183,-2,1,explt_v0_7_2_m54,3,m_sp_arch_medium_heads_conv16_0_bt_32_r313_m335,5_vs_5
2184,1,1,explt_v0_7_2_m54,0,m_sp_arch_medium_heads_conv16_0_bt_32_r313_m335,5_vs_5
2185,4,5,explt_v0_7_2_m54,1,m_sp_arch_medium_heads_conv16_0_bt_32_r313_m335,5_vs_5
2186,2,3,explt_v0_7_2_m54,1,m_sp_arch_medium_heads_conv16_0_bt_32_r313_m335,5_vs_5
2187,3,3,explt_v0_7_2_m54,0,m_sp_arch_longer_heads_bt_32_r201_m335,5_vs_5
2188,2,3,explt_v0_7_2_m54,1,m_sp_arch_longer_heads_bt_32_r201_m335,5_vs_5
2189,-1,1,explt_v0_7_2_m54,2,m_sp_arch_longer_heads_bt_32_r201_m335,5_vs_5
2190,-2,0,explt_v0_7_2_m54,2,m_sp_arch_longer_heads_bt_32_r201_m335,5_vs_5
2191,1,1,explt_v0_7_2_m54,0,m_sp_arch_longer_heads_bt_32_r201_m335,5_vs_5
2192,0,1,explt_v0_7_2_m54,1,m_sp_arch_medium_heads_bt_32_r201_m335,5_vs_5
2193,0,0,explt_v0_7_2_m54,0,m_sp_arch_medium_heads_bt_32_r201_m335,5_vs_5
2194,1,2,explt_v0_7_2_m54,1,m_sp_arch_medium_heads_bt_32_r201_m335,5_vs_5
2195,1,2,explt_v0_7_2_m54,1,m_sp_arch_medium_heads_bt_32_r201_m335,5_vs_5
2196,1,1,explt_v0_7_2_m54,0,m_sp_arch_medium_heads_bt_32_r201_m335,5_vs_5
2197,1,2,explt_v0_7_2_m54,1,m_sp_arch_4x1_bt_32_r201_m335,5_vs_5
2198,-1,1,explt_v0_7_2_m54,2,m_sp_arch_4x1_bt_32_r201_m335,5_vs_5
2199,4,5,explt_v0_7_2_m54,1,m_sp_arch_4x1_bt_32_r201_m335,5_vs_5
2200,-1,2,explt_v0_7_2_m54,3,m_sp_arch_4x1_bt_32_r201_m335,5_vs_5
2201,-1,1,explt_v0_7_2_m54,2,m_sp_arch_4x1_bt_32_r201_m335,5_vs_5
2202,-2,1,explt_v0_7_2_m54,3,m_sp_arch_4x1_bt_32_r201_cont3_m650,5_vs_5
2203,0,2,explt_v0_7_2_m54,2,m_sp_arch_4x1_bt_32_r201_cont3_m650,5_vs_5
2204,2,3,explt_v0_7_2_m54,1,m_sp_arch_4x1_bt_32_r201_cont3_m650,5_vs_5
2205,5,5,explt_v0_7_2_m54,0,m_sp_arch_4x1_bt_32_r201_cont3_m650,5_vs_5
2206,-1,1,explt_v0_7_2_m54,2,m_sp_arch_4x1_bt_32_r201_cont3_m650,5_vs_5
2207,2,3,explt_v0_7_2_m54,1,explt_v0_7_2_m54,5_vs_5
2208,-1,1,explt_v0_7_2_m54,2,explt_v0_7_2_m54,5_vs_5
2209,1,2,explt_v0_7_2_m54,1,explt_v0_7_2_m54,5_vs_5
2210,-2,2,explt_v0_7_2_m54,4,explt_v0_7_2_m54,5_vs_5
2211,0,2,explt_v0_7_2_m54,2,explt_v0_7_2_m54,5_vs_5
2212,-1,3,explt_v0_7_2_m54,4,m_sp_sc3v3_arch_2x1_32_r500_cont4x1_m224,5_vs_5
2213,-5,1,explt_v0_7_2_m54,6,m_sp_sc3v3_arch_2x1_32_r500_cont4x1_m224,5_vs_5
2214,2,2,explt_v0_7_2_m54,0,m_sp_sc3v3_arch_2x1_32_r500_cont4x1_m224,5_vs_5
2215,1,2,explt_v0_7_2_m54,1,m_sp_sc3v3_arch_2x1_32_r500_cont4x1_m224,5_vs_5
2216,1,4,explt_v0_7_2_m54,3,m_sp_sc3v3_arch_2x1_32_r500_cont4x1_m224,5_vs_5
2217,0,3,explt_v0_7_2_m54,3,m_sp_arch_4x1_bt_32_roles_r500_m335,5_vs_5
2218,0,2,explt_v0_7_2_m54,2,m_sp_arch_4x1_bt_32_roles_r500_m335,5_vs_5
2219,1,3,explt_v0_7_2_m54,2,m_sp_arch_4x1_bt_32_roles_r500_m335,5_vs_5
2220,1,2,explt_v0_7_2_m54,1,m_sp_arch_4x1_bt_32_roles_r500_m335,5_vs_5
2221,2,4,explt_v0_7_2_m54,2,m_sp_arch_4x1_bt_32_roles_r500_m335,5_vs_5
2222,7,8,f5v0to1to5_e2_ckpt252,1,easy_bots,5_vs_5
2223,15,15,f5v0to1to5_e2_ckpt252,0,easy_bots,5_vs_5
2224,14,15,f5v0to1to5_e2_ckpt252,1,easy_bots,5_vs_5
2225,7,7,f5v0to1to5_e2_ckpt252,0,easy_bots,5_vs_5
2226,9,9,f5v0to1to5_e2_ckpt252,0,medium_bots,5_vs_5_medium
2227,7,8,f5v0to1to5_e2_ckpt252,1,medium_bots,5_vs_5_medium
2228,5,7,f5v0to1to5_e2_ckpt252,2,medium_bots,5_vs_5_medium
2229,6,6,f5v0to1to5_e2_ckpt252,0,medium_bots,5_vs_5_medium
2230,5,7,f5v0to1to5_e2_ckpt252,2,hard_bots,5_vs_5_hard
2231,7,8,f5v0to1to5_e2_ckpt252,1,hard_bots,5_vs_5_hard
2232,8,8,f5v0to1to5_e2_ckpt252,0,hard_bots,5_vs_5_hard
2233,10,10,f5v0to1to5_e2_ckpt252,0,hard_bots,5_vs_5_hard
2234,2,6,f5v0to1to5_e2_ckpt252,4,f5v0to1to2t05_e2_ckpt291,5_vs_5
2235,0,5,f5v0to1to5_e2_ckpt252,5,f5v0to1to2t05_e2_ckpt291,5_vs_5
2236,-8,0,f5v0to1to5_e2_ckpt252,8,f5v0to1to5_e2_ckpt252,5_vs_5
2237,-1,2,f5v0to1to5_e2_ckpt252,3,f5v0to1to5_e2_ckpt252,5_vs_5
2238,5,5,f5v0to1to5_e2_ckpt252,0,scon_e3_p2_hard_ckpt840,5_vs_5
2239,5,6,f5v0to1to5_e2_ckpt252,1,scon_e3_p2_hard_ckpt840,5_vs_5
2240,1,4,f5v0to1to5_e2_ckpt252,3,less_then_partially_randomized_checkpoints_bots_4_heads_38_ckpt108,5_vs_5
2241,1,5,f5v0to1to5_e2_ckpt252,4,less_then_partially_randomized_checkpoints_bots_4_heads_38_ckpt108,5_vs_5
2242,3,6,f5v0to1to5_e2_ckpt252,3,less_then_partially_randomized_entropy_checkpoints_bots_4_heads_39_ckpt109,5_vs_5
2243,-3,2,f5v0to1to5_e2_ckpt252,5,less_then_partially_randomized_entropy_checkpoints_bots_4_heads_39_ckpt109,5_vs_5
2244,3,7,f5v0to1to5_e2_ckpt252,4,reward_shaping_checkpoints_bots_4_heads_1_ckpt360,5_vs_5
2245,1,5,f5v0to1to5_e2_ckpt252,4,reward_shaping_checkpoints_bots_4_heads_1_ckpt360,5_vs_5
2246,-9,3,f5v0to1to5_e2_ckpt252,12,checkpoints_selfplay_e9_sp_ckpt274,5_vs_5
2247,-7,2,f5v0to1to5_e2_ckpt252,9,checkpoints_selfplay_e9_sp_ckpt274,5_vs_5
2248,-7,1,f5v0to1to5_e2_ckpt252,8,checkpoints_sp_c_nb_e2_ckpt667,5_vs_5
2249,-5,1,f5v0to1to5_e2_ckpt252,6,checkpoints_sp_c_nb_e2_ckpt667,5_vs_5
2250,-2,1,f5v0to1to5_e2_ckpt252,3,m_sp_arch_medium_heads_conv16_0_bt_32_r313_m335,5_vs_5
2251,-2,3,f5v0to1to5_e2_ckpt252,5,m_sp_arch_medium_heads_conv16_0_bt_32_r313_m335,5_vs_5
2252,-3,1,f5v0to1to5_e2_ckpt252,4,m_sp_arch_longer_heads_bt_32_r201_m335,5_vs_5
2253,-4,2,f5v0to1to5_e2_ckpt252,6,m_sp_arch_longer_heads_bt_32_r201_m335,5_vs_5
2254,-8,0,f5v0to1to5_e2_ckpt252,8,m_sp_arch_medium_heads_bt_32_r201_m335,5_vs_5
2255,-2,0,f5v0to1to5_e2_ckpt252,2,m_sp_arch_medium_heads_bt_32_r201_m335,5_vs_5
2256,-9,1,f5v0to1to5_e2_ckpt252,10,m_sp_arch_4x1_bt_32_r201_m335,5_vs_5
2257,-6,2,f5v0to1to5_e2_ckpt252,8,m_sp_arch_4x1_bt_32_r201_m335,5_vs_5
2258,-8,1,f5v0to1to5_e2_ckpt252,9,m_sp_arch_4x1_bt_32_r201_cont3_m650,5_vs_5
2259,-11,0,f5v0to1to5_e2_ckpt252,11,m_sp_arch_4x1_bt_32_r201_cont3_m650,5_vs_5
2260,-3,0,f5v0to1to5_e2_ckpt252,3,explt_v0_7_2_m54,5_vs_5
2261,-3,0,f5v0to1to5_e2_ckpt252,3,explt_v0_7_2_m54,5_vs_5
2262,-5,0,f5v0to1to5_e2_ckpt252,5,m_sp_sc3v3_arch_2x1_32_r500_cont4x1_m224,5_vs_5
2263,-7,0,f5v0to1to5_e2_ckpt252,7,m_sp_sc3v3_arch_2x1_32_r500_cont4x1_m224,5_vs_5
2264,-16,0,f5v0to1to5_e2_ckpt252,16,m_sp_arch_4x1_bt_32_roles_r500_m335,5_vs_5
2265,-8,0,f5v0to1to5_e2_ckpt252,8,m_sp_arch_4x1_bt_32_roles_r500_m335,5_vs_5
2266,1,1,less_then_partially_randomized_entropy_checkpoints_bots_4_heads_39_ckpt109,0,easy_bots,5_vs_5
2267,7,8,less_then_partially_randomized_entropy_checkpoints_bots_4_heads_39_ckpt109,1,easy_bots,5_vs_5
2268,8,11,less_then_partially_randomized_entropy_checkpoints_bots_4_heads_39_ckpt109,3,easy_bots,5_vs_5
2269,4,5,less_then_partially_randomized_entropy_checkpoints_bots_4_heads_39_ckpt109,1,easy_bots,5_vs_5
2270,16,18,less_then_partially_randomized_entropy_checkpoints_bots_4_heads_39_ckpt109,2,easy_bots,5_vs_5
2271,14,14,less_then_partially_randomized_entropy_checkpoints_bots_4_heads_39_ckpt109,0,easy_bots,5_vs_5
2272,4,4,less_then_partially_randomized_entropy_checkpoints_bots_4_heads_39_ckpt109,0,medium_bots,5_vs_5_medium
2273,4,6,less_then_partially_randomized_entropy_checkpoints_bots_4_heads_39_ckpt109,2,medium_bots,5_vs_5_medium
2274,7,9,less_then_partially_randomized_entropy_checkpoints_bots_4_heads_39_ckpt109,2,medium_bots,5_vs_5_medium
2275,4,6,less_then_partially_randomized_entropy_checkpoints_bots_4_heads_39_ckpt109,2,medium_bots,5_vs_5_medium
2276,3,5,less_then_partially_randomized_entropy_checkpoints_bots_4_heads_39_ckpt109,2,medium_bots,5_vs_5_medium
2277,10,10,less_then_partially_randomized_entropy_checkpoints_bots_4_heads_39_ckpt109,0,medium_bots,5_vs_5_medium
2278,4,6,less_then_partially_randomized_entropy_checkpoints_bots_4_heads_39_ckpt109,2,hard_bots,5_vs_5_hard
2279,-1,2,less_then_partially_randomized_entropy_checkpoints_bots_4_heads_39_ckpt109,3,hard_bots,5_vs_5_hard
2280,3,4,less_then_partially_randomized_entropy_checkpoints_bots_4_heads_39_ckpt109,1,hard_bots,5_vs_5_hard
2281,5,5,less_then_partially_randomized_entropy_checkpoints_bots_4_heads_39_ckpt109,0,hard_bots,5_vs_5_hard
2282,1,3,less_then_partially_randomized_entropy_checkpoints_bots_4_heads_39_ckpt109,2,hard_bots,5_vs_5_hard
2283,10,11,less_then_partially_randomized_entropy_checkpoints_bots_4_heads_39_ckpt109,1,hard_bots,5_vs_5_hard
2284,1,4,less_then_partially_randomized_entropy_checkpoints_bots_4_heads_39_ckpt109,3,f5v0to1to2t05_e2_ckpt291,5_vs_5
2285,0,5,less_then_partially_randomized_entropy_checkpoints_bots_4_heads_39_ckpt109,5,f5v0to1to2t05_e2_ckpt291,5_vs_5
2286,-1,4,less_then_partially_randomized_entropy_checkpoints_bots_4_heads_39_ckpt109,5,f5v0to1to2t05_e2_ckpt291,5_vs_5
2287,2,5,less_then_partially_randomized_entropy_checkpoints_bots_4_heads_39_ckpt109,3,f5v0to1to5_e2_ckpt252,5_vs_5
2288,-3,2,less_then_partially_randomized_entropy_checkpoints_bots_4_heads_39_ckpt109,5,f5v0to1to5_e2_ckpt252,5_vs_5
2289,-2,5,less_then_partially_randomized_entropy_checkpoints_bots_4_heads_39_ckpt109,7,f5v0to1to5_e2_ckpt252,5_vs_5
2290,1,3,less_then_partially_randomized_entropy_checkpoints_bots_4_heads_39_ckpt109,2,scon_e3_p2_hard_ckpt840,5_vs_5
2291,1,4,less_then_partially_randomized_entropy_checkpoints_bots_4_heads_39_ckpt109,3,scon_e3_p2_hard_ckpt840,5_vs_5
2292,1,2,less_then_partially_randomized_entropy_checkpoints_bots_4_heads_39_ckpt109,1,scon_e3_p2_hard_ckpt840,5_vs_5
2293,3,6,less_then_partially_randomized_entropy_checkpoints_bots_4_heads_39_ckpt109,3,less_then_partially_randomized_checkpoints_bots_4_heads_38_ckpt108,5_vs_5
2294,0,3,less_then_partially_randomized_entropy_checkpoints_bots_4_heads_39_ckpt109,3,less_then_partially_randomized_checkpoints_bots_4_heads_38_ckpt108,5_vs_5
2295,-2,4,less_then_partially_randomized_entropy_checkpoints_bots_4_heads_39_ckpt109,6,less_then_partially_randomized_checkpoints_bots_4_heads_38_ckpt108,5_vs_5
2296,1,5,less_then_partially_randomized_entropy_checkpoints_bots_4_heads_39_ckpt109,4,less_then_partially_randomized_entropy_checkpoints_bots_4_heads_39_ckpt109,5_vs_5
2297,0,4,less_then_partially_randomized_entropy_checkpoints_bots_4_heads_39_ckpt109,4,less_then_partially_randomized_entropy_checkpoints_bots_4_heads_39_ckpt109,5_vs_5
2298,-1,4,less_then_partially_randomized_entropy_checkpoints_bots_4_heads_39_ckpt109,5,less_then_partially_randomized_entropy_checkpoints_bots_4_heads_39_ckpt109,5_vs_5
2299,3,5,less_then_partially_randomized_entropy_checkpoints_bots_4_heads_39_ckpt109,2,reward_shaping_checkpoints_bots_4_heads_1_ckpt360,5_vs_5
2300,4,4,less_then_partially_randomized_entropy_checkpoints_bots_4_heads_39_ckpt109,0,reward_shaping_checkpoints_bots_4_heads_1_ckpt360,5_vs_5
2301,2,4,less_then_partially_randomized_entropy_checkpoints_bots_4_heads_39_ckpt109,2,reward_shaping_checkpoints_bots_4_heads_1_ckpt360,5_vs_5
2302,-7,2,less_then_partially_randomized_entropy_checkpoints_bots_4_heads_39_ckpt109,9,checkpoints_selfplay_e9_sp_ckpt274,5_vs_5
2303,-12,1,less_then_partially_randomized_entropy_checkpoints_bots_4_heads_39_ckpt109,13,checkpoints_selfplay_e9_sp_ckpt274,5_vs_5
2304,-6,2,less_then_partially_randomized_entropy_checkpoints_bots_4_heads_39_ckpt109,8,checkpoints_selfplay_e9_sp_ckpt274,5_vs_5
2305,-5,1,less_then_partially_randomized_entropy_checkpoints_bots_4_heads_39_ckpt109,6,checkpoints_sp_c_nb_e2_ckpt667,5_vs_5
2306,-6,0,less_then_partially_randomized_entropy_checkpoints_bots_4_heads_39_ckpt109,6,checkpoints_sp_c_nb_e2_ckpt667,5_vs_5
2307,-7,0,less_then_partially_randomized_entropy_checkpoints_bots_4_heads_39_ckpt109,7,checkpoints_sp_c_nb_e2_ckpt667,5_vs_5
2308,-2,3,less_then_partially_randomized_entropy_checkpoints_bots_4_heads_39_ckpt109,5,m_sp_arch_medium_heads_conv16_0_bt_32_r313_m335,5_vs_5
2309,-2,1,less_then_partially_randomized_entropy_checkpoints_bots_4_heads_39_ckpt109,3,m_sp_arch_medium_heads_conv16_0_bt_32_r313_m335,5_vs_5
2310,-4,0,less_then_partially_randomized_entropy_checkpoints_bots_4_heads_39_ckpt109,4,m_sp_arch_medium_heads_conv16_0_bt_32_r313_m335,5_vs_5
2311,-5,0,less_then_partially_randomized_entropy_checkpoints_bots_4_heads_39_ckpt109,5,m_sp_arch_longer_heads_bt_32_r201_m335,5_vs_5
2312,-4,2,less_then_partially_randomized_entropy_checkpoints_bots_4_heads_39_ckpt109,6,m_sp_arch_longer_heads_bt_32_r201_m335,5_vs_5
2313,-2,1,less_then_partially_randomized_entropy_checkpoints_bots_4_heads_39_ckpt109,3,m_sp_arch_longer_heads_bt_32_r201_m335,5_vs_5
2314,-3,1,less_then_partially_randomized_entropy_checkpoints_bots_4_heads_39_ckpt109,4,m_sp_arch_medium_heads_bt_32_r201_m335,5_vs_5
2315,-5,2,less_then_partially_randomized_entropy_checkpoints_bots_4_heads_39_ckpt109,7,m_sp_arch_medium_heads_bt_32_r201_m335,5_vs_5
2316,-4,2,less_then_partially_randomized_entropy_checkpoints_bots_4_heads_39_ckpt109,6,m_sp_arch_medium_heads_bt_32_r201_m335,5_vs_5
2317,-8,0,less_then_partially_randomized_entropy_checkpoints_bots_4_heads_39_ckpt109,8,m_sp_arch_4x1_bt_32_r201_m335,5_vs_5
2318,-12,0,less_then_partially_randomized_entropy_checkpoints_bots_4_heads_39_ckpt109,12,m_sp_arch_4x1_bt_32_r201_m335,5_vs_5
2319,-8,0,less_then_partially_randomized_entropy_checkpoints_bots_4_heads_39_ckpt109,8,m_sp_arch_4x1_bt_32_r201_m335,5_vs_5
2320,-13,1,less_then_partially_randomized_entropy_checkpoints_bots_4_heads_39_ckpt109,14,m_sp_arch_4x1_bt_32_r201_cont3_m650,5_vs_5
2321,-13,0,less_then_partially_randomized_entropy_checkpoints_bots_4_heads_39_ckpt109,13,m_sp_arch_4x1_bt_32_r201_cont3_m650,5_vs_5
2322,-11,0,less_then_partially_randomized_entropy_checkpoints_bots_4_heads_39_ckpt109,11,m_sp_arch_4x1_bt_32_r201_cont3_m650,5_vs_5
2323,-1,2,less_then_partially_randomized_entropy_checkpoints_bots_4_heads_39_ckpt109,3,explt_v0_7_2_m54,5_vs_5
2324,-4,0,less_then_partially_randomized_entropy_checkpoints_bots_4_heads_39_ckpt109,4,explt_v0_7_2_m54,5_vs_5
2325,-4,0,less_then_partially_randomized_entropy_checkpoints_bots_4_heads_39_ckpt109,4,explt_v0_7_2_m54,5_vs_5
2326,-18,0,less_then_partially_randomized_entropy_checkpoints_bots_4_heads_39_ckpt109,18,m_sp_sc3v3_arch_2x1_32_r500_cont4x1_m224,5_vs_5
2327,-11,0,less_then_partially_randomized_entropy_checkpoints_bots_4_heads_39_ckpt109,11,m_sp_sc3v3_arch_2x1_32_r500_cont4x1_m224,5_vs_5
2328,-15,0,less_then_partially_randomized_entropy_checkpoints_bots_4_heads_39_ckpt109,15,m_sp_sc3v3_arch_2x1_32_r500_cont4x1_m224,5_vs_5
2329,-14,0,less_then_partially_randomized_entropy_checkpoints_bots_4_heads_39_ckpt109,14,m_sp_arch_4x1_bt_32_roles_r500_m335,5_vs_5
2330,-12,0,less_then_partially_randomized_entropy_checkpoints_bots_4_heads_39_ckpt109,12,m_sp_arch_4x1_bt_32_roles_r500_m335,5_vs_5
2331,-13,0,less_then_partially_randomized_entropy_checkpoints_bots_4_heads_39_ckpt109,13,m_sp_arch_4x1_bt_32_roles_r500_m335,5_vs_5
2332,3,3,m_sp_arch_medium_heads_conv16_0_bt_32_r313_m335,0,easy_bots,5_vs_5
2333,1,2,m_sp_arch_medium_heads_conv16_0_bt_32_r313_m335,1,easy_bots,5_vs_5
2334,1,3,m_sp_arch_medium_heads_conv16_0_bt_32_r313_m335,2,easy_bots,5_vs_5
2335,1,2,m_sp_arch_medium_heads_conv16_0_bt_32_r313_m335,1,easy_bots,5_vs_5
2336,-1,1,m_sp_arch_medium_heads_conv16_0_bt_32_r313_m335,2,easy_bots,5_vs_5
2337,0,3,m_sp_arch_medium_heads_conv16_0_bt_32_r313_m335,3,easy_bots,5_vs_5
2338,0,1,m_sp_arch_medium_heads_conv16_0_bt_32_r313_m335,1,easy_bots,5_vs_5
2339,-3,2,m_sp_arch_medium_heads_conv16_0_bt_32_r313_m335,5,easy_bots,5_vs_5
2340,2,5,m_sp_arch_medium_heads_conv16_0_bt_32_r313_m335,3,easy_bots,5_vs_5
2341,-1,1,m_sp_arch_medium_heads_conv16_0_bt_32_r313_m335,2,easy_bots,5_vs_5
2342,1,1,m_sp_arch_medium_heads_conv16_0_bt_32_r313_m335,0,medium_bots,5_vs_5_medium
2343,0,0,m_sp_arch_medium_heads_conv16_0_bt_32_r313_m335,0,medium_bots,5_vs_5_medium
2344,2,2,m_sp_arch_medium_heads_conv16_0_bt_32_r313_m335,0,medium_bots,5_vs_5_medium
2345,-2,0,m_sp_arch_medium_heads_conv16_0_bt_32_r313_m335,2,medium_bots,5_vs_5_medium
2346,0,2,m_sp_arch_medium_heads_conv16_0_bt_32_r313_m335,2,medium_bots,5_vs_5_medium
2347,-4,0,m_sp_arch_medium_heads_conv16_0_bt_32_r313_m335,4,medium_bots,5_vs_5_medium
2348,1,1,m_sp_arch_medium_heads_conv16_0_bt_32_r313_m335,0,medium_bots,5_vs_5_medium
2349,-1,0,m_sp_arch_medium_heads_conv16_0_bt_32_r313_m335,1,medium_bots,5_vs_5_medium
2350,-1,0,m_sp_arch_medium_heads_conv16_0_bt_32_r313_m335,1,medium_bots,5_vs_5_medium
2351,-3,0,m_sp_arch_medium_heads_conv16_0_bt_32_r313_m335,3,medium_bots,5_vs_5_medium
2352,-2,1,m_sp_arch_medium_heads_conv16_0_bt_32_r313_m335,3,hard_bots,5_vs_5_hard
2353,-2,0,m_sp_arch_medium_heads_conv16_0_bt_32_r313_m335,2,hard_bots,5_vs_5_hard
2354,1,2,m_sp_arch_medium_heads_conv16_0_bt_32_r313_m335,1,hard_bots,5_vs_5_hard
2355,-3,0,m_sp_arch_medium_heads_conv16_0_bt_32_r313_m335,3,hard_bots,5_vs_5_hard
2356,-2,0,m_sp_arch_medium_heads_conv16_0_bt_32_r313_m335,2,hard_bots,5_vs_5_hard
2357,1,1,m_sp_arch_medium_heads_conv16_0_bt_32_r313_m335,0,hard_bots,5_vs_5_hard
2358,-4,0,m_sp_arch_medium_heads_conv16_0_bt_32_r313_m335,4,hard_bots,5_vs_5_hard
2359,-2,0,m_sp_arch_medium_heads_conv16_0_bt_32_r313_m335,2,hard_bots,5_vs_5_hard
2360,-1,0,m_sp_arch_medium_heads_conv16_0_bt_32_r313_m335,1,hard_bots,5_vs_5_hard
2361,1,1,m_sp_arch_medium_heads_conv16_0_bt_32_r313_m335,0,hard_bots,5_vs_5_hard
2362,3,4,m_sp_arch_medium_heads_conv16_0_bt_32_r313_m335,1,f5v0to1to2t05_e2_ckpt291,5_vs_5
2363,1,3,m_sp_arch_medium_heads_conv16_0_bt_32_r313_m335,2,f5v0to1to2t05_e2_ckpt291,5_vs_5
2364,1,3,m_sp_arch_medium_heads_conv16_0_bt_32_r313_m335,2,f5v0to1to2t05_e2_ckpt291,5_vs_5
2365,6,7,m_sp_arch_medium_heads_conv16_0_bt_32_r313_m335,1,f5v0to1to2t05_e2_ckpt291,5_vs_5
2366,2,3,m_sp_arch_medium_heads_conv16_0_bt_32_r313_m335,1,f5v0to1to2t05_e2_ckpt291,5_vs_5
2367,4,5,m_sp_arch_medium_heads_conv16_0_bt_32_r313_m335,1,f5v0to1to5_e2_ckpt252,5_vs_5
2368,4,7,m_sp_arch_medium_heads_conv16_0_bt_32_r313_m335,3,f5v0to1to5_e2_ckpt252,5_vs_5
2369,-1,6,m_sp_arch_medium_heads_conv16_0_bt_32_r313_m335,7,f5v0to1to5_e2_ckpt252,5_vs_5
2370,0,3,m_sp_arch_medium_heads_conv16_0_bt_32_r313_m335,3,f5v0to1to5_e2_ckpt252,5_vs_5
2371,2,4,m_sp_arch_medium_heads_conv16_0_bt_32_r313_m335,2,f5v0to1to5_e2_ckpt252,5_vs_5
2372,5,5,m_sp_arch_medium_heads_conv16_0_bt_32_r313_m335,0,scon_e3_p2_hard_ckpt840,5_vs_5
2373,5,6,m_sp_arch_medium_heads_conv16_0_bt_32_r313_m335,1,scon_e3_p2_hard_ckpt840,5_vs_5
2374,8,8,m_sp_arch_medium_heads_conv16_0_bt_32_r313_m335,0,scon_e3_p2_hard_ckpt840,5_vs_5
2375,2,2,m_sp_arch_medium_heads_conv16_0_bt_32_r313_m335,0,scon_e3_p2_hard_ckpt840,5_vs_5
2376,3,3,m_sp_arch_medium_heads_conv16_0_bt_32_r313_m335,0,scon_e3_p2_hard_ckpt840,5_vs_5
2377,2,3,m_sp_arch_medium_heads_conv16_0_bt_32_r313_m335,1,less_then_partially_randomized_checkpoints_bots_4_heads_38_ckpt108,5_vs_5
2378,1,3,m_sp_arch_medium_heads_conv16_0_bt_32_r313_m335,2,less_then_partially_randomized_checkpoints_bots_4_heads_38_ckpt108,5_vs_5
2379,2,4,m_sp_arch_medium_heads_conv16_0_bt_32_r313_m335,2,less_then_partially_randomized_checkpoints_bots_4_heads_38_ckpt108,5_vs_5
2380,4,5,m_sp_arch_medium_heads_conv16_0_bt_32_r313_m335,1,less_then_partially_randomized_checkpoints_bots_4_heads_38_ckpt108,5_vs_5
2381,2,5,m_sp_arch_medium_heads_conv16_0_bt_32_r313_m335,3,less_then_partially_randomized_checkpoints_bots_4_heads_38_ckpt108,5_vs_5
2382,2,5,m_sp_arch_medium_heads_conv16_0_bt_32_r313_m335,3,less_then_partially_randomized_entropy_checkpoints_bots_4_heads_39_ckpt109,5_vs_5
2383,-1,1,m_sp_arch_medium_heads_conv16_0_bt_32_r313_m335,2,less_then_partially_randomized_entropy_checkpoints_bots_4_heads_39_ckpt109,5_vs_5
2384,2,4,m_sp_arch_medium_heads_conv16_0_bt_32_r313_m335,2,less_then_partially_randomized_entropy_checkpoints_bots_4_heads_39_ckpt109,5_vs_5
2385,2,3,m_sp_arch_medium_heads_conv16_0_bt_32_r313_m335,1,less_then_partially_randomized_entropy_checkpoints_bots_4_heads_39_ckpt109,5_vs_5
2386,3,5,m_sp_arch_medium_heads_conv16_0_bt_32_r313_m335,2,less_then_partially_randomized_entropy_checkpoints_bots_4_heads_39_ckpt109,5_vs_5
2387,1,3,m_sp_arch_medium_heads_conv16_0_bt_32_r313_m335,2,reward_shaping_checkpoints_bots_4_heads_1_ckpt360,5_vs_5
2388,-2,0,m_sp_arch_medium_heads_conv16_0_bt_32_r313_m335,2,reward_shaping_checkpoints_bots_4_heads_1_ckpt360,5_vs_5
2389,1,3,m_sp_arch_medium_heads_conv16_0_bt_32_r313_m335,2,reward_shaping_checkpoints_bots_4_heads_1_ckpt360,5_vs_5
2390,7,7,m_sp_arch_medium_heads_conv16_0_bt_32_r313_m335,0,reward_shaping_checkpoints_bots_4_heads_1_ckpt360,5_vs_5
2391,2,4,m_sp_arch_medium_heads_conv16_0_bt_32_r313_m335,2,reward_shaping_checkpoints_bots_4_heads_1_ckpt360,5_vs_5
2392,1,2,m_sp_arch_medium_heads_conv16_0_bt_32_r313_m335,1,checkpoints_selfplay_e9_sp_ckpt274,5_vs_5
2393,3,5,m_sp_arch_medium_heads_conv16_0_bt_32_r313_m335,2,checkpoints_selfplay_e9_sp_ckpt274,5_vs_5
2394,-1,3,m_sp_arch_medium_heads_conv16_0_bt_32_r313_m335,4,checkpoints_selfplay_e9_sp_ckpt274,5_vs_5
2395,-4,2,m_sp_arch_medium_heads_conv16_0_bt_32_r313_m335,6,checkpoints_selfplay_e9_sp_ckpt274,5_vs_5
2396,0,5,m_sp_arch_medium_heads_conv16_0_bt_32_r313_m335,5,checkpoints_selfplay_e9_sp_ckpt274,5_vs_5
2397,-1,3,m_sp_arch_medium_heads_conv16_0_bt_32_r313_m335,4,checkpoints_sp_c_nb_e2_ckpt667,5_vs_5
2398,-3,2,m_sp_arch_medium_heads_conv16_0_bt_32_r313_m335,5,checkpoints_sp_c_nb_e2_ckpt667,5_vs_5
2399,-4,1,m_sp_arch_medium_heads_conv16_0_bt_32_r313_m335,5,checkpoints_sp_c_nb_e2_ckpt667,5_vs_5
2400,-3,3,m_sp_arch_medium_heads_conv16_0_bt_32_r313_m335,6,checkpoints_sp_c_nb_e2_ckpt667,5_vs_5
2401,-3,3,m_sp_arch_medium_heads_conv16_0_bt_32_r313_m335,6,checkpoints_sp_c_nb_e2_ckpt667,5_vs_5
2402,0,2,m_sp_arch_medium_heads_conv16_0_bt_32_r313_m335,2,m_sp_arch_medium_heads_conv16_0_bt_32_r313_m335,5_vs_5
2403,3,3,m_sp_arch_medium_heads_conv16_0_bt_32_r313_m335,0,m_sp_arch_medium_heads_conv16_0_bt_32_r313_m335,5_vs_5
2404,0,4,m_sp_arch_medium_heads_conv16_0_bt_32_r313_m335,4,m_sp_arch_medium_heads_conv16_0_bt_32_r313_m335,5_vs_5
2405,0,2,m_sp_arch_medium_heads_conv16_0_bt_32_r313_m335,2,m_sp_arch_medium_heads_conv16_0_bt_32_r313_m335,5_vs_5
2406,-2,1,m_sp_arch_medium_heads_conv16_0_bt_32_r313_m335,3,m_sp_arch_medium_heads_conv16_0_bt_32_r313_m335,5_vs_5
2407,0,2,m_sp_arch_medium_heads_conv16_0_bt_32_r313_m335,2,m_sp_arch_longer_heads_bt_32_r201_m335,5_vs_5
2408,0,2,m_sp_arch_medium_heads_conv16_0_bt_32_r313_m335,2,m_sp_arch_longer_heads_bt_32_r201_m335,5_vs_5
2409,1,1,m_sp_arch_medium_heads_conv16_0_bt_32_r313_m335,0,m_sp_arch_longer_heads_bt_32_r201_m335,5_vs_5
2410,-1,1,m_sp_arch_medium_heads_conv16_0_bt_32_r313_m335,2,m_sp_arch_longer_heads_bt_32_r201_m335,5_vs_5
2411,0,2,m_sp_arch_medium_heads_conv16_0_bt_32_r313_m335,2,m_sp_arch_longer_heads_bt_32_r201_m335,5_vs_5
2412,2,5,m_sp_arch_medium_heads_conv16_0_bt_32_r313_m335,3,m_sp_arch_medium_heads_bt_32_r201_m335,5_vs_5
2413,5,5,m_sp_arch_medium_heads_conv16_0_bt_32_r313_m335,0,m_sp_arch_medium_heads_bt_32_r201_m335,5_vs_5
2414,3,4,m_sp_arch_medium_heads_conv16_0_bt_32_r313_m335,1,m_sp_arch_medium_heads_bt_32_r201_m335,5_vs_5
2415,-3,1,m_sp_arch_medium_heads_conv16_0_bt_32_r313_m335,4,m_sp_arch_medium_heads_bt_32_r201_m335,5_vs_5
2416,1,3,m_sp_arch_medium_heads_conv16_0_bt_32_r313_m335,2,m_sp_arch_medium_heads_bt_32_r201_m335,5_vs_5
2417,-5,0,m_sp_arch_medium_heads_conv16_0_bt_32_r313_m335,5,m_sp_arch_4x1_bt_32_r201_m335,5_vs_5
2418,-10,0,m_sp_arch_medium_heads_conv16_0_bt_32_r313_m335,10,m_sp_arch_4x1_bt_32_r201_m335,5_vs_5
2419,-8,0,m_sp_arch_medium_heads_conv16_0_bt_32_r313_m335,8,m_sp_arch_4x1_bt_32_r201_m335,5_vs_5
2420,-7,0,m_sp_arch_medium_heads_conv16_0_bt_32_r313_m335,7,m_sp_arch_4x1_bt_32_r201_m335,5_vs_5
2421,-5,2,m_sp_arch_medium_heads_conv16_0_bt_32_r313_m335,7,m_sp_arch_4x1_bt_32_r201_m335,5_vs_5
2422,-4,1,m_sp_arch_medium_heads_conv16_0_bt_32_r313_m335,5,m_sp_arch_4x1_bt_32_r201_cont3_m650,5_vs_5
2423,-6,0,m_sp_arch_medium_heads_conv16_0_bt_32_r313_m335,6,m_sp_arch_4x1_bt_32_r201_cont3_m650,5_vs_5
2424,-6,0,m_sp_arch_medium_heads_conv16_0_bt_32_r313_m335,6,m_sp_arch_4x1_bt_32_r201_cont3_m650,5_vs_5
2425,-11,0,m_sp_arch_medium_heads_conv16_0_bt_32_r313_m335,11,m_sp_arch_4x1_bt_32_r201_cont3_m650,5_vs_5
2426,-4,1,m_sp_arch_medium_heads_conv16_0_bt_32_r313_m335,5,m_sp_arch_4x1_bt_32_r201_cont3_m650,5_vs_5
2427,-3,2,m_sp_arch_medium_heads_conv16_0_bt_32_r313_m335,5,explt_v0_7_2_m54,5_vs_5
2428,-5,1,m_sp_arch_medium_heads_conv16_0_bt_32_r313_m335,6,explt_v0_7_2_m54,5_vs_5
2429,0,2,m_sp_arch_medium_heads_conv16_0_bt_32_r313_m335,2,explt_v0_7_2_m54,5_vs_5
2430,-1,0,m_sp_arch_medium_heads_conv16_0_bt_32_r313_m335,1,explt_v0_7_2_m54,5_vs_5
2431,-2,0,m_sp_arch_medium_heads_conv16_0_bt_32_r313_m335,2,explt_v0_7_2_m54,5_vs_5
2432,-7,1,m_sp_arch_medium_heads_conv16_0_bt_32_r313_m335,8,m_sp_sc3v3_arch_2x1_32_r500_cont4x1_m224,5_vs_5
2433,-3,1,m_sp_arch_medium_heads_conv16_0_bt_32_r313_m335,4,m_sp_sc3v3_arch_2x1_32_r500_cont4x1_m224,5_vs_5
2434,-3,1,m_sp_arch_medium_heads_conv16_0_bt_32_r313_m335,4,m_sp_sc3v3_arch_2x1_32_r500_cont4x1_m224,5_vs_5
2435,-3,1,m_sp_arch_medium_heads_conv16_0_bt_32_r313_m335,4,m_sp_sc3v3_arch_2x1_32_r500_cont4x1_m224,5_vs_5
2436,-6,0,m_sp_arch_medium_heads_conv16_0_bt_32_r313_m335,6,m_sp_sc3v3_arch_2x1_32_r500_cont4x1_m224,5_vs_5
2437,-2,0,m_sp_arch_medium_heads_conv16_0_bt_32_r313_m335,2,m_sp_arch_4x1_bt_32_roles_r500_m335,5_vs_5
2438,-4,4,m_sp_arch_medium_heads_conv16_0_bt_32_r313_m335,8,m_sp_arch_4x1_bt_32_roles_r500_m335,5_vs_5
2439,-5,2,m_sp_arch_medium_heads_conv16_0_bt_32_r313_m335,7,m_sp_arch_4x1_bt_32_roles_r500_m335,5_vs_5
2440,-5,1,m_sp_arch_medium_heads_conv16_0_bt_32_r313_m335,6,m_sp_arch_4x1_bt_32_roles_r500_m335,5_vs_5
2441,-5,0,m_sp_arch_medium_heads_conv16_0_bt_32_r313_m335,5,m_sp_arch_4x1_bt_32_roles_r500_m335,5_vs_5
2442,1,3,checkpoints_sp_c_nb_e2_ckpt667,2,easy_bots,5_vs_5
2443,5,5,checkpoints_sp_c_nb_e2_ckpt667,0,easy_bots,5_vs_5
2444,0,2,checkpoints_sp_c_nb_e2_ckpt667,2,easy_bots,5_vs_5
2445,-2,1,checkpoints_sp_c_nb_e2_ckpt667,3,easy_bots,5_vs_5
2446,-1,1,checkpoints_sp_c_nb_e2_ckpt667,2,medium_bots,5_vs_5_medium
2447,-3,1,checkpoints_sp_c_nb_e2_ckpt667,4,medium_bots,5_vs_5_medium
2448,-2,1,checkpoints_sp_c_nb_e2_ckpt667,3,medium_bots,5_vs_5_medium
2449,0,1,checkpoints_sp_c_nb_e2_ckpt667,1,medium_bots,5_vs_5_medium
2450,-1,1,checkpoints_sp_c_nb_e2_ckpt667,2,hard_bots,5_vs_5_hard
2451,2,2,checkpoints_sp_c_nb_e2_ckpt667,0,hard_bots,5_vs_5_hard
2452,-1,1,checkpoints_sp_c_nb_e2_ckpt667,2,hard_bots,5_vs_5_hard
2453,-4,1,checkpoints_sp_c_nb_e2_ckpt667,5,hard_bots,5_vs_5_hard
2454,10,11,checkpoints_sp_c_nb_e2_ckpt667,1,f5v0to1to2t05_e2_ckpt291,5_vs_5
2455,5,6,checkpoints_sp_c_nb_e2_ckpt667,1,f5v0to1to2t05_e2_ckpt291,5_vs_5
2456,2,2,checkpoints_sp_c_nb_e2_ckpt667,0,f5v0to1to5_e2_ckpt252,5_vs_5
2457,7,8,checkpoints_sp_c_nb_e2_ckpt667,1,f5v0to1to5_e2_ckpt252,5_vs_5
2458,10,10,checkpoints_sp_c_nb_e2_ckpt667,0,scon_e3_p2_hard_ckpt840,5_vs_5
2459,4,6,checkpoints_sp_c_nb_e2_ckpt667,2,scon_e3_p2_hard_ckpt840,5_vs_5
2460,4,4,checkpoints_sp_c_nb_e2_ckpt667,0,less_then_partially_randomized_checkpoints_bots_4_heads_38_ckpt108,5_vs_5
2461,11,11,checkpoints_sp_c_nb_e2_ckpt667,0,less_then_partially_randomized_checkpoints_bots_4_heads_38_ckpt108,5_vs_5
2462,7,7,checkpoints_sp_c_nb_e2_ckpt667,0,less_then_partially_randomized_entropy_checkpoints_bots_4_heads_39_ckpt109,5_vs_5
2463,6,6,checkpoints_sp_c_nb_e2_ckpt667,0,less_then_partially_randomized_entropy_checkpoints_bots_4_heads_39_ckpt109,5_vs_5
2464,6,6,checkpoints_sp_c_nb_e2_ckpt667,0,reward_shaping_checkpoints_bots_4_heads_1_ckpt360,5_vs_5
2465,4,4,checkpoints_sp_c_nb_e2_ckpt667,0,reward_shaping_checkpoints_bots_4_heads_1_ckpt360,5_vs_5
2466,7,8,checkpoints_sp_c_nb_e2_ckpt667,1,checkpoints_selfplay_e9_sp_ckpt274,5_vs_5
2467,3,6,checkpoints_sp_c_nb_e2_ckpt667,3,checkpoints_selfplay_e9_sp_ckpt274,5_vs_5
2468,-2,1,checkpoints_sp_c_nb_e2_ckpt667,3,checkpoints_sp_c_nb_e2_ckpt667,5_vs_5
2469,-2,0,checkpoints_sp_c_nb_e2_ckpt667,2,checkpoints_sp_c_nb_e2_ckpt667,5_vs_5
2470,1,3,checkpoints_sp_c_nb_e2_ckpt667,2,m_sp_arch_medium_heads_conv16_0_bt_32_r313_m335,5_vs_5
2471,7,7,checkpoints_sp_c_nb_e2_ckpt667,0,m_sp_arch_medium_heads_conv16_0_bt_32_r313_m335,5_vs_5
2472,5,6,checkpoints_sp_c_nb_e2_ckpt667,1,m_sp_arch_longer_heads_bt_32_r201_m335,5_vs_5
2473,1,4,checkpoints_sp_c_nb_e2_ckpt667,3,m_sp_arch_longer_heads_bt_32_r201_m335,5_vs_5
2474,6,8,checkpoints_sp_c_nb_e2_ckpt667,2,m_sp_arch_medium_heads_bt_32_r201_m335,5_vs_5
2475,3,3,checkpoints_sp_c_nb_e2_ckpt667,0,m_sp_arch_medium_heads_bt_32_r201_m335,5_vs_5
2476,-5,1,checkpoints_sp_c_nb_e2_ckpt667,6,m_sp_arch_4x1_bt_32_r201_m335,5_vs_5
2477,-2,2,checkpoints_sp_c_nb_e2_ckpt667,4,m_sp_arch_4x1_bt_32_r201_m335,5_vs_5
2478,-5,0,checkpoints_sp_c_nb_e2_ckpt667,5,m_sp_arch_4x1_bt_32_r201_cont3_m650,5_vs_5
2479,-1,1,checkpoints_sp_c_nb_e2_ckpt667,2,m_sp_arch_4x1_bt_32_r201_cont3_m650,5_vs_5
2480,-2,0,checkpoints_sp_c_nb_e2_ckpt667,2,explt_v0_7_2_m54,5_vs_5
2481,-2,1,checkpoints_sp_c_nb_e2_ckpt667,3,explt_v0_7_2_m54,5_vs_5
2482,-3,2,checkpoints_sp_c_nb_e2_ckpt667,5,m_sp_sc3v3_arch_2x1_32_r500_cont4x1_m224,5_vs_5
2483,-1,4,checkpoints_sp_c_nb_e2_ckpt667,5,m_sp_sc3v3_arch_2x1_32_r500_cont4x1_m224,5_vs_5
2484,-6,2,checkpoints_sp_c_nb_e2_ckpt667,8,m_sp_arch_4x1_bt_32_roles_r500_m335,5_vs_5
2485,-3,0,checkpoints_sp_c_nb_e2_ckpt667,3,m_sp_arch_4x1_bt_32_roles_r500_m335,5_vs_5
2486,8,10,scon_e3_p2_hard_ckpt840,2,easy_bots,5_vs_5
2487,11,12,scon_e3_p2_hard_ckpt840,1,easy_bots,5_vs_5
2488,10,13,scon_e3_p2_hard_ckpt840,3,easy_bots,5_vs_5
2489,5,7,scon_e3_p2_hard_ckpt840,2,easy_bots,5_vs_5
2490,4,5,scon_e3_p2_hard_ckpt840,1,easy_bots,5_vs_5
2491,5,8,scon_e3_p2_hard_ckpt840,3,easy_bots,5_vs_5
2492,6,8,scon_e3_p2_hard_ckpt840,2,easy_bots,5_vs_5
2493,10,11,scon_e3_p2_hard_ckpt840,1,easy_bots,5_vs_5
2494,11,12,scon_e3_p2_hard_ckpt840,1,easy_bots,5_vs_5
2495,4,5,scon_e3_p2_hard_ckpt840,1,easy_bots,5_vs_5
2496,8,10,scon_e3_p2_hard_ckpt840,2,medium_bots,5_vs_5_medium
2497,14,15,scon_e3_p2_hard_ckpt840,1,medium_bots,5_vs_5_medium
2498,6,8,scon_e3_p2_hard_ckpt840,2,medium_bots,5_vs_5_medium
2499,8,9,scon_e3_p2_hard_ckpt840,1,medium_bots,5_vs_5_medium
2500,8,9,scon_e3_p2_hard_ckpt840,1,medium_bots,5_vs_5_medium
2501,9,9,scon_e3_p2_hard_ckpt840,0,medium_bots,5_vs_5_medium
2502,11,12,scon_e3_p2_hard_ckpt840,1,medium_bots,5_vs_5_medium
2503,10,13,scon_e3_p2_hard_ckpt840,3,medium_bots,5_vs_5_medium
2504,11,12,scon_e3_p2_hard_ckpt840,1,medium_bots,5_vs_5_medium
2505,10,10,scon_e3_p2_hard_ckpt840,0,medium_bots,5_vs_5_medium
2506,3,6,scon_e3_p2_hard_ckpt840,3,hard_bots,5_vs_5_hard
2507,10,10,scon_e3_p2_hard_ckpt840,0,hard_bots,5_vs_5_hard
2508,12,13,scon_e3_p2_hard_ckpt840,1,hard_bots,5_vs_5_hard
2509,9,10,scon_e3_p2_hard_ckpt840,1,hard_bots,5_vs_5_hard
2510,11,12,scon_e3_p2_hard_ckpt840,1,hard_bots,5_vs_5_hard
2511,5,7,scon_e3_p2_hard_ckpt840,2,hard_bots,5_vs_5_hard
2512,8,10,scon_e3_p2_hard_ckpt840,2,hard_bots,5_vs_5_hard
2513,7,9,scon_e3_p2_hard_ckpt840,2,hard_bots,5_vs_5_hard
2514,8,9,scon_e3_p2_hard_ckpt840,1,hard_bots,5_vs_5_hard
2515,8,8,scon_e3_p2_hard_ckpt840,0,hard_bots,5_vs_5_hard
2516,2,4,scon_e3_p2_hard_ckpt840,2,f5v0to1to2t05_e2_ckpt291,5_vs_5
2517,-5,1,scon_e3_p2_hard_ckpt840,6,f5v0to1to2t05_e2_ckpt291,5_vs_5
2518,-4,2,scon_e3_p2_hard_ckpt840,6,f5v0to1to2t05_e2_ckpt291,5_vs_5
2519,-1,2,scon_e3_p2_hard_ckpt840,3,f5v0to1to2t05_e2_ckpt291,5_vs_5
2520,-6,0,scon_e3_p2_hard_ckpt840,6,f5v0to1to2t05_e2_ckpt291,5_vs_5
2521,0,2,scon_e3_p2_hard_ckpt840,2,f5v0to1to5_e2_ckpt252,5_vs_5
2522,3,5,scon_e3_p2_hard_ckpt840,2,f5v0to1to5_e2_ckpt252,5_vs_5
2523,-1,4,scon_e3_p2_hard_ckpt840,5,f5v0to1to5_e2_ckpt252,5_vs_5
2524,0,2,scon_e3_p2_hard_ckpt840,2,f5v0to1to5_e2_ckpt252,5_vs_5
2525,1,3,scon_e3_p2_hard_ckpt840,2,f5v0to1to5_e2_ckpt252,5_vs_5
2526,1,2,scon_e3_p2_hard_ckpt840,1,scon_e3_p2_hard_ckpt840,5_vs_5
2527,-1,2,scon_e3_p2_hard_ckpt840,3,scon_e3_p2_hard_ckpt840,5_vs_5
2528,-2,0,scon_e3_p2_hard_ckpt840,2,scon_e3_p2_hard_ckpt840,5_vs_5
2529,-1,2,scon_e3_p2_hard_ckpt840,3,scon_e3_p2_hard_ckpt840,5_vs_5
2530,5,5,scon_e3_p2_hard_ckpt840,0,scon_e3_p2_hard_ckpt840,5_vs_5
2531,-3,0,scon_e3_p2_hard_ckpt840,3,less_then_partially_randomized_checkpoints_bots_4_heads_38_ckpt108,5_vs_5
2532,4,5,scon_e3_p2_hard_ckpt840,1,less_then_partially_randomized_checkpoints_bots_4_heads_38_ckpt108,5_vs_5
2533,1,2,scon_e3_p2_hard_ckpt840,1,less_then_partially_randomized_checkpoints_bots_4_heads_38_ckpt108,5_vs_5
2534,0,3,scon_e3_p2_hard_ckpt840,3,less_then_partially_randomized_checkpoints_bots_4_heads_38_ckpt108,5_vs_5
2535,-2,1,scon_e3_p2_hard_ckpt840,3,less_then_partially_randomized_checkpoints_bots_4_heads_38_ckpt108,5_vs_5
2536,3,4,scon_e3_p2_hard_ckpt840,1,less_then_partially_randomized_entropy_checkpoints_bots_4_heads_39_ckpt109,5_vs_5
2537,-2,2,scon_e3_p2_hard_ckpt840,4,less_then_partially_randomized_entropy_checkpoints_bots_4_heads_39_ckpt109,5_vs_5
2538,1,4,scon_e3_p2_hard_ckpt840,3,less_then_partially_randomized_entropy_checkpoints_bots_4_heads_39_ckpt109,5_vs_5
2539,-1,3,scon_e3_p2_hard_ckpt840,4,less_then_partially_randomized_entropy_checkpoints_bots_4_heads_39_ckpt109,5_vs_5
2540,0,3,scon_e3_p2_hard_ckpt840,3,less_then_partially_randomized_entropy_checkpoints_bots_4_heads_39_ckpt109,5_vs_5
2541,1,5,scon_e3_p2_hard_ckpt840,4,reward_shaping_checkpoints_bots_4_heads_1_ckpt360,5_vs_5
2542,-2,2,scon_e3_p2_hard_ckpt840,4,reward_shaping_checkpoints_bots_4_heads_1_ckpt360,5_vs_5
2543,3,5,scon_e3_p2_hard_ckpt840,2,reward_shaping_checkpoints_bots_4_heads_1_ckpt360,5_vs_5
2544,-2,2,scon_e3_p2_hard_ckpt840,4,reward_shaping_checkpoints_bots_4_heads_1_ckpt360,5_vs_5
2545,4,4,scon_e3_p2_hard_ckpt840,0,reward_shaping_checkpoints_bots_4_heads_1_ckpt360,5_vs_5
2546,-6,1,scon_e3_p2_hard_ckpt840,7,checkpoints_selfplay_e9_sp_ckpt274,5_vs_5
2547,-5,4,scon_e3_p2_hard_ckpt840,9,checkpoints_selfplay_e9_sp_ckpt274,5_vs_5
2548,-3,2,scon_e3_p2_hard_ckpt840,5,checkpoints_selfplay_e9_sp_ckpt274,5_vs_5
2549,-7,1,scon_e3_p2_hard_ckpt840,8,checkpoints_selfplay_e9_sp_ckpt274,5_vs_5
2550,-8,0,scon_e3_p2_hard_ckpt840,8,checkpoints_selfplay_e9_sp_ckpt274,5_vs_5
2551,-6,1,scon_e3_p2_hard_ckpt840,7,checkpoints_sp_c_nb_e2_ckpt667,5_vs_5
2552,-11,0,scon_e3_p2_hard_ckpt840,11,checkpoints_sp_c_nb_e2_ckpt667,5_vs_5
2553,-7,2,scon_e3_p2_hard_ckpt840,9,checkpoints_sp_c_nb_e2_ckpt667,5_vs_5
2554,-6,0,scon_e3_p2_hard_ckpt840,6,checkpoints_sp_c_nb_e2_ckpt667,5_vs_5
2555,-4,1,scon_e3_p2_hard_ckpt840,5,checkpoints_sp_c_nb_e2_ckpt667,5_vs_5
2556,-5,0,scon_e3_p2_hard_ckpt840,5,m_sp_arch_medium_heads_conv16_0_bt_32_r313_m335,5_vs_5
2557,-1,1,scon_e3_p2_hard_ckpt840,2,m_sp_arch_medium_heads_conv16_0_bt_32_r313_m335,5_vs_5
2558,-4,0,scon_e3_p2_hard_ckpt840,4,m_sp_arch_medium_heads_conv16_0_bt_32_r313_m335,5_vs_5
2559,-6,0,scon_e3_p2_hard_ckpt840,6,m_sp_arch_medium_heads_conv16_0_bt_32_r313_m335,5_vs_5
2560,-5,1,scon_e3_p2_hard_ckpt840,6,m_sp_arch_medium_heads_conv16_0_bt_32_r313_m335,5_vs_5
2561,-4,0,scon_e3_p2_hard_ckpt840,4,m_sp_arch_longer_heads_bt_32_r201_m335,5_vs_5
2562,-4,1,scon_e3_p2_hard_ckpt840,5,m_sp_arch_longer_heads_bt_32_r201_m335,5_vs_5
2563,-5,0,scon_e3_p2_hard_ckpt840,5,m_sp_arch_longer_heads_bt_32_r201_m335,5_vs_5
2564,-5,0,scon_e3_p2_hard_ckpt840,5,m_sp_arch_longer_heads_bt_32_r201_m335,5_vs_5
2565,-5,1,scon_e3_p2_hard_ckpt840,6,m_sp_arch_longer_heads_bt_32_r201_m335,5_vs_5
2566,-2,2,scon_e3_p2_hard_ckpt840,4,m_sp_arch_medium_heads_bt_32_r201_m335,5_vs_5
2567,-6,1,scon_e3_p2_hard_ckpt840,7,m_sp_arch_medium_heads_bt_32_r201_m335,5_vs_5
2568,-9,0,scon_e3_p2_hard_ckpt840,9,m_sp_arch_medium_heads_bt_32_r201_m335,5_vs_5
2569,-10,0,scon_e3_p2_hard_ckpt840,10,m_sp_arch_medium_heads_bt_32_r201_m335,5_vs_5
2570,-5,1,scon_e3_p2_hard_ckpt840,6,m_sp_arch_medium_heads_bt_32_r201_m335,5_vs_5
2571,-12,0,scon_e3_p2_hard_ckpt840,12,m_sp_arch_4x1_bt_32_r201_m335,5_vs_5
2572,-14,0,scon_e3_p2_hard_ckpt840,14,m_sp_arch_4x1_bt_32_r201_m335,5_vs_5
2573,-6,0,scon_e3_p2_hard_ckpt840,6,m_sp_arch_4x1_bt_32_r201_m335,5_vs_5
2574,-13,0,scon_e3_p2_hard_ckpt840,13,m_sp_arch_4x1_bt_32_r201_m335,5_vs_5
2575,-13,0,scon_e3_p2_hard_ckpt840,13,m_sp_arch_4x1_bt_32_r201_m335,5_vs_5
2576,-9,0,scon_e3_p2_hard_ckpt840,9,m_sp_arch_4x1_bt_32_r201_cont3_m650,5_vs_5
2577,-10,0,scon_e3_p2_hard_ckpt840,10,m_sp_arch_4x1_bt_32_r201_cont3_m650,5_vs_5
2578,-11,0,scon_e3_p2_hard_ckpt840,11,m_sp_arch_4x1_bt_32_r201_cont3_m650,5_vs_5
2579,-7,0,scon_e3_p2_hard_ckpt840,7,m_sp_arch_4x1_bt_32_r201_cont3_m650,5_vs_5
2580,-10,0,scon_e3_p2_hard_ckpt840,10,m_sp_arch_4x1_bt_32_r201_cont3_m650,5_vs_5
2581,-3,0,scon_e3_p2_hard_ckpt840,3,explt_v0_7_2_m54,5_vs_5
2582,-1,0,scon_e3_p2_hard_ckpt840,1,explt_v0_7_2_m54,5_vs_5
2583,-4,0,scon_e3_p2_hard_ckpt840,4,explt_v0_7_2_m54,5_vs_5
2584,-1,0,scon_e3_p2_hard_ckpt840,1,explt_v0_7_2_m54,5_vs_5
2585,0,0,scon_e3_p2_hard_ckpt840,0,explt_v0_7_2_m54,5_vs_5
2586,-13,0,scon_e3_p2_hard_ckpt840,13,m_sp_sc3v3_arch_2x1_32_r500_cont4x1_m224,5_vs_5
2587,-10,0,scon_e3_p2_hard_ckpt840,10,m_sp_sc3v3_arch_2x1_32_r500_cont4x1_m224,5_vs_5
2588,-12,0,scon_e3_p2_hard_ckpt840,12,m_sp_sc3v3_arch_2x1_32_r500_cont4x1_m224,5_vs_5
2589,-15,0,scon_e3_p2_hard_ckpt840,15,m_sp_sc3v3_arch_2x1_32_r500_cont4x1_m224,5_vs_5
2590,-12,0,scon_e3_p2_hard_ckpt840,12,m_sp_sc3v3_arch_2x1_32_r500_cont4x1_m224,5_vs_5
2591,-9,0,scon_e3_p2_hard_ckpt840,9,m_sp_arch_4x1_bt_32_roles_r500_m335,5_vs_5
2592,-10,0,scon_e3_p2_hard_ckpt840,10,m_sp_arch_4x1_bt_32_roles_r500_m335,5_vs_5
2593,-8,0,scon_e3_p2_hard_ckpt840,8,m_sp_arch_4x1_bt_32_roles_r500_m335,5_vs_5
2594,-8,0,scon_e3_p2_hard_ckpt840,8,m_sp_arch_4x1_bt_32_roles_r500_m335,5_vs_5
2595,-12,1,scon_e3_p2_hard_ckpt840,13,m_sp_arch_4x1_bt_32_roles_r500_m335,5_vs_5
2596,3,6,f5v0to1to5_e2_ckpt252,3,easy_bots,5_vs_5
2597,3,4,f5v0to1to5_e2_ckpt252,1,easy_bots,5_vs_5
2598,1,2,f5v0to1to5_e2_ckpt252,1,easy_bots,5_vs_5
2599,7,10,f5v0to1to5_e2_ckpt252,3,easy_bots,5_vs_5
2600,8,8,f5v0to1to5_e2_ckpt252,0,easy_bots,5_vs_5
2601,5,6,f5v0to1to5_e2_ckpt252,1,easy_bots,5_vs_5
2602,5,6,f5v0to1to5_e2_ckpt252,1,medium_bots,5_vs_5_medium
2603,6,9,f5v0to1to5_e2_ckpt252,3,medium_bots,5_vs_5_medium
2604,8,9,f5v0to1to5_e2_ckpt252,1,medium_bots,5_vs_5_medium
2605,9,10,f5v0to1to5_e2_ckpt252,1,medium_bots,5_vs_5_medium
2606,8,9,f5v0to1to5_e2_ckpt252,1,medium_bots,5_vs_5_medium
2607,11,13,f5v0to1to5_e2_ckpt252,2,medium_bots,5_vs_5_medium
2608,8,10,f5v0to1to5_e2_ckpt252,2,hard_bots,5_vs_5_hard
2609,5,6,f5v0to1to5_e2_ckpt252,1,hard_bots,5_vs_5_hard
2610,6,8,f5v0to1to5_e2_ckpt252,2,hard_bots,5_vs_5_hard
2611,5,7,f5v0to1to5_e2_ckpt252,2,hard_bots,5_vs_5_hard
2612,14,16,f5v0to1to5_e2_ckpt252,2,hard_bots,5_vs_5_hard
2613,1,2,f5v0to1to5_e2_ckpt252,1,hard_bots,5_vs_5_hard
2614,-1,2,f5v0to1to5_e2_ckpt252,3,f5v0to1to2t05_e2_ckpt291,5_vs_5
2615,-1,4,f5v0to1to5_e2_ckpt252,5,f5v0to1to2t05_e2_ckpt291,5_vs_5
2616,-1,4,f5v0to1to5_e2_ckpt252,5,f5v0to1to2t05_e2_ckpt291,5_vs_5
2617,-7,1,f5v0to1to5_e2_ckpt252,8,f5v0to1to5_e2_ckpt252,5_vs_5
2618,1,4,f5v0to1to5_e2_ckpt252,3,f5v0to1to5_e2_ckpt252,5_vs_5
2619,-1,2,f5v0to1to5_e2_ckpt252,3,f5v0to1to5_e2_ckpt252,5_vs_5
2620,0,3,f5v0to1to5_e2_ckpt252,3,scon_e3_p2_hard_ckpt840,5_vs_5
2621,1,2,f5v0to1to5_e2_ckpt252,1,scon_e3_p2_hard_ckpt840,5_vs_5
2622,3,5,f5v0to1to5_e2_ckpt252,2,scon_e3_p2_hard_ckpt840,5_vs_5
2623,-2,3,f5v0to1to5_e2_ckpt252,5,less_then_partially_randomized_checkpoints_bots_4_heads_38_ckpt108,5_vs_5
2624,-1,4,f5v0to1to5_e2_ckpt252,5,less_then_partially_randomized_checkpoints_bots_4_heads_38_ckpt108,5_vs_5
2625,5,6,f5v0to1to5_e2_ckpt252,1,less_then_partially_randomized_checkpoints_bots_4_heads_38_ckpt108,5_vs_5
2626,0,5,f5v0to1to5_e2_ckpt252,5,less_then_partially_randomized_entropy_checkpoints_bots_4_heads_39_ckpt109,5_vs_5
2627,2,4,f5v0to1to5_e2_ckpt252,2,less_then_partially_randomized_entropy_checkpoints_bots_4_heads_39_ckpt109,5_vs_5
2628,4,6,f5v0to1to5_e2_ckpt252,2,less_then_partially_randomized_entropy_checkpoints_bots_4_heads_39_ckpt109,5_vs_5
2629,6,8,f5v0to1to5_e2_ckpt252,2,reward_shaping_checkpoints_bots_4_heads_1_ckpt360,5_vs_5
2630,0,3,f5v0to1to5_e2_ckpt252,3,reward_shaping_checkpoints_bots_4_heads_1_ckpt360,5_vs_5
2631,-1,2,f5v0to1to5_e2_ckpt252,3,reward_shaping_checkpoints_bots_4_heads_1_ckpt360,5_vs_5
2632,-4,2,f5v0to1to5_e2_ckpt252,6,checkpoints_selfplay_e9_sp_ckpt274,5_vs_5
2633,-3,3,f5v0to1to5_e2_ckpt252,6,checkpoints_selfplay_e9_sp_ckpt274,5_vs_5
2634,-7,2,f5v0to1to5_e2_ckpt252,9,checkpoints_selfplay_e9_sp_ckpt274,5_vs_5
2635,-4,2,f5v0to1to5_e2_ckpt252,6,checkpoints_sp_c_nb_e2_ckpt667,5_vs_5
2636,-4,3,f5v0to1to5_e2_ckpt252,7,checkpoints_sp_c_nb_e2_ckpt667,5_vs_5
2637,-8,2,f5v0to1to5_e2_ckpt252,10,checkpoints_sp_c_nb_e2_ckpt667,5_vs_5
2638,-1,2,f5v0to1to5_e2_ckpt252,3,m_sp_arch_medium_heads_conv16_0_bt_32_r313_m335,5_vs_5
2639,0,1,f5v0to1to5_e2_ckpt252,1,m_sp_arch_medium_heads_conv16_0_bt_32_r313_m335,5_vs_5
2640,-5,1,f5v0to1to5_e2_ckpt252,6,m_sp_arch_medium_heads_conv16_0_bt_32_r313_m335,5_vs_5
2641,-6,2,f5v0to1to5_e2_ckpt252,8,m_sp_arch_longer_heads_bt_32_r201_m335,5_vs_5
2642,1,1,f5v0to1to5_e2_ckpt252,0,m_sp_arch_longer_heads_bt_32_r201_m335,5_vs_5
2643,-1,0,f5v0to1to5_e2_ckpt252,1,m_sp_arch_longer_heads_bt_32_r201_m335,5_vs_5
2644,-2,1,f5v0to1to5_e2_ckpt252,3,m_sp_arch_medium_heads_bt_32_r201_m335,5_vs_5
2645,0,2,f5v0to1to5_e2_ckpt252,2,m_sp_arch_medium_heads_bt_32_r201_m335,5_vs_5
2646,-7,2,f5v0to1to5_e2_ckpt252,9,m_sp_arch_medium_heads_bt_32_r201_m335,5_vs_5
2647,-4,0,f5v0to1to5_e2_ckpt252,4,m_sp_arch_4x1_bt_32_r201_m335,5_vs_5
2648,-8,1,f5v0to1to5_e2_ckpt252,9,m_sp_arch_4x1_bt_32_r201_m335,5_vs_5
2649,-6,0,f5v0to1to5_e2_ckpt252,6,m_sp_arch_4x1_bt_32_r201_m335,5_vs_5
2650,-10,0,f5v0to1to5_e2_ckpt252,10,m_sp_arch_4x1_bt_32_r201_cont3_m650,5_vs_5
2651,-9,1,f5v0to1to5_e2_ckpt252,10,m_sp_arch_4x1_bt_32_r201_cont3_m650,5_vs_5
2652,-7,0,f5v0to1to5_e2_ckpt252,7,m_sp_arch_4x1_bt_32_r201_cont3_m650,5_vs_5
2653,-2,0,f5v0to1to5_e2_ckpt252,2,explt_v0_7_2_m54,5_vs_5
2654,-2,1,f5v0to1to5_e2_ckpt252,3,explt_v0_7_2_m54,5_vs_5
2655,0,1,f5v0to1to5_e2_ckpt252,1,explt_v0_7_2_m54,5_vs_5
2656,-8,0,f5v0to1to5_e2_ckpt252,8,m_sp_sc3v3_arch_2x1_32_r500_cont4x1_m224,5_vs_5
2657,-7,2,f5v0to1to5_e2_ckpt252,9,m_sp_sc3v3_arch_2x1_32_r500_cont4x1_m224,5_vs_5
2658,-4,2,f5v0to1to5_e2_ckpt252,6,m_sp_sc3v3_arch_2x1_32_r500_cont4x1_m224,5_vs_5
2659,-8,1,f5v0to1to5_e2_ckpt252,9,m_sp_arch_4x1_bt_32_roles_r500_m335,5_vs_5
2660,-9,1,f5v0to1to5_e2_ckpt252,10,m_sp_arch_4x1_bt_32_roles_r500_m335,5_vs_5
2661,-14,0,f5v0to1to5_e2_ckpt252,14,m_sp_arch_4x1_bt_32_roles_r500_m335,5_vs_5
2662,1,4,m_sp_arch_4x1_bt_32_roles_r500_m335,3,easy_bots,5_vs_5
2663,0,2,m_sp_arch_4x1_bt_32_roles_r500_m335,2,easy_bots,5_vs_5
2664,2,3,m_sp_arch_4x1_bt_32_roles_r500_m335,1,easy_bots,5_vs_5
2665,4,6,m_sp_arch_4x1_bt_32_roles_r500_m335,2,easy_bots,5_vs_5
2666,4,4,m_sp_arch_4x1_bt_32_roles_r500_m335,0,easy_bots,5_vs_5
2667,1,2,m_sp_arch_4x1_bt_32_roles_r500_m335,1,easy_bots,5_vs_5
2668,-2,0,m_sp_arch_4x1_bt_32_roles_r500_m335,2,medium_bots,5_vs_5_medium
2669,0,2,m_sp_arch_4x1_bt_32_roles_r500_m335,2,medium_bots,5_vs_5_medium
2670,3,3,m_sp_arch_4x1_bt_32_roles_r500_m335,0,medium_bots,5_vs_5_medium
2671,1,3,m_sp_arch_4x1_bt_32_roles_r500_m335,2,medium_bots,5_vs_5_medium
2672,1,3,m_sp_arch_4x1_bt_32_roles_r500_m335,2,medium_bots,5_vs_5_medium
2673,3,4,m_sp_arch_4x1_bt_32_roles_r500_m335,1,medium_bots,5_vs_5_medium
2674,2,2,m_sp_arch_4x1_bt_32_roles_r500_m335,0,hard_bots,5_vs_5_hard
2675,0,1,m_sp_arch_4x1_bt_32_roles_r500_m335,1,hard_bots,5_vs_5_hard
2676,0,0,m_sp_arch_4x1_bt_32_roles_r500_m335,0,hard_bots,5_vs_5_hard
2677,2,2,m_sp_arch_4x1_bt_32_roles_r500_m335,0,hard_bots,5_vs_5_hard
2678,0,1,m_sp_arch_4x1_bt_32_roles_r500_m335,1,hard_bots,5_vs_5_hard
2679,0,0,m_sp_arch_4x1_bt_32_roles_r500_m335,0,hard_bots,5_vs_5_hard
2680,16,18,m_sp_arch_4x1_bt_32_roles_r500_m335,2,f5v0to1to2t05_e2_ckpt291,5_vs_5
2681,9,9,m_sp_arch_4x1_bt_32_roles_r500_m335,0,f5v0to1to2t05_e2_ckpt291,5_vs_5
2682,7,9,m_sp_arch_4x1_bt_32_roles_r500_m335,2,f5v0to1to2t05_e2_ckpt291,5_vs_5
2683,11,11,m_sp_arch_4x1_bt_32_roles_r500_m335,0,f5v0to1to5_e2_ckpt252,5_vs_5
2684,12,13,m_sp_arch_4x1_bt_32_roles_r500_m335,1,f5v0to1to5_e2_ckpt252,5_vs_5
2685,11,13,m_sp_arch_4x1_bt_32_roles_r500_m335,2,f5v0to1to5_e2_ckpt252,5_vs_5
2686,16,17,m_sp_arch_4x1_bt_32_roles_r500_m335,1,scon_e3_p2_hard_ckpt840,5_vs_5
2687,9,10,m_sp_arch_4x1_bt_32_roles_r500_m335,1,scon_e3_p2_hard_ckpt840,5_vs_5
2688,14,17,m_sp_arch_4x1_bt_32_roles_r500_m335,3,scon_e3_p2_hard_ckpt840,5_vs_5
2689,12,12,m_sp_arch_4x1_bt_32_roles_r500_m335,0,less_then_partially_randomized_checkpoints_bots_4_heads_38_ckpt108,5_vs_5
2690,13,13,m_sp_arch_4x1_bt_32_roles_r500_m335,0,less_then_partially_randomized_checkpoints_bots_4_heads_38_ckpt108,5_vs_5
2691,11,12,m_sp_arch_4x1_bt_32_roles_r500_m335,1,less_then_partially_randomized_checkpoints_bots_4_heads_38_ckpt108,5_vs_5
2692,8,9,m_sp_arch_4x1_bt_32_roles_r500_m335,1,less_then_partially_randomized_entropy_checkpoints_bots_4_heads_39_ckpt109,5_vs_5
2693,8,8,m_sp_arch_4x1_bt_32_roles_r500_m335,0,less_then_partially_randomized_entropy_checkpoints_bots_4_heads_39_ckpt109,5_vs_5
2694,11,11,m_sp_arch_4x1_bt_32_roles_r500_m335,0,less_then_partially_randomized_entropy_checkpoints_bots_4_heads_39_ckpt109,5_vs_5
2695,14,14,m_sp_arch_4x1_bt_32_roles_r500_m335,0,reward_shaping_checkpoints_bots_4_heads_1_ckpt360,5_vs_5
2696,8,8,m_sp_arch_4x1_bt_32_roles_r500_m335,0,reward_shaping_checkpoints_bots_4_heads_1_ckpt360,5_vs_5
2697,12,12,m_sp_arch_4x1_bt_32_roles_r500_m335,0,reward_shaping_checkpoints_bots_4_heads_1_ckpt360,5_vs_5
2698,6,7,m_sp_arch_4x1_bt_32_roles_r500_m335,1,checkpoints_selfplay_e9_sp_ckpt274,5_vs_5
2699,5,5,m_sp_arch_4x1_bt_32_roles_r500_m335,0,checkpoints_selfplay_e9_sp_ckpt274,5_vs_5
2700,7,7,m_sp_arch_4x1_bt_32_roles_r500_m335,0,checkpoints_selfplay_e9_sp_ckpt274,5_vs_5
2701,-2,3,m_sp_arch_4x1_bt_32_roles_r500_m335,5,checkpoints_sp_c_nb_e2_ckpt667,5_vs_5
2702,1,5,m_sp_arch_4x1_bt_32_roles_r500_m335,4,checkpoints_sp_c_nb_e2_ckpt667,5_vs_5
2703,1,2,m_sp_arch_4x1_bt_32_roles_r500_m335,1,checkpoints_sp_c_nb_e2_ckpt667,5_vs_5
2704,9,11,m_sp_arch_4x1_bt_32_roles_r500_m335,2,m_sp_arch_medium_heads_conv16_0_bt_32_r313_m335,5_vs_5
2705,6,7,m_sp_arch_4x1_bt_32_roles_r500_m335,1,m_sp_arch_medium_heads_conv16_0_bt_32_r313_m335,5_vs_5
2706,5,6,m_sp_arch_4x1_bt_32_roles_r500_m335,1,m_sp_arch_medium_heads_conv16_0_bt_32_r313_m335,5_vs_5
2707,8,9,m_sp_arch_4x1_bt_32_roles_r500_m335,1,m_sp_arch_longer_heads_bt_32_r201_m335,5_vs_5
2708,5,5,m_sp_arch_4x1_bt_32_roles_r500_m335,0,m_sp_arch_longer_heads_bt_32_r201_m335,5_vs_5
2709,3,6,m_sp_arch_4x1_bt_32_roles_r500_m335,3,m_sp_arch_longer_heads_bt_32_r201_m335,5_vs_5
2710,5,6,m_sp_arch_4x1_bt_32_roles_r500_m335,1,m_sp_arch_medium_heads_bt_32_r201_m335,5_vs_5
2711,3,3,m_sp_arch_4x1_bt_32_roles_r500_m335,0,m_sp_arch_medium_heads_bt_32_r201_m335,5_vs_5
2712,11,11,m_sp_arch_4x1_bt_32_roles_r500_m335,0,m_sp_arch_medium_heads_bt_32_r201_m335,5_vs_5
2713,-3,0,m_sp_arch_4x1_bt_32_roles_r500_m335,3,m_sp_arch_4x1_bt_32_r201_m335,5_vs_5
2714,2,3,m_sp_arch_4x1_bt_32_roles_r500_m335,1,m_sp_arch_4x1_bt_32_r201_m335,5_vs_5
2715,1,2,m_sp_arch_4x1_bt_32_roles_r500_m335,1,m_sp_arch_4x1_bt_32_r201_m335,5_vs_5
2716,-1,0,m_sp_arch_4x1_bt_32_roles_r500_m335,1,m_sp_arch_4x1_bt_32_r201_cont3_m650,5_vs_5
2717,-3,1,m_sp_arch_4x1_bt_32_roles_r500_m335,4,m_sp_arch_4x1_bt_32_r201_cont3_m650,5_vs_5
2718,-1,2,m_sp_arch_4x1_bt_32_roles_r500_m335,3,m_sp_arch_4x1_bt_32_r201_cont3_m650,5_vs_5
2719,1,2,m_sp_arch_4x1_bt_32_roles_r500_m335,1,explt_v0_7_2_m54,5_vs_5
2720,2,3,m_sp_arch_4x1_bt_32_roles_r500_m335,1,explt_v0_7_2_m54,5_vs_5
2721,1,1,m_sp_arch_4x1_bt_32_roles_r500_m335,0,explt_v0_7_2_m54,5_vs_5
2722,6,7,m_sp_arch_4x1_bt_32_roles_r500_m335,1,m_sp_sc3v3_arch_2x1_32_r500_cont4x1_m224,5_vs_5
2723,5,6,m_sp_arch_4x1_bt_32_roles_r500_m335,1,m_sp_sc3v3_arch_2x1_32_r500_cont4x1_m224,5_vs_5
2724,3,5,m_sp_arch_4x1_bt_32_roles_r500_m335,2,m_sp_sc3v3_arch_2x1_32_r500_cont4x1_m224,5_vs_5
2725,0,1,m_sp_arch_4x1_bt_32_roles_r500_m335,1,m_sp_arch_4x1_bt_32_roles_r500_m335,5_vs_5
2726,2,5,m_sp_arch_4x1_bt_32_roles_r500_m335,3,m_sp_arch_4x1_bt_32_roles_r500_m335,5_vs_5
2727,-3,1,m_sp_arch_4x1_bt_32_roles_r500_m335,4,m_sp_arch_4x1_bt_32_roles_r500_m335,5_vs_5
2728,9,9,f5v0to1to5_e2_ckpt252,0,easy_bots,5_vs_5
2729,4,6,f5v0to1to5_e2_ckpt252,2,easy_bots,5_vs_5
2730,6,7,f5v0to1to5_e2_ckpt252,1,easy_bots,5_vs_5
2731,8,11,f5v0to1to5_e2_ckpt252,3,easy_bots,5_vs_5
2732,6,7,f5v0to1to5_e2_ckpt252,1,easy_bots,5_vs_5
2733,10,11,f5v0to1to5_e2_ckpt252,1,easy_bots,5_vs_5
2734,9,10,f5v0to1to5_e2_ckpt252,1,easy_bots,5_vs_5
2735,11,11,f5v0to1to5_e2_ckpt252,0,easy_bots,5_vs_5
2736,13,14,f5v0to1to5_e2_ckpt252,1,easy_bots,5_vs_5
2737,1,3,f5v0to1to5_e2_ckpt252,2,easy_bots,5_vs_5
2738,7,9,f5v0to1to5_e2_ckpt252,2,medium_bots,5_vs_5_medium
2739,5,6,f5v0to1to5_e2_ckpt252,1,medium_bots,5_vs_5_medium
2740,7,7,f5v0to1to5_e2_ckpt252,0,medium_bots,5_vs_5_medium
2741,3,5,f5v0to1to5_e2_ckpt252,2,medium_bots,5_vs_5_medium
2742,8,10,f5v0to1to5_e2_ckpt252,2,medium_bots,5_vs_5_medium
2743,8,8,f5v0to1to5_e2_ckpt252,0,medium_bots,5_vs_5_medium
2744,5,5,f5v0to1to5_e2_ckpt252,0,medium_bots,5_vs_5_medium
2745,2,5,f5v0to1to5_e2_ckpt252,3,medium_bots,5_vs_5_medium
2746,8,9,f5v0to1to5_e2_ckpt252,1,medium_bots,5_vs_5_medium
2747,3,4,f5v0to1to5_e2_ckpt252,1,medium_bots,5_vs_5_medium
2748,8,9,f5v0to1to5_e2_ckpt252,1,hard_bots,5_vs_5_hard
2749,5,6,f5v0to1to5_e2_ckpt252,1,hard_bots,5_vs_5_hard
2750,3,4,f5v0to1to5_e2_ckpt252,1,hard_bots,5_vs_5_hard
2751,4,6,f5v0to1to5_e2_ckpt252,2,hard_bots,5_vs_5_hard
2752,3,5,f5v0to1to5_e2_ckpt252,2,hard_bots,5_vs_5_hard
2753,2,4,f5v0to1to5_e2_ckpt252,2,hard_bots,5_vs_5_hard
2754,9,9,f5v0to1to5_e2_ckpt252,0,hard_bots,5_vs_5_hard
2755,8,8,f5v0to1to5_e2_ckpt252,0,hard_bots,5_vs_5_hard
2756,10,11,f5v0to1to5_e2_ckpt252,1,hard_bots,5_vs_5_hard
2757,6,7,f5v0to1to5_e2_ckpt252,1,hard_bots,5_vs_5_hard
2758,1,4,f5v0to1to5_e2_ckpt252,3,f5v0to1to2t05_e2_ckpt291,5_vs_5
2759,1,4,f5v0to1to5_e2_ckpt252,3,f5v0to1to2t05_e2_ckpt291,5_vs_5
2760,1,7,f5v0to1to5_e2_ckpt252,6,f5v0to1to2t05_e2_ckpt291,5_vs_5
2761,-2,0,f5v0to1to5_e2_ckpt252,2,f5v0to1to2t05_e2_ckpt291,5_vs_5
2762,2,5,f5v0to1to5_e2_ckpt252,3,f5v0to1to2t05_e2_ckpt291,5_vs_5
2763,-3,1,f5v0to1to5_e2_ckpt252,4,f5v0to1to5_e2_ckpt252,5_vs_5
2764,3,6,f5v0to1to5_e2_ckpt252,3,f5v0to1to5_e2_ckpt252,5_vs_5
2765,-1,4,f5v0to1to5_e2_ckpt252,5,f5v0to1to5_e2_ckpt252,5_vs_5
2766,0,3,f5v0to1to5_e2_ckpt252,3,f5v0to1to5_e2_ckpt252,5_vs_5
2767,1,4,f5v0to1to5_e2_ckpt252,3,f5v0to1to5_e2_ckpt252,5_vs_5
2768,1,4,f5v0to1to5_e2_ckpt252,3,scon_e3_p2_hard_ckpt840,5_vs_5
2769,2,2,f5v0to1to5_e2_ckpt252,0,scon_e3_p2_hard_ckpt840,5_vs_5
2770,1,3,f5v0to1to5_e2_ckpt252,2,scon_e3_p2_hard_ckpt840,5_vs_5
2771,2,5,f5v0to1to5_e2_ckpt252,3,scon_e3_p2_hard_ckpt840,5_vs_5
2772,1,3,f5v0to1to5_e2_ckpt252,2,scon_e3_p2_hard_ckpt840,5_vs_5
2773,1,5,f5v0to1to5_e2_ckpt252,4,less_then_partially_randomized_checkpoints_bots_4_heads_38_ckpt108,5_vs_5
2774,-2,2,f5v0to1to5_e2_ckpt252,4,less_then_partially_randomized_checkpoints_bots_4_heads_38_ckpt108,5_vs_5
2775,3,6,f5v0to1to5_e2_ckpt252,3,less_then_partially_randomized_checkpoints_bots_4_heads_38_ckpt108,5_vs_5
2776,-2,2,f5v0to1to5_e2_ckpt252,4,less_then_partially_randomized_checkpoints_bots_4_heads_38_ckpt108,5_vs_5
2777,1,5,f5v0to1to5_e2_ckpt252,4,less_then_partially_randomized_checkpoints_bots_4_heads_38_ckpt108,5_vs_5
2778,4,6,f5v0to1to5_e2_ckpt252,2,less_then_partially_randomized_entropy_checkpoints_bots_4_heads_39_ckpt109,5_vs_5
2779,-1,4,f5v0to1to5_e2_ckpt252,5,less_then_partially_randomized_entropy_checkpoints_bots_4_heads_39_ckpt109,5_vs_5
2780,3,4,f5v0to1to5_e2_ckpt252,1,less_then_partially_randomized_entropy_checkpoints_bots_4_heads_39_ckpt109,5_vs_5
2781,-7,2,f5v0to1to5_e2_ckpt252,9,less_then_partially_randomized_entropy_checkpoints_bots_4_heads_39_ckpt109,5_vs_5
2782,-2,1,f5v0to1to5_e2_ckpt252,3,less_then_partially_randomized_entropy_checkpoints_bots_4_heads_39_ckpt109,5_vs_5
2783,2,5,f5v0to1to5_e2_ckpt252,3,reward_shaping_checkpoints_bots_4_heads_1_ckpt360,5_vs_5
2784,2,7,f5v0to1to5_e2_ckpt252,5,reward_shaping_checkpoints_bots_4_heads_1_ckpt360,5_vs_5
2785,2,3,f5v0to1to5_e2_ckpt252,1,reward_shaping_checkpoints_bots_4_heads_1_ckpt360,5_vs_5
2786,1,3,f5v0to1to5_e2_ckpt252,2,reward_shaping_checkpoints_bots_4_heads_1_ckpt360,5_vs_5
2787,2,3,f5v0to1to5_e2_ckpt252,1,reward_shaping_checkpoints_bots_4_heads_1_ckpt360,5_vs_5
2788,-4,5,f5v0to1to5_e2_ckpt252,9,checkpoints_selfplay_e9_sp_ckpt274,5_vs_5
2789,-4,1,f5v0to1to5_e2_ckpt252,5,checkpoints_selfplay_e9_sp_ckpt274,5_vs_5
2790,-3,2,f5v0to1to5_e2_ckpt252,5,checkpoints_selfplay_e9_sp_ckpt274,5_vs_5
2791,-5,3,f5v0to1to5_e2_ckpt252,8,checkpoints_selfplay_e9_sp_ckpt274,5_vs_5
2792,-1,3,f5v0to1to5_e2_ckpt252,4,checkpoints_selfplay_e9_sp_ckpt274,5_vs_5
2793,-5,1,f5v0to1to5_e2_ckpt252,6,checkpoints_sp_c_nb_e2_ckpt667,5_vs_5
2794,-6,1,f5v0to1to5_e2_ckpt252,7,checkpoints_sp_c_nb_e2_ckpt667,5_vs_5
2795,-5,0,f5v0to1to5_e2_ckpt252,5,checkpoints_sp_c_nb_e2_ckpt667,5_vs_5
2796,-6,1,f5v0to1to5_e2_ckpt252,7,checkpoints_sp_c_nb_e2_ckpt667,5_vs_5
2797,-9,1,f5v0to1to5_e2_ckpt252,10,checkpoints_sp_c_nb_e2_ckpt667,5_vs_5
2798,-3,1,f5v0to1to5_e2_ckpt252,4,m_sp_arch_medium_heads_conv16_0_bt_32_r313_m335,5_vs_5
2799,2,3,f5v0to1to5_e2_ckpt252,1,m_sp_arch_medium_heads_conv16_0_bt_32_r313_m335,5_vs_5
2800,-1,2,f5v0to1to5_e2_ckpt252,3,m_sp_arch_medium_heads_conv16_0_bt_32_r313_m335,5_vs_5
2801,0,2,f5v0to1to5_e2_ckpt252,2,m_sp_arch_medium_heads_conv16_0_bt_32_r313_m335,5_vs_5
2802,-1,0,f5v0to1to5_e2_ckpt252,1,m_sp_arch_medium_heads_conv16_0_bt_32_r313_m335,5_vs_5
2803,-2,0,f5v0to1to5_e2_ckpt252,2,m_sp_arch_longer_heads_bt_32_r201_m335,5_vs_5
2804,0,2,f5v0to1to5_e2_ckpt252,2,m_sp_arch_longer_heads_bt_32_r201_m335,5_vs_5
2805,-2,3,f5v0to1to5_e2_ckpt252,5,m_sp_arch_longer_heads_bt_32_r201_m335,5_vs_5
2806,-2,2,f5v0to1to5_e2_ckpt252,4,m_sp_arch_longer_heads_bt_32_r201_m335,5_vs_5
2807,-3,0,f5v0to1to5_e2_ckpt252,3,m_sp_arch_longer_heads_bt_32_r201_m335,5_vs_5
2808,-7,1,f5v0to1to5_e2_ckpt252,8,m_sp_arch_medium_heads_bt_32_r201_m335,5_vs_5
2809,-5,1,f5v0to1to5_e2_ckpt252,6,m_sp_arch_medium_heads_bt_32_r201_m335,5_vs_5
2810,-1,4,f5v0to1to5_e2_ckpt252,5,m_sp_arch_medium_heads_bt_32_r201_m335,5_vs_5
2811,0,4,f5v0to1to5_e2_ckpt252,4,m_sp_arch_medium_heads_bt_32_r201_m335,5_vs_5
2812,-4,3,f5v0to1to5_e2_ckpt252,7,m_sp_arch_medium_heads_bt_32_r201_m335,5_vs_5
2813,-4,2,f5v0to1to5_e2_ckpt252,6,m_sp_arch_4x1_bt_32_r201_m335,5_vs_5
2814,-10,0,f5v0to1to5_e2_ckpt252,10,m_sp_arch_4x1_bt_32_r201_m335,5_vs_5
2815,-6,0,f5v0to1to5_e2_ckpt252,6,m_sp_arch_4x1_bt_32_r201_m335,5_vs_5
2816,-7,0,f5v0to1to5_e2_ckpt252,7,m_sp_arch_4x1_bt_32_r201_m335,5_vs_5
2817,-5,2,f5v0to1to5_e2_ckpt252,7,m_sp_arch_4x1_bt_32_r201_m335,5_vs_5
2818,-5,2,f5v0to1to5_e2_ckpt252,7,m_sp_arch_4x1_bt_32_r201_cont3_m650,5_vs_5
2819,-5,0,f5v0to1to5_e2_ckpt252,5,m_sp_arch_4x1_bt_32_r201_cont3_m650,5_vs_5
2820,-7,1,f5v0to1to5_e2_ckpt252,8,m_sp_arch_4x1_bt_32_r201_cont3_m650,5_vs_5
2821,-7,0,f5v0to1to5_e2_ckpt252,7,m_sp_arch_4x1_bt_32_r201_cont3_m650,5_vs_5
2822,-6,1,f5v0to1to5_e2_ckpt252,7,m_sp_arch_4x1_bt_32_r201_cont3_m650,5_vs_5
2823,-4,0,f5v0to1to5_e2_ckpt252,4,explt_v0_7_2_m54,5_vs_5
2824,0,1,f5v0to1to5_e2_ckpt252,1,explt_v0_7_2_m54,5_vs_5
2825,-2,1,f5v0to1to5_e2_ckpt252,3,explt_v0_7_2_m54,5_vs_5
2826,0,2,f5v0to1to5_e2_ckpt252,2,explt_v0_7_2_m54,5_vs_5
2827,0,0,f5v0to1to5_e2_ckpt252,0,explt_v0_7_2_m54,5_vs_5
2828,-10,0,f5v0to1to5_e2_ckpt252,10,m_sp_sc3v3_arch_2x1_32_r500_cont4x1_m224,5_vs_5
2829,-7,1,f5v0to1to5_e2_ckpt252,8,m_sp_sc3v3_arch_2x1_32_r500_cont4x1_m224,5_vs_5
2830,-8,1,f5v0to1to5_e2_ckpt252,9,m_sp_sc3v3_arch_2x1_32_r500_cont4x1_m224,5_vs_5
2831,-9,1,f5v0to1to5_e2_ckpt252,10,m_sp_sc3v3_arch_2x1_32_r500_cont4x1_m224,5_vs_5
2832,-15,0,f5v0to1to5_e2_ckpt252,15,m_sp_sc3v3_arch_2x1_32_r500_cont4x1_m224,5_vs_5
2833,-11,0,f5v0to1to5_e2_ckpt252,11,m_sp_arch_4x1_bt_32_roles_r500_m335,5_vs_5
2834,-10,1,f5v0to1to5_e2_ckpt252,11,m_sp_arch_4x1_bt_32_roles_r500_m335,5_vs_5
2835,-14,0,f5v0to1to5_e2_ckpt252,14,m_sp_arch_4x1_bt_32_roles_r500_m335,5_vs_5
2836,-8,0,f5v0to1to5_e2_ckpt252,8,m_sp_arch_4x1_bt_32_roles_r500_m335,5_vs_5
2837,-6,4,f5v0to1to5_e2_ckpt252,10,m_sp_arch_4x1_bt_32_roles_r500_m335,5_vs_5
2838,-1,1,m_sp_arch_medium_heads_bt_32_r201_m335,2,easy_bots,5_vs_5
2839,0,0,m_sp_arch_medium_heads_bt_32_r201_m335,0,easy_bots,5_vs_5
2840,-2,1,m_sp_arch_medium_heads_bt_32_r201_m335,3,easy_bots,5_vs_5
2841,-3,1,m_sp_arch_medium_heads_bt_32_r201_m335,4,easy_bots,5_vs_5
2842,0,2,m_sp_arch_medium_heads_bt_32_r201_m335,2,easy_bots,5_vs_5
2843,1,2,m_sp_arch_medium_heads_bt_32_r201_m335,1,easy_bots,5_vs_5
2844,-2,0,m_sp_arch_medium_heads_bt_32_r201_m335,2,medium_bots,5_vs_5_medium
2845,-1,0,m_sp_arch_medium_heads_bt_32_r201_m335,1,medium_bots,5_vs_5_medium
2846,0,1,m_sp_arch_medium_heads_bt_32_r201_m335,1,medium_bots,5_vs_5_medium
2847,0,0,m_sp_arch_medium_heads_bt_32_r201_m335,0,medium_bots,5_vs_5_medium
2848,-4,0,m_sp_arch_medium_heads_bt_32_r201_m335,4,medium_bots,5_vs_5_medium
2849,-4,2,m_sp_arch_medium_heads_bt_32_r201_m335,6,medium_bots,5_vs_5_medium
2850,-4,0,m_sp_arch_medium_heads_bt_32_r201_m335,4,hard_bots,5_vs_5_hard
2851,-1,0,m_sp_arch_medium_heads_bt_32_r201_m335,1,hard_bots,5_vs_5_hard
2852,-4,1,m_sp_arch_medium_heads_bt_32_r201_m335,5,hard_bots,5_vs_5_hard
2853,-4,0,m_sp_arch_medium_heads_bt_32_r201_m335,4,hard_bots,5_vs_5_hard
2854,-1,1,m_sp_arch_medium_heads_bt_32_r201_m335,2,hard_bots,5_vs_5_hard
2855,-3,0,m_sp_arch_medium_heads_bt_32_r201_m335,3,hard_bots,5_vs_5_hard
2856,10,11,m_sp_arch_medium_heads_bt_32_r201_m335,1,f5v0to1to2t05_e2_ckpt291,5_vs_5
2857,9,9,m_sp_arch_medium_heads_bt_32_r201_m335,0,f5v0to1to2t05_e2_ckpt291,5_vs_5
2858,5,5,m_sp_arch_medium_heads_bt_32_r201_m335,0,f5v0to1to2t05_e2_ckpt291,5_vs_5
2859,2,4,m_sp_arch_medium_heads_bt_32_r201_m335,2,f5v0to1to5_e2_ckpt252,5_vs_5
2860,4,6,m_sp_arch_medium_heads_bt_32_r201_m335,2,f5v0to1to5_e2_ckpt252,5_vs_5
2861,5,7,m_sp_arch_medium_heads_bt_32_r201_m335,2,f5v0to1to5_e2_ckpt252,5_vs_5
2862,9,9,m_sp_arch_medium_heads_bt_32_r201_m335,0,scon_e3_p2_hard_ckpt840,5_vs_5
2863,8,8,m_sp_arch_medium_heads_bt_32_r201_m335,0,scon_e3_p2_hard_ckpt840,5_vs_5
2864,9,9,m_sp_arch_medium_heads_bt_32_r201_m335,0,scon_e3_p2_hard_ckpt840,5_vs_5
2865,7,7,m_sp_arch_medium_heads_bt_32_r201_m335,0,less_then_partially_randomized_checkpoints_bots_4_heads_38_ckpt108,5_vs_5
2866,3,3,m_sp_arch_medium_heads_bt_32_r201_m335,0,less_then_partially_randomized_checkpoints_bots_4_heads_38_ckpt108,5_vs_5
2867,7,8,m_sp_arch_medium_heads_bt_32_r201_m335,1,less_then_partially_randomized_checkpoints_bots_4_heads_38_ckpt108,5_vs_5
2868,6,8,m_sp_arch_medium_heads_bt_32_r201_m335,2,less_then_partially_randomized_entropy_checkpoints_bots_4_heads_39_ckpt109,5_vs_5
2869,4,5,m_sp_arch_medium_heads_bt_32_r201_m335,1,less_then_partially_randomized_entropy_checkpoints_bots_4_heads_39_ckpt109,5_vs_5
2870,1,4,m_sp_arch_medium_heads_bt_32_r201_m335,3,less_then_partially_randomized_entropy_checkpoints_bots_4_heads_39_ckpt109,5_vs_5
2871,8,9,m_sp_arch_medium_heads_bt_32_r201_m335,1,reward_shaping_checkpoints_bots_4_heads_1_ckpt360,5_vs_5
2872,6,7,m_sp_arch_medium_heads_bt_32_r201_m335,1,reward_shaping_checkpoints_bots_4_heads_1_ckpt360,5_vs_5
2873,6,8,m_sp_arch_medium_heads_bt_32_r201_m335,2,reward_shaping_checkpoints_bots_4_heads_1_ckpt360,5_vs_5
2874,-2,3,m_sp_arch_medium_heads_bt_32_r201_m335,5,checkpoints_selfplay_e9_sp_ckpt274,5_vs_5
2875,-6,2,m_sp_arch_medium_heads_bt_32_r201_m335,8,checkpoints_selfplay_e9_sp_ckpt274,5_vs_5
2876,-3,4,m_sp_arch_medium_heads_bt_32_r201_m335,7,checkpoints_selfplay_e9_sp_ckpt274,5_vs_5
2877,-4,1,m_sp_arch_medium_heads_bt_32_r201_m335,5,checkpoints_sp_c_nb_e2_ckpt667,5_vs_5
2878,-6,0,m_sp_arch_medium_heads_bt_32_r201_m335,6,checkpoints_sp_c_nb_e2_ckpt667,5_vs_5
2879,-6,0,m_sp_arch_medium_heads_bt_32_r201_m335,6,checkpoints_sp_c_nb_e2_ckpt667,5_vs_5
2880,-1,1,m_sp_arch_medium_heads_bt_32_r201_m335,2,m_sp_arch_medium_heads_conv16_0_bt_32_r313_m335,5_vs_5
2881,-1,3,m_sp_arch_medium_heads_bt_32_r201_m335,4,m_sp_arch_medium_heads_conv16_0_bt_32_r313_m335,5_vs_5
2882,0,2,m_sp_arch_medium_heads_bt_32_r201_m335,2,m_sp_arch_medium_heads_conv16_0_bt_32_r313_m335,5_vs_5
2883,0,2,m_sp_arch_medium_heads_bt_32_r201_m335,2,m_sp_arch_longer_heads_bt_32_r201_m335,5_vs_5
2884,-2,1,m_sp_arch_medium_heads_bt_32_r201_m335,3,m_sp_arch_longer_heads_bt_32_r201_m335,5_vs_5
2885,-4,0,m_sp_arch_medium_heads_bt_32_r201_m335,4,m_sp_arch_longer_heads_bt_32_r201_m335,5_vs_5
2886,-1,1,m_sp_arch_medium_heads_bt_32_r201_m335,2,m_sp_arch_medium_heads_bt_32_r201_m335,5_vs_5
2887,-2,1,m_sp_arch_medium_heads_bt_32_r201_m335,3,m_sp_arch_medium_heads_bt_32_r201_m335,5_vs_5
2888,0,1,m_sp_arch_medium_heads_bt_32_r201_m335,1,m_sp_arch_medium_heads_bt_32_r201_m335,5_vs_5
2889,-7,2,m_sp_arch_medium_heads_bt_32_r201_m335,9,m_sp_arch_4x1_bt_32_r201_m335,5_vs_5
2890,-6,0,m_sp_arch_medium_heads_bt_32_r201_m335,6,m_sp_arch_4x1_bt_32_r201_m335,5_vs_5
2891,-6,0,m_sp_arch_medium_heads_bt_32_r201_m335,6,m_sp_arch_4x1_bt_32_r201_m335,5_vs_5
2892,-7,0,m_sp_arch_medium_heads_bt_32_r201_m335,7,m_sp_arch_4x1_bt_32_r201_cont3_m650,5_vs_5
2893,-4,0,m_sp_arch_medium_heads_bt_32_r201_m335,4,m_sp_arch_4x1_bt_32_r201_cont3_m650,5_vs_5
2894,-8,1,m_sp_arch_medium_heads_bt_32_r201_m335,9,m_sp_arch_4x1_bt_32_r201_cont3_m650,5_vs_5
2895,-3,0,m_sp_arch_medium_heads_bt_32_r201_m335,3,explt_v0_7_2_m54,5_vs_5
2896,-2,1,m_sp_arch_medium_heads_bt_32_r201_m335,3,explt_v0_7_2_m54,5_vs_5
2897,-4,0,m_sp_arch_medium_heads_bt_32_r201_m335,4,explt_v0_7_2_m54,5_vs_5
2898,-4,3,m_sp_arch_medium_heads_bt_32_r201_m335,7,m_sp_sc3v3_arch_2x1_32_r500_cont4x1_m224,5_vs_5
2899,-6,0,m_sp_arch_medium_heads_bt_32_r201_m335,6,m_sp_sc3v3_arch_2x1_32_r500_cont4x1_m224,5_vs_5
2900,-1,5,m_sp_arch_medium_heads_bt_32_r201_m335,6,m_sp_sc3v3_arch_2x1_32_r500_cont4x1_m224,5_vs_5
2901,-9,0,m_sp_arch_medium_heads_bt_32_r201_m335,9,m_sp_arch_4x1_bt_32_roles_r500_m335,5_vs_5
2902,-2,1,m_sp_arch_medium_heads_bt_32_r201_m335,3,m_sp_arch_4x1_bt_32_roles_r500_m335,5_vs_5
2903,-8,0,m_sp_arch_medium_heads_bt_32_r201_m335,8,m_sp_arch_4x1_bt_32_roles_r500_m335,5_vs_5
2904,4,4,m_sp_arch_4x1_bt_32_r201_m335,0,easy_bots,5_vs_5
2905,0,0,m_sp_arch_4x1_bt_32_r201_m335,0,easy_bots,5_vs_5
2906,3,3,m_sp_arch_4x1_bt_32_r201_m335,0,easy_bots,5_vs_5
2907,2,2,m_sp_arch_4x1_bt_32_r201_m335,0,easy_bots,5_vs_5
2908,1,3,m_sp_arch_4x1_bt_32_r201_m335,2,easy_bots,5_vs_5
2909,1,3,m_sp_arch_4x1_bt_32_r201_m335,2,easy_bots,5_vs_5
2910,1,1,m_sp_arch_4x1_bt_32_r201_m335,0,medium_bots,5_vs_5_medium
2911,1,1,m_sp_arch_4x1_bt_32_r201_m335,0,medium_bots,5_vs_5_medium
2912,1,1,m_sp_arch_4x1_bt_32_r201_m335,0,medium_bots,5_vs_5_medium
2913,1,2,m_sp_arch_4x1_bt_32_r201_m335,1,medium_bots,5_vs_5_medium
2914,1,2,m_sp_arch_4x1_bt_32_r201_m335,1,medium_bots,5_vs_5_medium
2915,-1,1,m_sp_arch_4x1_bt_32_r201_m335,2,medium_bots,5_vs_5_medium
2916,1,1,m_sp_arch_4x1_bt_32_r201_m335,0,hard_bots,5_vs_5_hard
2917,0,0,m_sp_arch_4x1_bt_32_r201_m335,0,hard_bots,5_vs_5_hard
2918,-1,1,m_sp_arch_4x1_bt_32_r201_m335,2,hard_bots,5_vs_5_hard
2919,0,0,m_sp_arch_4x1_bt_32_r201_m335,0,hard_bots,5_vs_5_hard
2920,-2,0,m_sp_arch_4x1_bt_32_r201_m335,2,hard_bots,5_vs_5_hard
2921,-2,0,m_sp_arch_4x1_bt_32_r201_m335,2,hard_bots,5_vs_5_hard
2922,11,12,m_sp_arch_4x1_bt_32_r201_m335,1,f5v0to1to2t05_e2_ckpt291,5_vs_5
2923,9,10,m_sp_arch_4x1_bt_32_r201_m335,1,f5v0to1to2t05_e2_ckpt291,5_vs_5
2924,10,10,m_sp_arch_4x1_bt_32_r201_m335,0,f5v0to1to2t05_e2_ckpt291,5_vs_5
2925,8,8,m_sp_arch_4x1_bt_32_r201_m335,0,f5v0to1to5_e2_ckpt252,5_vs_5
2926,5,5,m_sp_arch_4x1_bt_32_r201_m335,0,f5v0to1to5_e2_ckpt252,5_vs_5
2927,6,7,m_sp_arch_4x1_bt_32_r201_m335,1,f5v0to1to5_e2_ckpt252,5_vs_5
2928,10,10,m_sp_arch_4x1_bt_32_r201_m335,0,scon_e3_p2_hard_ckpt840,5_vs_5
2929,6,6,m_sp_arch_4x1_bt_32_r201_m335,0,scon_e3_p2_hard_ckpt840,5_vs_5
2930,11,11,m_sp_arch_4x1_bt_32_r201_m335,0,scon_e3_p2_hard_ckpt840,5_vs_5
2931,13,13,m_sp_arch_4x1_bt_32_r201_m335,0,less_then_partially_randomized_checkpoints_bots_4_heads_38_ckpt108,5_vs_5
2932,11,11,m_sp_arch_4x1_bt_32_r201_m335,0,less_then_partially_randomized_checkpoints_bots_4_heads_38_ckpt108,5_vs_5
2933,17,17,m_sp_arch_4x1_bt_32_r201_m335,0,less_then_partially_randomized_checkpoints_bots_4_heads_38_ckpt108,5_vs_5
2934,12,12,m_sp_arch_4x1_bt_32_r201_m335,0,less_then_partially_randomized_entropy_checkpoints_bots_4_heads_39_ckpt109,5_vs_5
2935,11,11,m_sp_arch_4x1_bt_32_r201_m335,0,less_then_partially_randomized_entropy_checkpoints_bots_4_heads_39_ckpt109,5_vs_5
2936,8,8,m_sp_arch_4x1_bt_32_r201_m335,0,less_then_partially_randomized_entropy_checkpoints_bots_4_heads_39_ckpt109,5_vs_5
2937,11,11,m_sp_arch_4x1_bt_32_r201_m335,0,reward_shaping_checkpoints_bots_4_heads_1_ckpt360,5_vs_5
2938,9,9,m_sp_arch_4x1_bt_32_r201_m335,0,reward_shaping_checkpoints_bots_4_heads_1_ckpt360,5_vs_5
2939,12,12,m_sp_arch_4x1_bt_32_r201_m335,0,reward_shaping_checkpoints_bots_4_heads_1_ckpt360,5_vs_5
2940,10,11,m_sp_arch_4x1_bt_32_r201_m335,1,checkpoints_selfplay_e9_sp_ckpt274,5_vs_5
2941,6,6,m_sp_arch_4x1_bt_32_r201_m335,0,checkpoints_selfplay_e9_sp_ckpt274,5_vs_5
2942,5,5,m_sp_arch_4x1_bt_32_r201_m335,0,checkpoints_selfplay_e9_sp_ckpt274,5_vs_5
2943,-1,3,m_sp_arch_4x1_bt_32_r201_m335,4,checkpoints_sp_c_nb_e2_ckpt667,5_vs_5
2944,-1,1,m_sp_arch_4x1_bt_32_r201_m335,2,checkpoints_sp_c_nb_e2_ckpt667,5_vs_5
2945,3,5,m_sp_arch_4x1_bt_32_r201_m335,2,checkpoints_sp_c_nb_e2_ckpt667,5_vs_5
2946,6,7,m_sp_arch_4x1_bt_32_r201_m335,1,m_sp_arch_medium_heads_conv16_0_bt_32_r313_m335,5_vs_5
2947,6,7,m_sp_arch_4x1_bt_32_r201_m335,1,m_sp_arch_medium_heads_conv16_0_bt_32_r313_m335,5_vs_5
2948,3,6,m_sp_arch_4x1_bt_32_r201_m335,3,m_sp_arch_medium_heads_conv16_0_bt_32_r313_m335,5_vs_5
2949,3,4,m_sp_arch_4x1_bt_32_r201_m335,1,m_sp_arch_longer_heads_bt_32_r201_m335,5_vs_5
2950,7,7,m_sp_arch_4x1_bt_32_r201_m335,0,m_sp_arch_longer_heads_bt_32_r201_m335,5_vs_5
2951,5,5,m_sp_arch_4x1_bt_32_r201_m335,0,m_sp_arch_longer_heads_bt_32_r201_m335,5_vs_5
2952,5,5,m_sp_arch_4x1_bt_32_r201_m335,0,m_sp_arch_medium_heads_bt_32_r201_m335,5_vs_5
2953,6,6,m_sp_arch_4x1_bt_32_r201_m335,0,m_sp_arch_medium_heads_bt_32_r201_m335,5_vs_5
2954,6,6,m_sp_arch_4x1_bt_32_r201_m335,0,m_sp_arch_medium_heads_bt_32_r201_m335,5_vs_5
2955,-1,0,m_sp_arch_4x1_bt_32_r201_m335,1,m_sp_arch_4x1_bt_32_r201_m335,5_vs_5
2956,2,2,m_sp_arch_4x1_bt_32_r201_m335,0,m_sp_arch_4x1_bt_32_r201_m335,5_vs_5
2957,0,1,m_sp_arch_4x1_bt_32_r201_m335,1,m_sp_arch_4x1_bt_32_r201_m335,5_vs_5
2958,2,2,m_sp_arch_4x1_bt_32_r201_m335,0,m_sp_arch_4x1_bt_32_r201_cont3_m650,5_vs_5
2959,0,1,m_sp_arch_4x1_bt_32_r201_m335,1,m_sp_arch_4x1_bt_32_r201_cont3_m650,5_vs_5
2960,0,0,m_sp_arch_4x1_bt_32_r201_m335,0,m_sp_arch_4x1_bt_32_r201_cont3_m650,5_vs_5
2961,3,3,m_sp_arch_4x1_bt_32_r201_m335,0,explt_v0_7_2_m54,5_vs_5
2962,-1,1,m_sp_arch_4x1_bt_32_r201_m335,2,explt_v0_7_2_m54,5_vs_5
2963,0,2,m_sp_arch_4x1_bt_32_r201_m335,2,explt_v0_7_2_m54,5_vs_5
2964,7,8,m_sp_arch_4x1_bt_32_r201_m335,1,m_sp_sc3v3_arch_2x1_32_r500_cont4x1_m224,5_vs_5
2965,-1,3,m_sp_arch_4x1_bt_32_r201_m335,4,m_sp_sc3v3_arch_2x1_32_r500_cont4x1_m224,5_vs_5
2966,-1,5,m_sp_arch_4x1_bt_32_r201_m335,6,m_sp_sc3v3_arch_2x1_32_r500_cont4x1_m224,5_vs_5
2967,1,2,m_sp_arch_4x1_bt_32_r201_m335,1,m_sp_arch_4x1_bt_32_roles_r500_m335,5_vs_5
2968,-2,1,m_sp_arch_4x1_bt_32_r201_m335,3,m_sp_arch_4x1_bt_32_roles_r500_m335,5_vs_5
2969,-2,1,m_sp_arch_4x1_bt_32_r201_m335,3,m_sp_arch_4x1_bt_32_roles_r500_m335,5_vs_5
2970,9,9,less_then_partially_randomized_entropy_checkpoints_bots_4_heads_39_ckpt109,0,easy_bots,5_vs_5
2971,8,9,less_then_partially_randomized_entropy_checkpoints_bots_4_heads_39_ckpt109,1,easy_bots,5_vs_5
2972,8,9,less_then_partially_randomized_entropy_checkpoints_bots_4_heads_39_ckpt109,1,easy_bots,5_vs_5
2973,14,15,less_then_partially_randomized_entropy_checkpoints_bots_4_heads_39_ckpt109,1,easy_bots,5_vs_5
2974,4,7,less_then_partially_randomized_entropy_checkpoints_bots_4_heads_39_ckpt109,3,easy_bots,5_vs_5
2975,11,12,less_then_partially_randomized_entropy_checkpoints_bots_4_heads_39_ckpt109,1,easy_bots,5_vs_5
2976,8,10,less_then_partially_randomized_entropy_checkpoints_bots_4_heads_39_ckpt109,2,easy_bots,5_vs_5
2977,10,11,less_then_partially_randomized_entropy_checkpoints_bots_4_heads_39_ckpt109,1,easy_bots,5_vs_5
2978,6,8,less_then_partially_randomized_entropy_checkpoints_bots_4_heads_39_ckpt109,2,easy_bots,5_vs_5
2979,11,11,less_then_partially_randomized_entropy_checkpoints_bots_4_heads_39_ckpt109,0,easy_bots,5_vs_5
2980,10,10,less_then_partially_randomized_entropy_checkpoints_bots_4_heads_39_ckpt109,0,medium_bots,5_vs_5_medium
2981,2,6,less_then_partially_randomized_entropy_checkpoints_bots_4_heads_39_ckpt109,4,medium_bots,5_vs_5_medium
2982,4,5,less_then_partially_randomized_entropy_checkpoints_bots_4_heads_39_ckpt109,1,medium_bots,5_vs_5_medium
2983,8,10,less_then_partially_randomized_entropy_checkpoints_bots_4_heads_39_ckpt109,2,medium_bots,5_vs_5_medium
2984,6,6,less_then_partially_randomized_entropy_checkpoints_bots_4_heads_39_ckpt109,0,medium_bots,5_vs_5_medium
2985,11,11,less_then_partially_randomized_entropy_checkpoints_bots_4_heads_39_ckpt109,0,medium_bots,5_vs_5_medium
2986,3,6,less_then_partially_randomized_entropy_checkpoints_bots_4_heads_39_ckpt109,3,medium_bots,5_vs_5_medium
2987,2,4,less_then_partially_randomized_entropy_checkpoints_bots_4_heads_39_ckpt109,2,medium_bots,5_vs_5_medium
2988,14,14,less_then_partially_randomized_entropy_checkpoints_bots_4_heads_39_ckpt109,0,medium_bots,5_vs_5_medium
2989,6,7,less_then_partially_randomized_entropy_checkpoints_bots_4_heads_39_ckpt109,1,medium_bots,5_vs_5_medium
2990,1,5,less_then_partially_randomized_entropy_checkpoints_bots_4_heads_39_ckpt109,4,hard_bots,5_vs_5_hard
2991,8,9,less_then_partially_randomized_entropy_checkpoints_bots_4_heads_39_ckpt109,1,hard_bots,5_vs_5_hard
2992,3,5,less_then_partially_randomized_entropy_checkpoints_bots_4_heads_39_ckpt109,2,hard_bots,5_vs_5_hard
2993,8,8,less_then_partially_randomized_entropy_checkpoints_bots_4_heads_39_ckpt109,0,hard_bots,5_vs_5_hard
2994,3,4,less_then_partially_randomized_entropy_checkpoints_bots_4_heads_39_ckpt109,1,hard_bots,5_vs_5_hard
2995,7,8,less_then_partially_randomized_entropy_checkpoints_bots_4_heads_39_ckpt109,1,hard_bots,5_vs_5_hard
2996,7,7,less_then_partially_randomized_entropy_checkpoints_bots_4_heads_39_ckpt109,0,hard_bots,5_vs_5_hard
2997,3,6,less_then_partially_randomized_entropy_checkpoints_bots_4_heads_39_ckpt109,3,hard_bots,5_vs_5_hard
2998,7,9,less_then_partially_randomized_entropy_checkpoints_bots_4_heads_39_ckpt109,2,hard_bots,5_vs_5_hard
2999,4,5,less_then_partially_randomized_entropy_checkpoints_bots_4_heads_39_ckpt109,1,hard_bots,5_vs_5_hard
3000,-1,2,less_then_partially_randomized_entropy_checkpoints_bots_4_heads_39_ckpt109,3,f5v0to1to2t05_e2_ckpt291,5_vs_5
3001,2,6,less_then_partially_randomized_entropy_checkpoints_bots_4_heads_39_ckpt109,4,f5v0to1to2t05_e2_ckpt291,5_vs_5
3002,7,9,less_then_partially_randomized_entropy_checkpoints_bots_4_heads_39_ckpt109,2,f5v0to1to2t05_e2_ckpt291,5_vs_5
3003,-5,1,less_then_partially_randomized_entropy_checkpoints_bots_4_heads_39_ckpt109,6,f5v0to1to2t05_e2_ckpt291,5_vs_5
3004,1,5,less_then_partially_randomized_entropy_checkpoints_bots_4_heads_39_ckpt109,4,f5v0to1to2t05_e2_ckpt291,5_vs_5
3005,0,3,less_then_partially_randomized_entropy_checkpoints_bots_4_heads_39_ckpt109,3,f5v0to1to5_e2_ckpt252,5_vs_5
3006,3,7,less_then_partially_randomized_entropy_checkpoints_bots_4_heads_39_ckpt109,4,f5v0to1to5_e2_ckpt252,5_vs_5
3007,2,5,less_then_partially_randomized_entropy_checkpoints_bots_4_heads_39_ckpt109,3,f5v0to1to5_e2_ckpt252,5_vs_5
3008,-4,1,less_then_partially_randomized_entropy_checkpoints_bots_4_heads_39_ckpt109,5,f5v0to1to5_e2_ckpt252,5_vs_5
3009,0,5,less_then_partially_randomized_entropy_checkpoints_bots_4_heads_39_ckpt109,5,f5v0to1to5_e2_ckpt252,5_vs_5
3010,0,3,less_then_partially_randomized_entropy_checkpoints_bots_4_heads_39_ckpt109,3,scon_e3_p2_hard_ckpt840,5_vs_5
3011,-2,1,less_then_partially_randomized_entropy_checkpoints_bots_4_heads_39_ckpt109,3,scon_e3_p2_hard_ckpt840,5_vs_5
3012,-2,2,less_then_partially_randomized_entropy_checkpoints_bots_4_heads_39_ckpt109,4,scon_e3_p2_hard_ckpt840,5_vs_5
3013,2,4,less_then_partially_randomized_entropy_checkpoints_bots_4_heads_39_ckpt109,2,scon_e3_p2_hard_ckpt840,5_vs_5
3014,-3,1,less_then_partially_randomized_entropy_checkpoints_bots_4_heads_39_ckpt109,4,scon_e3_p2_hard_ckpt840,5_vs_5
3015,-5,2,less_then_partially_randomized_entropy_checkpoints_bots_4_heads_39_ckpt109,7,less_then_partially_randomized_checkpoints_bots_4_heads_38_ckpt108,5_vs_5
3016,3,7,less_then_partially_randomized_entropy_checkpoints_bots_4_heads_39_ckpt109,4,less_then_partially_randomized_checkpoints_bots_4_heads_38_ckpt108,5_vs_5
3017,3,6,less_then_partially_randomized_entropy_checkpoints_bots_4_heads_39_ckpt109,3,less_then_partially_randomized_checkpoints_bots_4_heads_38_ckpt108,5_vs_5
3018,-1,3,less_then_partially_randomized_entropy_checkpoints_bots_4_heads_39_ckpt109,4,less_then_partially_randomized_checkpoints_bots_4_heads_38_ckpt108,5_vs_5
3019,4,6,less_then_partially_randomized_entropy_checkpoints_bots_4_heads_39_ckpt109,2,less_then_partially_randomized_checkpoints_bots_4_heads_38_ckpt108,5_vs_5
3020,-3,3,less_then_partially_randomized_entropy_checkpoints_bots_4_heads_39_ckpt109,6,less_then_partially_randomized_entropy_checkpoints_bots_4_heads_39_ckpt109,5_vs_5
3021,-1,3,less_then_partially_randomized_entropy_checkpoints_bots_4_heads_39_ckpt109,4,less_then_partially_randomized_entropy_checkpoints_bots_4_heads_39_ckpt109,5_vs_5
3022,-2,4,less_then_partially_randomized_entropy_checkpoints_bots_4_heads_39_ckpt109,6,less_then_partially_randomized_entropy_checkpoints_bots_4_heads_39_ckpt109,5_vs_5
3023,-5,2,less_then_partially_randomized_entropy_checkpoints_bots_4_heads_39_ckpt109,7,less_then_partially_randomized_entropy_checkpoints_bots_4_heads_39_ckpt109,5_vs_5
3024,-2,2,less_then_partially_randomized_entropy_checkpoints_bots_4_heads_39_ckpt109,4,less_then_partially_randomized_entropy_checkpoints_bots_4_heads_39_ckpt109,5_vs_5
3025,2,4,less_then_partially_randomized_entropy_checkpoints_bots_4_heads_39_ckpt109,2,reward_shaping_checkpoints_bots_4_heads_1_ckpt360,5_vs_5
3026,2,3,less_then_partially_randomized_entropy_checkpoints_bots_4_heads_39_ckpt109,1,reward_shaping_checkpoints_bots_4_heads_1_ckpt360,5_vs_5
3027,3,5,less_then_partially_randomized_entropy_checkpoints_bots_4_heads_39_ckpt109,2,reward_shaping_checkpoints_bots_4_heads_1_ckpt360,5_vs_5
3028,4,4,less_then_partially_randomized_entropy_checkpoints_bots_4_heads_39_ckpt109,0,reward_shaping_checkpoints_bots_4_heads_1_ckpt360,5_vs_5
3029,4,7,less_then_partially_randomized_entropy_checkpoints_bots_4_heads_39_ckpt109,3,reward_shaping_checkpoints_bots_4_heads_1_ckpt360,5_vs_5
3030,-8,2,less_then_partially_randomized_entropy_checkpoints_bots_4_heads_39_ckpt109,10,checkpoints_selfplay_e9_sp_ckpt274,5_vs_5
3031,-8,1,less_then_partially_randomized_entropy_checkpoints_bots_4_heads_39_ckpt109,9,checkpoints_selfplay_e9_sp_ckpt274,5_vs_5
3032,-6,0,less_then_partially_randomized_entropy_checkpoints_bots_4_heads_39_ckpt109,6,checkpoints_selfplay_e9_sp_ckpt274,5_vs_5
3033,-6,2,less_then_partially_randomized_entropy_checkpoints_bots_4_heads_39_ckpt109,8,checkpoints_selfplay_e9_sp_ckpt274,5_vs_5
3034,-4,4,less_then_partially_randomized_entropy_checkpoints_bots_4_heads_39_ckpt109,8,checkpoints_selfplay_e9_sp_ckpt274,5_vs_5
3035,-10,0,less_then_partially_randomized_entropy_checkpoints_bots_4_heads_39_ckpt109,10,checkpoints_sp_c_nb_e2_ckpt667,5_vs_5
3036,-9,1,less_then_partially_randomized_entropy_checkpoints_bots_4_heads_39_ckpt109,10,checkpoints_sp_c_nb_e2_ckpt667,5_vs_5
3037,-4,0,less_then_partially_randomized_entropy_checkpoints_bots_4_heads_39_ckpt109,4,checkpoints_sp_c_nb_e2_ckpt667,5_vs_5
3038,-5,0,less_then_partially_randomized_entropy_checkpoints_bots_4_heads_39_ckpt109,5,checkpoints_sp_c_nb_e2_ckpt667,5_vs_5
3039,-14,0,less_then_partially_randomized_entropy_checkpoints_bots_4_heads_39_ckpt109,14,checkpoints_sp_c_nb_e2_ckpt667,5_vs_5
3040,-1,2,less_then_partially_randomized_entropy_checkpoints_bots_4_heads_39_ckpt109,3,m_sp_arch_medium_heads_conv16_0_bt_32_r313_m335,5_vs_5
3041,0,4,less_then_partially_randomized_entropy_checkpoints_bots_4_heads_39_ckpt109,4,m_sp_arch_medium_heads_conv16_0_bt_32_r313_m335,5_vs_5
3042,-4,0,less_then_partially_randomized_entropy_checkpoints_bots_4_heads_39_ckpt109,4,m_sp_arch_medium_heads_conv16_0_bt_32_r313_m335,5_vs_5
3043,-7,2,less_then_partially_randomized_entropy_checkpoints_bots_4_heads_39_ckpt109,9,m_sp_arch_medium_heads_conv16_0_bt_32_r313_m335,5_vs_5
3044,-3,1,less_then_partially_randomized_entropy_checkpoints_bots_4_heads_39_ckpt109,4,m_sp_arch_medium_heads_conv16_0_bt_32_r313_m335,5_vs_5
3045,-5,1,less_then_partially_randomized_entropy_checkpoints_bots_4_heads_39_ckpt109,6,m_sp_arch_longer_heads_bt_32_r201_m335,5_vs_5
3046,-3,0,less_then_partially_randomized_entropy_checkpoints_bots_4_heads_39_ckpt109,3,m_sp_arch_longer_heads_bt_32_r201_m335,5_vs_5
3047,-1,2,less_then_partially_randomized_entropy_checkpoints_bots_4_heads_39_ckpt109,3,m_sp_arch_longer_heads_bt_32_r201_m335,5_vs_5
3048,-4,1,less_then_partially_randomized_entropy_checkpoints_bots_4_heads_39_ckpt109,5,m_sp_arch_longer_heads_bt_32_r201_m335,5_vs_5
3049,-5,0,less_then_partially_randomized_entropy_checkpoints_bots_4_heads_39_ckpt109,5,m_sp_arch_longer_heads_bt_32_r201_m335,5_vs_5
3050,-7,2,less_then_partially_randomized_entropy_checkpoints_bots_4_heads_39_ckpt109,9,m_sp_arch_medium_heads_bt_32_r201_m335,5_vs_5
3051,-7,0,less_then_partially_randomized_entropy_checkpoints_bots_4_heads_39_ckpt109,7,m_sp_arch_medium_heads_bt_32_r201_m335,5_vs_5
3052,-1,2,less_then_partially_randomized_entropy_checkpoints_bots_4_heads_39_ckpt109,3,m_sp_arch_medium_heads_bt_32_r201_m335,5_vs_5
3053,-7,3,less_then_partially_randomized_entropy_checkpoints_bots_4_heads_39_ckpt109,10,m_sp_arch_medium_heads_bt_32_r201_m335,5_vs_5
3054,-2,3,less_then_partially_randomized_entropy_checkpoints_bots_4_heads_39_ckpt109,5,m_sp_arch_medium_heads_bt_32_r201_m335,5_vs_5
3055,-11,0,less_then_partially_randomized_entropy_checkpoints_bots_4_heads_39_ckpt109,11,m_sp_arch_4x1_bt_32_r201_m335,5_vs_5
3056,-12,0,less_then_partially_randomized_entropy_checkpoints_bots_4_heads_39_ckpt109,12,m_sp_arch_4x1_bt_32_r201_m335,5_vs_5
3057,-13,0,less_then_partially_randomized_entropy_checkpoints_bots_4_heads_39_ckpt109,13,m_sp_arch_4x1_bt_32_r201_m335,5_vs_5
3058,-8,0,less_then_partially_randomized_entropy_checkpoints_bots_4_heads_39_ckpt109,8,m_sp_arch_4x1_bt_32_r201_m335,5_vs_5
3059,-12,0,less_then_partially_randomized_entropy_checkpoints_bots_4_heads_39_ckpt109,12,m_sp_arch_4x1_bt_32_r201_m335,5_vs_5
3060,-11,0,less_then_partially_randomized_entropy_checkpoints_bots_4_heads_39_ckpt109,11,m_sp_arch_4x1_bt_32_r201_cont3_m650,5_vs_5
3061,-12,0,less_then_partially_randomized_entropy_checkpoints_bots_4_heads_39_ckpt109,12,m_sp_arch_4x1_bt_32_r201_cont3_m650,5_vs_5
3062,-10,0,less_then_partially_randomized_entropy_checkpoints_bots_4_heads_39_ckpt109,10,m_sp_arch_4x1_bt_32_r201_cont3_m650,5_vs_5
3063,-12,0,less_then_partially_randomized_entropy_checkpoints_bots_4_heads_39_ckpt109,12,m_sp_arch_4x1_bt_32_r201_cont3_m650,5_vs_5
3064,-12,0,less_then_partially_randomized_entropy_checkpoints_bots_4_heads_39_ckpt109,12,m_sp_arch_4x1_bt_32_r201_cont3_m650,5_vs_5
3065,-3,0,less_then_partially_randomized_entropy_checkpoints_bots_4_heads_39_ckpt109,3,explt_v0_7_2_m54,5_vs_5
3066,0,0,less_then_partially_randomized_entropy_checkpoints_bots_4_heads_39_ckpt109,0,explt_v0_7_2_m54,5_vs_5
3067,-1,0,less_then_partially_randomized_entropy_checkpoints_bots_4_heads_39_ckpt109,1,explt_v0_7_2_m54,5_vs_5
3068,-1,1,less_then_partially_randomized_entropy_checkpoints_bots_4_heads_39_ckpt109,2,explt_v0_7_2_m54,5_vs_5
3069,-2,0,less_then_partially_randomized_entropy_checkpoints_bots_4_heads_39_ckpt109,2,explt_v0_7_2_m54,5_vs_5
3070,-17,0,less_then_partially_randomized_entropy_checkpoints_bots_4_heads_39_ckpt109,17,m_sp_sc3v3_arch_2x1_32_r500_cont4x1_m224,5_vs_5
3071,-15,0,less_then_partially_randomized_entropy_checkpoints_bots_4_heads_39_ckpt109,15,m_sp_sc3v3_arch_2x1_32_r500_cont4x1_m224,5_vs_5
3072,-16,0,less_then_partially_randomized_entropy_checkpoints_bots_4_heads_39_ckpt109,16,m_sp_sc3v3_arch_2x1_32_r500_cont4x1_m224,5_vs_5
3073,-14,1,less_then_partially_randomized_entropy_checkpoints_bots_4_heads_39_ckpt109,15,m_sp_sc3v3_arch_2x1_32_r500_cont4x1_m224,5_vs_5
3074,-15,1,less_then_partially_randomized_entropy_checkpoints_bots_4_heads_39_ckpt109,16,m_sp_sc3v3_arch_2x1_32_r500_cont4x1_m224,5_vs_5
3075,-15,0,less_then_partially_randomized_entropy_checkpoints_bots_4_heads_39_ckpt109,15,m_sp_arch_4x1_bt_32_roles_r500_m335,5_vs_5
3076,-12,1,less_then_partially_randomized_entropy_checkpoints_bots_4_heads_39_ckpt109,13,m_sp_arch_4x1_bt_32_roles_r500_m335,5_vs_5
3077,-14,0,less_then_partially_randomized_entropy_checkpoints_bots_4_heads_39_ckpt109,14,m_sp_arch_4x1_bt_32_roles_r500_m335,5_vs_5
3078,-13,0,less_then_partially_randomized_entropy_checkpoints_bots_4_heads_39_ckpt109,13,m_sp_arch_4x1_bt_32_roles_r500_m335,5_vs_5
3079,-6,1,less_then_partially_randomized_entropy_checkpoints_bots_4_heads_39_ckpt109,7,m_sp_arch_4x1_bt_32_roles_r500_m335,5_vs_5
3080,6,7,less_then_partially_randomized_checkpoints_bots_4_heads_38_ckpt108,1,easy_bots,5_vs_5
3081,10,10,less_then_partially_randomized_checkpoints_bots_4_heads_38_ckpt108,0,easy_bots,5_vs_5
3082,6,7,less_then_partially_randomized_checkpoints_bots_4_heads_38_ckpt108,1,easy_bots,5_vs_5
3083,11,11,less_then_partially_randomized_checkpoints_bots_4_heads_38_ckpt108,0,easy_bots,5_vs_5
3084,7,8,less_then_partially_randomized_checkpoints_bots_4_heads_38_ckpt108,1,easy_bots,5_vs_5
3085,5,6,less_then_partially_randomized_checkpoints_bots_4_heads_38_ckpt108,1,easy_bots,5_vs_5
3086,8,8,less_then_partially_randomized_checkpoints_bots_4_heads_38_ckpt108,0,easy_bots,5_vs_5
3087,7,9,less_then_partially_randomized_checkpoints_bots_4_heads_38_ckpt108,2,easy_bots,5_vs_5
3088,11,11,less_then_partially_randomized_checkpoints_bots_4_heads_38_ckpt108,0,easy_bots,5_vs_5
3089,10,10,less_then_partially_randomized_checkpoints_bots_4_heads_38_ckpt108,0,easy_bots,5_vs_5
3090,9,10,less_then_partially_randomized_checkpoints_bots_4_heads_38_ckpt108,1,medium_bots,5_vs_5_medium
3091,9,10,less_then_partially_randomized_checkpoints_bots_4_heads_38_ckpt108,1,medium_bots,5_vs_5_medium
3092,12,12,less_then_partially_randomized_checkpoints_bots_4_heads_38_ckpt108,0,medium_bots,5_vs_5_medium
3093,6,6,less_then_partially_randomized_checkpoints_bots_4_heads_38_ckpt108,0,medium_bots,5_vs_5_medium
3094,8,9,less_then_partially_randomized_checkpoints_bots_4_heads_38_ckpt108,1,medium_bots,5_vs_5_medium
3095,7,9,less_then_partially_randomized_checkpoints_bots_4_heads_38_ckpt108,2,medium_bots,5_vs_5_medium
3096,6,8,less_then_partially_randomized_checkpoints_bots_4_heads_38_ckpt108,2,medium_bots,5_vs_5_medium
3097,3,4,less_then_partially_randomized_checkpoints_bots_4_heads_38_ckpt108,1,medium_bots,5_vs_5_medium
3098,4,6,less_then_partially_randomized_checkpoints_bots_4_heads_38_ckpt108,2,medium_bots,5_vs_5_medium
3099,10,10,less_then_partially_randomized_checkpoints_bots_4_heads_38_ckpt108,0,medium_bots,5_vs_5_medium
3100,1,2,less_then_partially_randomized_checkpoints_bots_4_heads_38_ckpt108,1,hard_bots,5_vs_5_hard
3101,4,5,less_then_partially_randomized_checkpoints_bots_4_heads_38_ckpt108,1,hard_bots,5_vs_5_hard
3102,5,6,less_then_partially_randomized_checkpoints_bots_4_heads_38_ckpt108,1,hard_bots,5_vs_5_hard
3103,7,8,less_then_partially_randomized_checkpoints_bots_4_heads_38_ckpt108,1,hard_bots,5_vs_5_hard
3104,2,4,less_then_partially_randomized_checkpoints_bots_4_heads_38_ckpt108,2,hard_bots,5_vs_5_hard
3105,1,3,less_then_partially_randomized_checkpoints_bots_4_heads_38_ckpt108,2,hard_bots,5_vs_5_hard
3106,9,10,less_then_partially_randomized_checkpoints_bots_4_heads_38_ckpt108,1,hard_bots,5_vs_5_hard
3107,4,6,less_then_partially_randomized_checkpoints_bots_4_heads_38_ckpt108,2,hard_bots,5_vs_5_hard
3108,8,8,less_then_partially_randomized_checkpoints_bots_4_heads_38_ckpt108,0,hard_bots,5_vs_5_hard
3109,6,7,less_then_partially_randomized_checkpoints_bots_4_heads_38_ckpt108,1,hard_bots,5_vs_5_hard
3110,-3,2,less_then_partially_randomized_checkpoints_bots_4_heads_38_ckpt108,5,f5v0to1to2t05_e2_ckpt291,5_vs_5
3111,-3,1,less_then_partially_randomized_checkpoints_bots_4_heads_38_ckpt108,4,f5v0to1to2t05_e2_ckpt291,5_vs_5
3112,-1,3,less_then_partially_randomized_checkpoints_bots_4_heads_38_ckpt108,4,f5v0to1to2t05_e2_ckpt291,5_vs_5
3113,-1,2,less_then_partially_randomized_checkpoints_bots_4_heads_38_ckpt108,3,f5v0to1to2t05_e2_ckpt291,5_vs_5
3114,0,3,less_then_partially_randomized_checkpoints_bots_4_heads_38_ckpt108,3,f5v0to1to2t05_e2_ckpt291,5_vs_5
3115,-1,3,less_then_partially_randomized_checkpoints_bots_4_heads_38_ckpt108,4,f5v0to1to5_e2_ckpt252,5_vs_5
3116,-1,4,less_then_partially_randomized_checkpoints_bots_4_heads_38_ckpt108,5,f5v0to1to5_e2_ckpt252,5_vs_5
3117,2,5,less_then_partially_randomized_checkpoints_bots_4_heads_38_ckpt108,3,f5v0to1to5_e2_ckpt252,5_vs_5
3118,1,4,less_then_partially_randomized_checkpoints_bots_4_heads_38_ckpt108,3,f5v0to1to5_e2_ckpt252,5_vs_5
3119,-3,2,less_then_partially_randomized_checkpoints_bots_4_heads_38_ckpt108,5,f5v0to1to5_e2_ckpt252,5_vs_5
3120,-2,3,less_then_partially_randomized_checkpoints_bots_4_heads_38_ckpt108,5,scon_e3_p2_hard_ckpt840,5_vs_5
3121,-1,1,less_then_partially_randomized_checkpoints_bots_4_heads_38_ckpt108,2,scon_e3_p2_hard_ckpt840,5_vs_5
3122,6,6,less_then_partially_randomized_checkpoints_bots_4_heads_38_ckpt108,0,scon_e3_p2_hard_ckpt840,5_vs_5
3123,-1,2,less_then_partially_randomized_checkpoints_bots_4_heads_38_ckpt108,3,scon_e3_p2_hard_ckpt840,5_vs_5
3124,0,1,less_then_partially_randomized_checkpoints_bots_4_heads_38_ckpt108,1,scon_e3_p2_hard_ckpt840,5_vs_5
3125,0,5,less_then_partially_randomized_checkpoints_bots_4_heads_38_ckpt108,5,less_then_partially_randomized_checkpoints_bots_4_heads_38_ckpt108,5_vs_5
3126,3,4,less_then_partially_randomized_checkpoints_bots_4_heads_38_ckpt108,1,less_then_partially_randomized_checkpoints_bots_4_heads_38_ckpt108,5_vs_5
3127,2,5,less_then_partially_randomized_checkpoints_bots_4_heads_38_ckpt108,3,less_then_partially_randomized_checkpoints_bots_4_heads_38_ckpt108,5_vs_5
3128,-4,3,less_then_partially_randomized_checkpoints_bots_4_heads_38_ckpt108,7,less_then_partially_randomized_checkpoints_bots_4_heads_38_ckpt108,5_vs_5
3129,-1,3,less_then_partially_randomized_checkpoints_bots_4_heads_38_ckpt108,4,less_then_partially_randomized_checkpoints_bots_4_heads_38_ckpt108,5_vs_5
3130,2,4,less_then_partially_randomized_checkpoints_bots_4_heads_38_ckpt108,2,less_then_partially_randomized_entropy_checkpoints_bots_4_heads_39_ckpt109,5_vs_5
3131,1,4,less_then_partially_randomized_checkpoints_bots_4_heads_38_ckpt108,3,less_then_partially_randomized_entropy_checkpoints_bots_4_heads_39_ckpt109,5_vs_5
3132,4,7,less_then_partially_randomized_checkpoints_bots_4_heads_38_ckpt108,3,less_then_partially_randomized_entropy_checkpoints_bots_4_heads_39_ckpt109,5_vs_5
3133,-1,4,less_then_partially_randomized_checkpoints_bots_4_heads_38_ckpt108,5,less_then_partially_randomized_entropy_checkpoints_bots_4_heads_39_ckpt109,5_vs_5
3134,-3,2,less_then_partially_randomized_checkpoints_bots_4_heads_38_ckpt108,5,less_then_partially_randomized_entropy_checkpoints_bots_4_heads_39_ckpt109,5_vs_5
3135,-1,2,less_then_partially_randomized_checkpoints_bots_4_heads_38_ckpt108,3,reward_shaping_checkpoints_bots_4_heads_1_ckpt360,5_vs_5
3136,5,7,less_then_partially_randomized_checkpoints_bots_4_heads_38_ckpt108,2,reward_shaping_checkpoints_bots_4_heads_1_ckpt360,5_vs_5
3137,3,5,less_then_partially_randomized_checkpoints_bots_4_heads_38_ckpt108,2,reward_shaping_checkpoints_bots_4_heads_1_ckpt360,5_vs_5
3138,4,6,less_then_partially_randomized_checkpoints_bots_4_heads_38_ckpt108,2,reward_shaping_checkpoints_bots_4_heads_1_ckpt360,5_vs_5
3139,7,7,less_then_partially_randomized_checkpoints_bots_4_heads_38_ckpt108,0,reward_shaping_checkpoints_bots_4_heads_1_ckpt360,5_vs_5
3140,-7,2,less_then_partially_randomized_checkpoints_bots_4_heads_38_ckpt108,9,checkpoints_selfplay_e9_sp_ckpt274,5_vs_5
3141,-15,0,less_then_partially_randomized_checkpoints_bots_4_heads_38_ckpt108,15,checkpoints_selfplay_e9_sp_ckpt274,5_vs_5
3142,-10,2,less_then_partially_randomized_checkpoints_bots_4_heads_38_ckpt108,12,checkpoints_selfplay_e9_sp_ckpt274,5_vs_5
3143,-4,0,less_then_partially_randomized_checkpoints_bots_4_heads_38_ckpt108,4,checkpoints_selfplay_e9_sp_ckpt274,5_vs_5
3144,0,5,less_then_partially_randomized_checkpoints_bots_4_heads_38_ckpt108,5,checkpoints_selfplay_e9_sp_ckpt274,5_vs_5
3145,-7,0,less_then_partially_randomized_checkpoints_bots_4_heads_38_ckpt108,7,checkpoints_sp_c_nb_e2_ckpt667,5_vs_5
3146,-10,0,less_then_partially_randomized_checkpoints_bots_4_heads_38_ckpt108,10,checkpoints_sp_c_nb_e2_ckpt667,5_vs_5
3147,-6,1,less_then_partially_randomized_checkpoints_bots_4_heads_38_ckpt108,7,checkpoints_sp_c_nb_e2_ckpt667,5_vs_5
3148,-7,0,less_then_partially_randomized_checkpoints_bots_4_heads_38_ckpt108,7,checkpoints_sp_c_nb_e2_ckpt667,5_vs_5
3149,-5,1,less_then_partially_randomized_checkpoints_bots_4_heads_38_ckpt108,6,checkpoints_sp_c_nb_e2_ckpt667,5_vs_5
3150,-1,3,less_then_partially_randomized_checkpoints_bots_4_heads_38_ckpt108,4,m_sp_arch_medium_heads_conv16_0_bt_32_r313_m335,5_vs_5
3151,-1,4,less_then_partially_randomized_checkpoints_bots_4_heads_38_ckpt108,5,m_sp_arch_medium_heads_conv16_0_bt_32_r313_m335,5_vs_5
3152,1,4,less_then_partially_randomized_checkpoints_bots_4_heads_38_ckpt108,3,m_sp_arch_medium_heads_conv16_0_bt_32_r313_m335,5_vs_5
3153,-3,2,less_then_partially_randomized_checkpoints_bots_4_heads_38_ckpt108,5,m_sp_arch_medium_heads_conv16_0_bt_32_r313_m335,5_vs_5
3154,-4,0,less_then_partially_randomized_checkpoints_bots_4_heads_38_ckpt108,4,m_sp_arch_medium_heads_conv16_0_bt_32_r313_m335,5_vs_5
3155,-8,0,less_then_partially_randomized_checkpoints_bots_4_heads_38_ckpt108,8,m_sp_arch_longer_heads_bt_32_r201_m335,5_vs_5
3156,-7,0,less_then_partially_randomized_checkpoints_bots_4_heads_38_ckpt108,7,m_sp_arch_longer_heads_bt_32_r201_m335,5_vs_5
3157,-4,1,less_then_partially_randomized_checkpoints_bots_4_heads_38_ckpt108,5,m_sp_arch_longer_heads_bt_32_r201_m335,5_vs_5
3158,-7,0,less_then_partially_randomized_checkpoints_bots_4_heads_38_ckpt108,7,m_sp_arch_longer_heads_bt_32_r201_m335,5_vs_5
3159,-3,2,less_then_partially_randomized_checkpoints_bots_4_heads_38_ckpt108,5,m_sp_arch_longer_heads_bt_32_r201_m335,5_vs_5
3160,-2,3,less_then_partially_randomized_checkpoints_bots_4_heads_38_ckpt108,5,m_sp_arch_medium_heads_bt_32_r201_m335,5_vs_5
3161,-6,2,less_then_partially_randomized_checkpoints_bots_4_heads_38_ckpt108,8,m_sp_arch_medium_heads_bt_32_r201_m335,5_vs_5
3162,-3,4,less_then_partially_randomized_checkpoints_bots_4_heads_38_ckpt108,7,m_sp_arch_medium_heads_bt_32_r201_m335,5_vs_5
3163,-4,3,less_then_partially_randomized_checkpoints_bots_4_heads_38_ckpt108,7,m_sp_arch_medium_heads_bt_32_r201_m335,5_vs_5
3164,-2,1,less_then_partially_randomized_checkpoints_bots_4_heads_38_ckpt108,3,m_sp_arch_medium_heads_bt_32_r201_m335,5_vs_5
3165,-11,0,less_then_partially_randomized_checkpoints_bots_4_heads_38_ckpt108,11,m_sp_arch_4x1_bt_32_r201_m335,5_vs_5
3166,-13,0,less_then_partially_randomized_checkpoints_bots_4_heads_38_ckpt108,13,m_sp_arch_4x1_bt_32_r201_m335,5_vs_5
3167,-10,0,less_then_partially_randomized_checkpoints_bots_4_heads_38_ckpt108,10,m_sp_arch_4x1_bt_32_r201_m335,5_vs_5
3168,-14,0,less_then_partially_randomized_checkpoints_bots_4_heads_38_ckpt108,14,m_sp_arch_4x1_bt_32_r201_m335,5_vs_5
3169,-7,0,less_then_partially_randomized_checkpoints_bots_4_heads_38_ckpt108,7,m_sp_arch_4x1_bt_32_r201_m335,5_vs_5
3170,-13,0,less_then_partially_randomized_checkpoints_bots_4_heads_38_ckpt108,13,m_sp_arch_4x1_bt_32_r201_cont3_m650,5_vs_5
3171,-9,0,less_then_partially_randomized_checkpoints_bots_4_heads_38_ckpt108,9,m_sp_arch_4x1_bt_32_r201_cont3_m650,5_vs_5
3172,-9,0,less_then_partially_randomized_checkpoints_bots_4_heads_38_ckpt108,9,m_sp_arch_4x1_bt_32_r201_cont3_m650,5_vs_5
3173,-9,0,less_then_partially_randomized_checkpoints_bots_4_heads_38_ckpt108,9,m_sp_arch_4x1_bt_32_r201_cont3_m650,5_vs_5
3174,-9,0,less_then_partially_randomized_checkpoints_bots_4_heads_38_ckpt108,9,m_sp_arch_4x1_bt_32_r201_cont3_m650,5_vs_5
3175,-1,1,less_then_partially_randomized_checkpoints_bots_4_heads_38_ckpt108,2,explt_v0_7_2_m54,5_vs_5
3176,-6,0,less_then_partially_randomized_checkpoints_bots_4_heads_38_ckpt108,6,explt_v0_7_2_m54,5_vs_5
3177,1,1,less_then_partially_randomized_checkpoints_bots_4_heads_38_ckpt108,0,explt_v0_7_2_m54,5_vs_5
3178,-1,0,less_then_partially_randomized_checkpoints_bots_4_heads_38_ckpt108,1,explt_v0_7_2_m54,5_vs_5
3179,-2,0,less_then_partially_randomized_checkpoints_bots_4_heads_38_ckpt108,2,explt_v0_7_2_m54,5_vs_5
3180,-13,0,less_then_partially_randomized_checkpoints_bots_4_heads_38_ckpt108,13,m_sp_sc3v3_arch_2x1_32_r500_cont4x1_m224,5_vs_5
3181,-15,0,less_then_partially_randomized_checkpoints_bots_4_heads_38_ckpt108,15,m_sp_sc3v3_arch_2x1_32_r500_cont4x1_m224,5_vs_5
3182,-14,0,less_then_partially_randomized_checkpoints_bots_4_heads_38_ckpt108,14,m_sp_sc3v3_arch_2x1_32_r500_cont4x1_m224,5_vs_5
3183,-13,0,less_then_partially_randomized_checkpoints_bots_4_heads_38_ckpt108,13,m_sp_sc3v3_arch_2x1_32_r500_cont4x1_m224,5_vs_5
3184,-17,0,less_then_partially_randomized_checkpoints_bots_4_heads_38_ckpt108,17,m_sp_sc3v3_arch_2x1_32_r500_cont4x1_m224,5_vs_5
3185,-10,0,less_then_partially_randomized_checkpoints_bots_4_heads_38_ckpt108,10,m_sp_arch_4x1_bt_32_roles_r500_m335,5_vs_5
3186,-8,0,less_then_partially_randomized_checkpoints_bots_4_heads_38_ckpt108,8,m_sp_arch_4x1_bt_32_roles_r500_m335,5_vs_5
3187,-10,0,less_then_partially_randomized_checkpoints_bots_4_heads_38_ckpt108,10,m_sp_arch_4x1_bt_32_roles_r500_m335,5_vs_5
3188,-13,0,less_then_partially_randomized_checkpoints_bots_4_heads_38_ckpt108,13,m_sp_arch_4x1_bt_32_roles_r500_m335,5_vs_5
3189,-15,0,less_then_partially_randomized_checkpoints_bots_4_heads_38_ckpt108,15,m_sp_arch_4x1_bt_32_roles_r500_m335,5_vs_5
3190,7,10,reward_shaping_checkpoints_bots_4_heads_1_ckpt360,3,easy_bots,5_vs_5
3191,12,12,reward_shaping_checkpoints_bots_4_heads_1_ckpt360,0,easy_bots,5_vs_5
3192,5,6,reward_shaping_checkpoints_bots_4_heads_1_ckpt360,1,easy_bots,5_vs_5
3193,8,9,reward_shaping_checkpoints_bots_4_heads_1_ckpt360,1,easy_bots,5_vs_5
3194,3,5,reward_shaping_checkpoints_bots_4_heads_1_ckpt360,2,easy_bots,5_vs_5
3195,9,10,reward_shaping_checkpoints_bots_4_heads_1_ckpt360,1,easy_bots,5_vs_5
3196,8,9,reward_shaping_checkpoints_bots_4_heads_1_ckpt360,1,medium_bots,5_vs_5_medium
3197,4,4,reward_shaping_checkpoints_bots_4_heads_1_ckpt360,0,medium_bots,5_vs_5_medium
3198,5,6,reward_shaping_checkpoints_bots_4_heads_1_ckpt360,1,medium_bots,5_vs_5_medium
3199,3,5,reward_shaping_checkpoints_bots_4_heads_1_ckpt360,2,medium_bots,5_vs_5_medium
3200,8,8,reward_shaping_checkpoints_bots_4_heads_1_ckpt360,0,medium_bots,5_vs_5_medium
3201,5,8,reward_shaping_checkpoints_bots_4_heads_1_ckpt360,3,medium_bots,5_vs_5_medium
3202,4,5,reward_shaping_checkpoints_bots_4_heads_1_ckpt360,1,hard_bots,5_vs_5_hard
3203,2,3,reward_shaping_checkpoints_bots_4_heads_1_ckpt360,1,hard_bots,5_vs_5_hard
3204,3,4,reward_shaping_checkpoints_bots_4_heads_1_ckpt360,1,hard_bots,5_vs_5_hard
3205,1,4,reward_shaping_checkpoints_bots_4_heads_1_ckpt360,3,hard_bots,5_vs_5_hard
3206,3,3,reward_shaping_checkpoints_bots_4_heads_1_ckpt360,0,hard_bots,5_vs_5_hard
3207,5,5,reward_shaping_checkpoints_bots_4_heads_1_ckpt360,0,hard_bots,5_vs_5_hard
3208,-2,2,reward_shaping_checkpoints_bots_4_heads_1_ckpt360,4,f5v0to1to2t05_e2_ckpt291,5_vs_5
3209,-4,0,reward_shaping_checkpoints_bots_4_heads_1_ckpt360,4,f5v0to1to2t05_e2_ckpt291,5_vs_5
3210,-6,0,reward_shaping_checkpoints_bots_4_heads_1_ckpt360,6,f5v0to1to2t05_e2_ckpt291,5_vs_5
3211,0,1,reward_shaping_checkpoints_bots_4_heads_1_ckpt360,1,f5v0to1to5_e2_ckpt252,5_vs_5
3212,-4,1,reward_shaping_checkpoints_bots_4_heads_1_ckpt360,5,f5v0to1to5_e2_ckpt252,5_vs_5
3213,-4,2,reward_shaping_checkpoints_bots_4_heads_1_ckpt360,6,f5v0to1to5_e2_ckpt252,5_vs_5
3214,-2,1,reward_shaping_checkpoints_bots_4_heads_1_ckpt360,3,scon_e3_p2_hard_ckpt840,5_vs_5
3215,-3,2,reward_shaping_checkpoints_bots_4_heads_1_ckpt360,5,scon_e3_p2_hard_ckpt840,5_vs_5
3216,1,3,reward_shaping_checkpoints_bots_4_heads_1_ckpt360,2,scon_e3_p2_hard_ckpt840,5_vs_5
3217,0,3,reward_shaping_checkpoints_bots_4_heads_1_ckpt360,3,less_then_partially_randomized_checkpoints_bots_4_heads_38_ckpt108,5_vs_5
3218,-4,3,reward_shaping_checkpoints_bots_4_heads_1_ckpt360,7,less_then_partially_randomized_checkpoints_bots_4_heads_38_ckpt108,5_vs_5
3219,2,5,reward_shaping_checkpoints_bots_4_heads_1_ckpt360,3,less_then_partially_randomized_checkpoints_bots_4_heads_38_ckpt108,5_vs_5
3220,-3,1,reward_shaping_checkpoints_bots_4_heads_1_ckpt360,4,less_then_partially_randomized_entropy_checkpoints_bots_4_heads_39_ckpt109,5_vs_5
3221,0,1,reward_shaping_checkpoints_bots_4_heads_1_ckpt360,1,less_then_partially_randomized_entropy_checkpoints_bots_4_heads_39_ckpt109,5_vs_5
3222,1,4,reward_shaping_checkpoints_bots_4_heads_1_ckpt360,3,less_then_partially_randomized_entropy_checkpoints_bots_4_heads_39_ckpt109,5_vs_5
3223,2,3,reward_shaping_checkpoints_bots_4_heads_1_ckpt360,1,reward_shaping_checkpoints_bots_4_heads_1_ckpt360,5_vs_5
3224,4,5,reward_shaping_checkpoints_bots_4_heads_1_ckpt360,1,reward_shaping_checkpoints_bots_4_heads_1_ckpt360,5_vs_5
3225,-1,2,reward_shaping_checkpoints_bots_4_heads_1_ckpt360,3,reward_shaping_checkpoints_bots_4_heads_1_ckpt360,5_vs_5
3226,-12,0,reward_shaping_checkpoints_bots_4_heads_1_ckpt360,12,checkpoints_selfplay_e9_sp_ckpt274,5_vs_5
3227,-4,1,reward_shaping_checkpoints_bots_4_heads_1_ckpt360,5,checkpoints_selfplay_e9_sp_ckpt274,5_vs_5
3228,-8,2,reward_shaping_checkpoints_bots_4_heads_1_ckpt360,10,checkpoints_selfplay_e9_sp_ckpt274,5_vs_5
3229,-7,1,reward_shaping_checkpoints_bots_4_heads_1_ckpt360,8,checkpoints_sp_c_nb_e2_ckpt667,5_vs_5
3230,-7,0,reward_shaping_checkpoints_bots_4_heads_1_ckpt360,7,checkpoints_sp_c_nb_e2_ckpt667,5_vs_5
3231,-7,0,reward_shaping_checkpoints_bots_4_heads_1_ckpt360,7,checkpoints_sp_c_nb_e2_ckpt667,5_vs_5
3232,0,2,reward_shaping_checkpoints_bots_4_heads_1_ckpt360,2,m_sp_arch_medium_heads_conv16_0_bt_32_r313_m335,5_vs_5
3233,-3,0,reward_shaping_checkpoints_bots_4_heads_1_ckpt360,3,m_sp_arch_medium_heads_conv16_0_bt_32_r313_m335,5_vs_5
3234,-3,2,reward_shaping_checkpoints_bots_4_heads_1_ckpt360,5,m_sp_arch_medium_heads_conv16_0_bt_32_r313_m335,5_vs_5
3235,-4,2,reward_shaping_checkpoints_bots_4_heads_1_ckpt360,6,m_sp_arch_longer_heads_bt_32_r201_m335,5_vs_5
3236,-7,0,reward_shaping_checkpoints_bots_4_heads_1_ckpt360,7,m_sp_arch_longer_heads_bt_32_r201_m335,5_vs_5
3237,-6,1,reward_shaping_checkpoints_bots_4_heads_1_ckpt360,7,m_sp_arch_longer_heads_bt_32_r201_m335,5_vs_5
3238,-5,0,reward_shaping_checkpoints_bots_4_heads_1_ckpt360,5,m_sp_arch_medium_heads_bt_32_r201_m335,5_vs_5
3239,-6,0,reward_shaping_checkpoints_bots_4_heads_1_ckpt360,6,m_sp_arch_medium_heads_bt_32_r201_m335,5_vs_5
3240,-5,0,reward_shaping_checkpoints_bots_4_heads_1_ckpt360,5,m_sp_arch_medium_heads_bt_32_r201_m335,5_vs_5
3241,-12,1,reward_shaping_checkpoints_bots_4_heads_1_ckpt360,13,m_sp_arch_4x1_bt_32_r201_m335,5_vs_5
3242,-9,0,reward_shaping_checkpoints_bots_4_heads_1_ckpt360,9,m_sp_arch_4x1_bt_32_r201_m335,5_vs_5
3243,-11,0,reward_shaping_checkpoints_bots_4_heads_1_ckpt360,11,m_sp_arch_4x1_bt_32_r201_m335,5_vs_5
3244,-9,0,reward_shaping_checkpoints_bots_4_heads_1_ckpt360,9,m_sp_arch_4x1_bt_32_r201_cont3_m650,5_vs_5
3245,-12,0,reward_shaping_checkpoints_bots_4_heads_1_ckpt360,12,m_sp_arch_4x1_bt_32_r201_cont3_m650,5_vs_5
3246,-7,0,reward_shaping_checkpoints_bots_4_heads_1_ckpt360,7,m_sp_arch_4x1_bt_32_r201_cont3_m650,5_vs_5
3247,-3,1,reward_shaping_checkpoints_bots_4_heads_1_ckpt360,4,explt_v0_7_2_m54,5_vs_5
3248,-7,0,reward_shaping_checkpoints_bots_4_heads_1_ckpt360,7,explt_v0_7_2_m54,5_vs_5
3249,-3,0,reward_shaping_checkpoints_bots_4_heads_1_ckpt360,3,explt_v0_7_2_m54,5_vs_5
3250,-12,0,reward_shaping_checkpoints_bots_4_heads_1_ckpt360,12,m_sp_sc3v3_arch_2x1_32_r500_cont4x1_m224,5_vs_5
3251,-9,0,reward_shaping_checkpoints_bots_4_heads_1_ckpt360,9,m_sp_sc3v3_arch_2x1_32_r500_cont4x1_m224,5_vs_5
3252,-10,0,reward_shaping_checkpoints_bots_4_heads_1_ckpt360,10,m_sp_sc3v3_arch_2x1_32_r500_cont4x1_m224,5_vs_5
3253,-10,0,reward_shaping_checkpoints_bots_4_heads_1_ckpt360,10,m_sp_arch_4x1_bt_32_roles_r500_m335,5_vs_5
3254,-11,0,reward_shaping_checkpoints_bots_4_heads_1_ckpt360,11,m_sp_arch_4x1_bt_32_roles_r500_m335,5_vs_5
3255,-12,0,reward_shaping_checkpoints_bots_4_heads_1_ckpt360,12,m_sp_arch_4x1_bt_32_roles_r500_m335,5_vs_5
3256,-1,2,checkpoints_sp_c_nb_e2_ckpt667,3,easy_bots,5_vs_5
3257,0,1,checkpoints_sp_c_nb_e2_ckpt667,1,easy_bots,5_vs_5
3258,-1,0,checkpoints_sp_c_nb_e2_ckpt667,1,easy_bots,5_vs_5
3259,1,2,checkpoints_sp_c_nb_e2_ckpt667,1,easy_bots,5_vs_5
3260,-2,2,checkpoints_sp_c_nb_e2_ckpt667,4,easy_bots,5_vs_5
3261,-1,0,checkpoints_sp_c_nb_e2_ckpt667,1,easy_bots,5_vs_5
3262,-2,2,checkpoints_sp_c_nb_e2_ckpt667,4,medium_bots,5_vs_5_medium
3263,1,2,checkpoints_sp_c_nb_e2_ckpt667,1,medium_bots,5_vs_5_medium
3264,-3,1,checkpoints_sp_c_nb_e2_ckpt667,4,medium_bots,5_vs_5_medium
3265,-1,0,checkpoints_sp_c_nb_e2_ckpt667,1,medium_bots,5_vs_5_medium
3266,-2,2,checkpoints_sp_c_nb_e2_ckpt667,4,medium_bots,5_vs_5_medium
3267,-1,1,checkpoints_sp_c_nb_e2_ckpt667,2,medium_bots,5_vs_5_medium
3268,-1,0,checkpoints_sp_c_nb_e2_ckpt667,1,hard_bots,5_vs_5_hard
3269,-1,1,checkpoints_sp_c_nb_e2_ckpt667,2,hard_bots,5_vs_5_hard
3270,-3,0,checkpoints_sp_c_nb_e2_ckpt667,3,hard_bots,5_vs_5_hard
3271,-1,0,checkpoints_sp_c_nb_e2_ckpt667,1,hard_bots,5_vs_5_hard
3272,-1,0,checkpoints_sp_c_nb_e2_ckpt667,1,hard_bots,5_vs_5_hard
3273,0,3,checkpoints_sp_c_nb_e2_ckpt667,3,hard_bots,5_vs_5_hard
3274,6,6,checkpoints_sp_c_nb_e2_ckpt667,0,f5v0to1to2t05_e2_ckpt291,5_vs_5
3275,3,3,checkpoints_sp_c_nb_e2_ckpt667,0,f5v0to1to2t05_e2_ckpt291,5_vs_5
3276,5,7,checkpoints_sp_c_nb_e2_ckpt667,2,f5v0to1to2t05_e2_ckpt291,5_vs_5
3277,8,8,checkpoints_sp_c_nb_e2_ckpt667,0,f5v0to1to5_e2_ckpt252,5_vs_5
3278,4,7,checkpoints_sp_c_nb_e2_ckpt667,3,f5v0to1to5_e2_ckpt252,5_vs_5
3279,8,11,checkpoints_sp_c_nb_e2_ckpt667,3,f5v0to1to5_e2_ckpt252,5_vs_5
3280,5,6,checkpoints_sp_c_nb_e2_ckpt667,1,scon_e3_p2_hard_ckpt840,5_vs_5
3281,4,5,checkpoints_sp_c_nb_e2_ckpt667,1,scon_e3_p2_hard_ckpt840,5_vs_5
3282,7,8,checkpoints_sp_c_nb_e2_ckpt667,1,scon_e3_p2_hard_ckpt840,5_vs_5
3283,8,9,checkpoints_sp_c_nb_e2_ckpt667,1,less_then_partially_randomized_checkpoints_bots_4_heads_38_ckpt108,5_vs_5
3284,6,6,checkpoints_sp_c_nb_e2_ckpt667,0,less_then_partially_randomized_checkpoints_bots_4_heads_38_ckpt108,5_vs_5
3285,8,8,checkpoints_sp_c_nb_e2_ckpt667,0,less_then_partially_randomized_checkpoints_bots_4_heads_38_ckpt108,5_vs_5
3286,7,7,checkpoints_sp_c_nb_e2_ckpt667,0,less_then_partially_randomized_entropy_checkpoints_bots_4_heads_39_ckpt109,5_vs_5
3287,6,6,checkpoints_sp_c_nb_e2_ckpt667,0,less_then_partially_randomized_entropy_checkpoints_bots_4_heads_39_ckpt109,5_vs_5
3288,8,8,checkpoints_sp_c_nb_e2_ckpt667,0,less_then_partially_randomized_entropy_checkpoints_bots_4_heads_39_ckpt109,5_vs_5
3289,5,6,checkpoints_sp_c_nb_e2_ckpt667,1,reward_shaping_checkpoints_bots_4_heads_1_ckpt360,5_vs_5
3290,5,6,checkpoints_sp_c_nb_e2_ckpt667,1,reward_shaping_checkpoints_bots_4_heads_1_ckpt360,5_vs_5
3291,8,8,checkpoints_sp_c_nb_e2_ckpt667,0,reward_shaping_checkpoints_bots_4_heads_1_ckpt360,5_vs_5
3292,1,4,checkpoints_sp_c_nb_e2_ckpt667,3,checkpoints_selfplay_e9_sp_ckpt274,5_vs_5
3293,8,11,checkpoints_sp_c_nb_e2_ckpt667,3,checkpoints_selfplay_e9_sp_ckpt274,5_vs_5
3294,1,5,checkpoints_sp_c_nb_e2_ckpt667,4,checkpoints_selfplay_e9_sp_ckpt274,5_vs_5
3295,-6,3,checkpoints_sp_c_nb_e2_ckpt667,9,checkpoints_sp_c_nb_e2_ckpt667,5_vs_5
3296,-4,2,checkpoints_sp_c_nb_e2_ckpt667,6,checkpoints_sp_c_nb_e2_ckpt667,5_vs_5
3297,0,5,checkpoints_sp_c_nb_e2_ckpt667,5,checkpoints_sp_c_nb_e2_ckpt667,5_vs_5
3298,1,3,checkpoints_sp_c_nb_e2_ckpt667,2,m_sp_arch_medium_heads_conv16_0_bt_32_r313_m335,5_vs_5
3299,6,6,checkpoints_sp_c_nb_e2_ckpt667,0,m_sp_arch_medium_heads_conv16_0_bt_32_r313_m335,5_vs_5
3300,2,5,checkpoints_sp_c_nb_e2_ckpt667,3,m_sp_arch_medium_heads_conv16_0_bt_32_r313_m335,5_vs_5
3301,-1,2,checkpoints_sp_c_nb_e2_ckpt667,3,m_sp_arch_longer_heads_bt_32_r201_m335,5_vs_5
3302,2,4,checkpoints_sp_c_nb_e2_ckpt667,2,m_sp_arch_longer_heads_bt_32_r201_m335,5_vs_5
3303,3,4,checkpoints_sp_c_nb_e2_ckpt667,1,m_sp_arch_longer_heads_bt_32_r201_m335,5_vs_5
3304,8,8,checkpoints_sp_c_nb_e2_ckpt667,0,m_sp_arch_medium_heads_bt_32_r201_m335,5_vs_5
3305,6,7,checkpoints_sp_c_nb_e2_ckpt667,1,m_sp_arch_medium_heads_bt_32_r201_m335,5_vs_5
3306,6,8,checkpoints_sp_c_nb_e2_ckpt667,2,m_sp_arch_medium_heads_bt_32_r201_m335,5_vs_5
3307,-1,1,checkpoints_sp_c_nb_e2_ckpt667,2,m_sp_arch_4x1_bt_32_r201_m335,5_vs_5
3308,0,1,checkpoints_sp_c_nb_e2_ckpt667,1,m_sp_arch_4x1_bt_32_r201_m335,5_vs_5
3309,0,2,checkpoints_sp_c_nb_e2_ckpt667,2,m_sp_arch_4x1_bt_32_r201_m335,5_vs_5
3310,1,4,checkpoints_sp_c_nb_e2_ckpt667,3,m_sp_arch_4x1_bt_32_r201_cont3_m650,5_vs_5
3311,-6,1,checkpoints_sp_c_nb_e2_ckpt667,7,m_sp_arch_4x1_bt_32_r201_cont3_m650,5_vs_5
3312,-5,0,checkpoints_sp_c_nb_e2_ckpt667,5,m_sp_arch_4x1_bt_32_r201_cont3_m650,5_vs_5
3313,-1,0,checkpoints_sp_c_nb_e2_ckpt667,1,explt_v0_7_2_m54,5_vs_5
3314,-1,1,checkpoints_sp_c_nb_e2_ckpt667,2,explt_v0_7_2_m54,5_vs_5
3315,-1,1,checkpoints_sp_c_nb_e2_ckpt667,2,explt_v0_7_2_m54,5_vs_5
3316,-1,1,checkpoints_sp_c_nb_e2_ckpt667,2,m_sp_sc3v3_arch_2x1_32_r500_cont4x1_m224,5_vs_5
3317,-8,0,checkpoints_sp_c_nb_e2_ckpt667,8,m_sp_sc3v3_arch_2x1_32_r500_cont4x1_m224,5_vs_5
3318,-3,2,checkpoints_sp_c_nb_e2_ckpt667,5,m_sp_sc3v3_arch_2x1_32_r500_cont4x1_m224,5_vs_5
3319,-5,1,checkpoints_sp_c_nb_e2_ckpt667,6,m_sp_arch_4x1_bt_32_roles_r500_m335,5_vs_5
3320,-1,2,checkpoints_sp_c_nb_e2_ckpt667,3,m_sp_arch_4x1_bt_32_roles_r500_m335,5_vs_5
3321,-2,1,checkpoints_sp_c_nb_e2_ckpt667,3,m_sp_arch_4x1_bt_32_roles_r500_m335,5_vs_5
3322,2,2,m_sp_arch_4x1_bt_32_r201_cont3_m650,0,easy_bots,5_vs_5
3323,4,5,m_sp_arch_4x1_bt_32_r201_cont3_m650,1,easy_bots,5_vs_5
3324,3,4,m_sp_arch_4x1_bt_32_r201_cont3_m650,1,easy_bots,5_vs_5
3325,2,4,m_sp_arch_4x1_bt_32_r201_cont3_m650,2,easy_bots,5_vs_5
3326,2,3,m_sp_arch_4x1_bt_32_r201_cont3_m650,1,easy_bots,5_vs_5
3327,4,4,m_sp_arch_4x1_bt_32_r201_cont3_m650,0,easy_bots,5_vs_5
3328,2,3,m_sp_arch_4x1_bt_32_r201_cont3_m650,1,easy_bots,5_vs_5
3329,-1,0,m_sp_arch_4x1_bt_32_r201_cont3_m650,1,easy_bots,5_vs_5
3330,3,4,m_sp_arch_4x1_bt_32_r201_cont3_m650,1,easy_bots,5_vs_5
3331,1,1,m_sp_arch_4x1_bt_32_r201_cont3_m650,0,easy_bots,5_vs_5
3332,-1,1,m_sp_arch_4x1_bt_32_r201_cont3_m650,2,medium_bots,5_vs_5_medium
3333,0,0,m_sp_arch_4x1_bt_32_r201_cont3_m650,0,medium_bots,5_vs_5_medium
3334,1,2,m_sp_arch_4x1_bt_32_r201_cont3_m650,1,medium_bots,5_vs_5_medium
3335,2,2,m_sp_arch_4x1_bt_32_r201_cont3_m650,0,medium_bots,5_vs_5_medium
3336,1,2,m_sp_arch_4x1_bt_32_r201_cont3_m650,1,medium_bots,5_vs_5_medium
3337,0,2,m_sp_arch_4x1_bt_32_r201_cont3_m650,2,medium_bots,5_vs_5_medium
3338,-2,0,m_sp_arch_4x1_bt_32_r201_cont3_m650,2,medium_bots,5_vs_5_medium
3339,0,1,m_sp_arch_4x1_bt_32_r201_cont3_m650,1,medium_bots,5_vs_5_medium
3340,0,0,m_sp_arch_4x1_bt_32_r201_cont3_m650,0,medium_bots,5_vs_5_medium
3341,-3,0,m_sp_arch_4x1_bt_32_r201_cont3_m650,3,medium_bots,5_vs_5_medium
3342,1,2,m_sp_arch_4x1_bt_32_r201_cont3_m650,1,hard_bots,5_vs_5_hard
3343,0,1,m_sp_arch_4x1_bt_32_r201_cont3_m650,1,hard_bots,5_vs_5_hard
3344,-2,0,m_sp_arch_4x1_bt_32_r201_cont3_m650,2,hard_bots,5_vs_5_hard
3345,1,1,m_sp_arch_4x1_bt_32_r201_cont3_m650,0,hard_bots,5_vs_5_hard
3346,-1,1,m_sp_arch_4x1_bt_32_r201_cont3_m650,2,hard_bots,5_vs_5_hard
3347,-2,0,m_sp_arch_4x1_bt_32_r201_cont3_m650,2,hard_bots,5_vs_5_hard
3348,1,2,m_sp_arch_4x1_bt_32_r201_cont3_m650,1,hard_bots,5_vs_5_hard
3349,-2,1,m_sp_arch_4x1_bt_32_r201_cont3_m650,3,hard_bots,5_vs_5_hard
3350,2,3,m_sp_arch_4x1_bt_32_r201_cont3_m650,1,hard_bots,5_vs_5_hard
3351,0,0,m_sp_arch_4x1_bt_32_r201_cont3_m650,0,hard_bots,5_vs_5_hard
3352,11,11,m_sp_arch_4x1_bt_32_r201_cont3_m650,0,f5v0to1to2t05_e2_ckpt291,5_vs_5
3353,13,14,m_sp_arch_4x1_bt_32_r201_cont3_m650,1,f5v0to1to2t05_e2_ckpt291,5_vs_5
3354,9,10,m_sp_arch_4x1_bt_32_r201_cont3_m650,1,f5v0to1to2t05_e2_ckpt291,5_vs_5
3355,7,7,m_sp_arch_4x1_bt_32_r201_cont3_m650,0,f5v0to1to2t05_e2_ckpt291,5_vs_5
3356,9,10,m_sp_arch_4x1_bt_32_r201_cont3_m650,1,f5v0to1to2t05_e2_ckpt291,5_vs_5
3357,6,6,m_sp_arch_4x1_bt_32_r201_cont3_m650,0,f5v0to1to5_e2_ckpt252,5_vs_5
3358,4,4,m_sp_arch_4x1_bt_32_r201_cont3_m650,0,f5v0to1to5_e2_ckpt252,5_vs_5
3359,9,9,m_sp_arch_4x1_bt_32_r201_cont3_m650,0,f5v0to1to5_e2_ckpt252,5_vs_5
3360,5,5,m_sp_arch_4x1_bt_32_r201_cont3_m650,0,f5v0to1to5_e2_ckpt252,5_vs_5
3361,9,9,m_sp_arch_4x1_bt_32_r201_cont3_m650,0,f5v0to1to5_e2_ckpt252,5_vs_5
3362,9,9,m_sp_arch_4x1_bt_32_r201_cont3_m650,0,scon_e3_p2_hard_ckpt840,5_vs_5
3363,8,8,m_sp_arch_4x1_bt_32_r201_cont3_m650,0,scon_e3_p2_hard_ckpt840,5_vs_5
3364,11,11,m_sp_arch_4x1_bt_32_r201_cont3_m650,0,scon_e3_p2_hard_ckpt840,5_vs_5
3365,13,13,m_sp_arch_4x1_bt_32_r201_cont3_m650,0,scon_e3_p2_hard_ckpt840,5_vs_5
3366,12,12,m_sp_arch_4x1_bt_32_r201_cont3_m650,0,scon_e3_p2_hard_ckpt840,5_vs_5
3367,11,11,m_sp_arch_4x1_bt_32_r201_cont3_m650,0,less_then_partially_randomized_checkpoints_bots_4_heads_38_ckpt108,5_vs_5
3368,7,8,m_sp_arch_4x1_bt_32_r201_cont3_m650,1,less_then_partially_randomized_checkpoints_bots_4_heads_38_ckpt108,5_vs_5
3369,9,10,m_sp_arch_4x1_bt_32_r201_cont3_m650,1,less_then_partially_randomized_checkpoints_bots_4_heads_38_ckpt108,5_vs_5
3370,12,12,m_sp_arch_4x1_bt_32_r201_cont3_m650,0,less_then_partially_randomized_checkpoints_bots_4_heads_38_ckpt108,5_vs_5
3371,14,14,m_sp_arch_4x1_bt_32_r201_cont3_m650,0,less_then_partially_randomized_checkpoints_bots_4_heads_38_ckpt108,5_vs_5
3372,9,9,m_sp_arch_4x1_bt_32_r201_cont3_m650,0,less_then_partially_randomized_entropy_checkpoints_bots_4_heads_39_ckpt109,5_vs_5
3373,11,11,m_sp_arch_4x1_bt_32_r201_cont3_m650,0,less_then_partially_randomized_entropy_checkpoints_bots_4_heads_39_ckpt109,5_vs_5
3374,13,13,m_sp_arch_4x1_bt_32_r201_cont3_m650,0,less_then_partially_randomized_entropy_checkpoints_bots_4_heads_39_ckpt109,5_vs_5
3375,12,12,m_sp_arch_4x1_bt_32_r201_cont3_m650,0,less_then_partially_randomized_entropy_checkpoints_bots_4_heads_39_ckpt109,5_vs_5
3376,10,10,m_sp_arch_4x1_bt_32_r201_cont3_m650,0,less_then_partially_randomized_entropy_checkpoints_bots_4_heads_39_ckpt109,5_vs_5
3377,5,5,m_sp_arch_4x1_bt_32_r201_cont3_m650,0,reward_shaping_checkpoints_bots_4_heads_1_ckpt360,5_vs_5
3378,14,14,m_sp_arch_4x1_bt_32_r201_cont3_m650,0,reward_shaping_checkpoints_bots_4_heads_1_ckpt360,5_vs_5
3379,12,12,m_sp_arch_4x1_bt_32_r201_cont3_m650,0,reward_shaping_checkpoints_bots_4_heads_1_ckpt360,5_vs_5
3380,9,9,m_sp_arch_4x1_bt_32_r201_cont3_m650,0,reward_shaping_checkpoints_bots_4_heads_1_ckpt360,5_vs_5
3381,7,7,m_sp_arch_4x1_bt_32_r201_cont3_m650,0,reward_shaping_checkpoints_bots_4_heads_1_ckpt360,5_vs_5
3382,7,8,m_sp_arch_4x1_bt_32_r201_cont3_m650,1,checkpoints_selfplay_e9_sp_ckpt274,5_vs_5
3383,4,5,m_sp_arch_4x1_bt_32_r201_cont3_m650,1,checkpoints_selfplay_e9_sp_ckpt274,5_vs_5
3384,5,7,m_sp_arch_4x1_bt_32_r201_cont3_m650,2,checkpoints_selfplay_e9_sp_ckpt274,5_vs_5
3385,7,7,m_sp_arch_4x1_bt_32_r201_cont3_m650,0,checkpoints_selfplay_e9_sp_ckpt274,5_vs_5
3386,4,6,m_sp_arch_4x1_bt_32_r201_cont3_m650,2,checkpoints_selfplay_e9_sp_ckpt274,5_vs_5
3387,1,3,m_sp_arch_4x1_bt_32_r201_cont3_m650,2,checkpoints_sp_c_nb_e2_ckpt667,5_vs_5
3388,1,2,m_sp_arch_4x1_bt_32_r201_cont3_m650,1,checkpoints_sp_c_nb_e2_ckpt667,5_vs_5
3389,7,7,m_sp_arch_4x1_bt_32_r201_cont3_m650,0,checkpoints_sp_c_nb_e2_ckpt667,5_vs_5
3390,1,4,m_sp_arch_4x1_bt_32_r201_cont3_m650,3,checkpoints_sp_c_nb_e2_ckpt667,5_vs_5
3391,4,4,m_sp_arch_4x1_bt_32_r201_cont3_m650,0,checkpoints_sp_c_nb_e2_ckpt667,5_vs_5
3392,3,3,m_sp_arch_4x1_bt_32_r201_cont3_m650,0,m_sp_arch_medium_heads_conv16_0_bt_32_r313_m335,5_vs_5
3393,2,2,m_sp_arch_4x1_bt_32_r201_cont3_m650,0,m_sp_arch_medium_heads_conv16_0_bt_32_r313_m335,5_vs_5
3394,1,1,m_sp_arch_4x1_bt_32_r201_cont3_m650,0,m_sp_arch_medium_heads_conv16_0_bt_32_r313_m335,5_vs_5
3395,5,5,m_sp_arch_4x1_bt_32_r201_cont3_m650,0,m_sp_arch_medium_heads_conv16_0_bt_32_r313_m335,5_vs_5
3396,6,6,m_sp_arch_4x1_bt_32_r201_cont3_m650,0,m_sp_arch_medium_heads_conv16_0_bt_32_r313_m335,5_vs_5
3397,4,4,m_sp_arch_4x1_bt_32_r201_cont3_m650,0,m_sp_arch_longer_heads_bt_32_r201_m335,5_vs_5
3398,7,7,m_sp_arch_4x1_bt_32_r201_cont3_m650,0,m_sp_arch_longer_heads_bt_32_r201_m335,5_vs_5
3399,8,9,m_sp_arch_4x1_bt_32_r201_cont3_m650,1,m_sp_arch_longer_heads_bt_32_r201_m335,5_vs_5
3400,3,4,m_sp_arch_4x1_bt_32_r201_cont3_m650,1,m_sp_arch_longer_heads_bt_32_r201_m335,5_vs_5
3401,4,6,m_sp_arch_4x1_bt_32_r201_cont3_m650,2,m_sp_arch_longer_heads_bt_32_r201_m335,5_vs_5
3402,5,5,m_sp_arch_4x1_bt_32_r201_cont3_m650,0,m_sp_arch_medium_heads_bt_32_r201_m335,5_vs_5
3403,6,7,m_sp_arch_4x1_bt_32_r201_cont3_m650,1,m_sp_arch_medium_heads_bt_32_r201_m335,5_vs_5
3404,1,2,m_sp_arch_4x1_bt_32_r201_cont3_m650,1,m_sp_arch_medium_heads_bt_32_r201_m335,5_vs_5
3405,3,4,m_sp_arch_4x1_bt_32_r201_cont3_m650,1,m_sp_arch_medium_heads_bt_32_r201_m335,5_vs_5
3406,5,5,m_sp_arch_4x1_bt_32_r201_cont3_m650,0,m_sp_arch_medium_heads_bt_32_r201_m335,5_vs_5
3407,-1,2,m_sp_arch_4x1_bt_32_r201_cont3_m650,3,m_sp_arch_4x1_bt_32_r201_m335,5_vs_5
3408,3,3,m_sp_arch_4x1_bt_32_r201_cont3_m650,0,m_sp_arch_4x1_bt_32_r201_m335,5_vs_5
3409,1,1,m_sp_arch_4x1_bt_32_r201_cont3_m650,0,m_sp_arch_4x1_bt_32_r201_m335,5_vs_5
3410,0,2,m_sp_arch_4x1_bt_32_r201_cont3_m650,2,m_sp_arch_4x1_bt_32_r201_m335,5_vs_5
3411,1,2,m_sp_arch_4x1_bt_32_r201_cont3_m650,1,m_sp_arch_4x1_bt_32_r201_m335,5_vs_5
3412,1,1,m_sp_arch_4x1_bt_32_r201_cont3_m650,0,m_sp_arch_4x1_bt_32_r201_cont3_m650,5_vs_5
3413,0,1,m_sp_arch_4x1_bt_32_r201_cont3_m650,1,m_sp_arch_4x1_bt_32_r201_cont3_m650,5_vs_5
3414,1,1,m_sp_arch_4x1_bt_32_r201_cont3_m650,0,m_sp_arch_4x1_bt_32_r201_cont3_m650,5_vs_5
3415,0,1,m_sp_arch_4x1_bt_32_r201_cont3_m650,1,m_sp_arch_4x1_bt_32_r201_cont3_m650,5_vs_5
3416,1,1,m_sp_arch_4x1_bt_32_r201_cont3_m650,0,m_sp_arch_4x1_bt_32_r201_cont3_m650,5_vs_5
3417,-5,0,m_sp_arch_4x1_bt_32_r201_cont3_m650,5,explt_v0_7_2_m54,5_vs_5
3418,-3,0,m_sp_arch_4x1_bt_32_r201_cont3_m650,3,explt_v0_7_2_m54,5_vs_5
3419,-2,1,m_sp_arch_4x1_bt_32_r201_cont3_m650,3,explt_v0_7_2_m54,5_vs_5
3420,1,2,m_sp_arch_4x1_bt_32_r201_cont3_m650,1,explt_v0_7_2_m54,5_vs_5
3421,1,3,m_sp_arch_4x1_bt_32_r201_cont3_m650,2,explt_v0_7_2_m54,5_vs_5
3422,2,3,m_sp_arch_4x1_bt_32_r201_cont3_m650,1,m_sp_sc3v3_arch_2x1_32_r500_cont4x1_m224,5_vs_5
3423,2,4,m_sp_arch_4x1_bt_32_r201_cont3_m650,2,m_sp_sc3v3_arch_2x1_32_r500_cont4x1_m224,5_vs_5
3424,2,4,m_sp_arch_4x1_bt_32_r201_cont3_m650,2,m_sp_sc3v3_arch_2x1_32_r500_cont4x1_m224,5_vs_5
3425,0,1,m_sp_arch_4x1_bt_32_r201_cont3_m650,1,m_sp_sc3v3_arch_2x1_32_r500_cont4x1_m224,5_vs_5
3426,0,4,m_sp_arch_4x1_bt_32_r201_cont3_m650,4,m_sp_sc3v3_arch_2x1_32_r500_cont4x1_m224,5_vs_5
3427,-1,1,m_sp_arch_4x1_bt_32_r201_cont3_m650,2,m_sp_arch_4x1_bt_32_roles_r500_m335,5_vs_5
3428,4,4,m_sp_arch_4x1_bt_32_r201_cont3_m650,0,m_sp_arch_4x1_bt_32_roles_r500_m335,5_vs_5
3429,0,1,m_sp_arch_4x1_bt_32_r201_cont3_m650,1,m_sp_arch_4x1_bt_32_roles_r500_m335,5_vs_5
3430,-2,1,m_sp_arch_4x1_bt_32_r201_cont3_m650,3,m_sp_arch_4x1_bt_32_roles_r500_m335,5_vs_5
3431,1,2,m_sp_arch_4x1_bt_32_r201_cont3_m650,1,m_sp_arch_4x1_bt_32_roles_r500_m335,5_vs_5
3432,15,16,less_then_partially_randomized_entropy_checkpoints_bots_4_heads_39_ckpt109,1,easy_bots,5_vs_5
3433,4,7,less_then_partially_randomized_entropy_checkpoints_bots_4_heads_39_ckpt109,3,easy_bots,5_vs_5
3434,16,16,less_then_partially_randomized_entropy_checkpoints_bots_4_heads_39_ckpt109,0,easy_bots,5_vs_5
3435,13,14,less_then_partially_randomized_entropy_checkpoints_bots_4_heads_39_ckpt109,1,easy_bots,5_vs_5
3436,8,10,less_then_partially_randomized_entropy_checkpoints_bots_4_heads_39_ckpt109,2,medium_bots,5_vs_5_medium
3437,9,10,less_then_partially_randomized_entropy_checkpoints_bots_4_heads_39_ckpt109,1,medium_bots,5_vs_5_medium
3438,8,10,less_then_partially_randomized_entropy_checkpoints_bots_4_heads_39_ckpt109,2,medium_bots,5_vs_5_medium
3439,7,7,less_then_partially_randomized_entropy_checkpoints_bots_4_heads_39_ckpt109,0,medium_bots,5_vs_5_medium
3440,3,5,less_then_partially_randomized_entropy_checkpoints_bots_4_heads_39_ckpt109,2,hard_bots,5_vs_5_hard
3441,6,9,less_then_partially_randomized_entropy_checkpoints_bots_4_heads_39_ckpt109,3,hard_bots,5_vs_5_hard
3442,2,5,less_then_partially_randomized_entropy_checkpoints_bots_4_heads_39_ckpt109,3,hard_bots,5_vs_5_hard
3443,0,2,less_then_partially_randomized_entropy_checkpoints_bots_4_heads_39_ckpt109,2,hard_bots,5_vs_5_hard
3444,4,8,less_then_partially_randomized_entropy_checkpoints_bots_4_heads_39_ckpt109,4,f5v0to1to2t05_e2_ckpt291,5_vs_5
3445,-1,4,less_then_partially_randomized_entropy_checkpoints_bots_4_heads_39_ckpt109,5,f5v0to1to2t05_e2_ckpt291,5_vs_5
3446,2,3,less_then_partially_randomized_entropy_checkpoints_bots_4_heads_39_ckpt109,1,f5v0to1to5_e2_ckpt252,5_vs_5
3447,-1,2,less_then_partially_randomized_entropy_checkpoints_bots_4_heads_39_ckpt109,3,f5v0to1to5_e2_ckpt252,5_vs_5
3448,4,6,less_then_partially_randomized_entropy_checkpoints_bots_4_heads_39_ckpt109,2,scon_e3_p2_hard_ckpt840,5_vs_5
3449,3,6,less_then_partially_randomized_entropy_checkpoints_bots_4_heads_39_ckpt109,3,scon_e3_p2_hard_ckpt840,5_vs_5
3450,-3,4,less_then_partially_randomized_entropy_checkpoints_bots_4_heads_39_ckpt109,7,less_then_partially_randomized_checkpoints_bots_4_heads_38_ckpt108,5_vs_5
3451,1,5,less_then_partially_randomized_entropy_checkpoints_bots_4_heads_39_ckpt109,4,less_then_partially_randomized_checkpoints_bots_4_heads_38_ckpt108,5_vs_5
3452,3,5,less_then_partially_randomized_entropy_checkpoints_bots_4_heads_39_ckpt109,2,less_then_partially_randomized_entropy_checkpoints_bots_4_heads_39_ckpt109,5_vs_5
3453,-4,1,less_then_partially_randomized_entropy_checkpoints_bots_4_heads_39_ckpt109,5,less_then_partially_randomized_entropy_checkpoints_bots_4_heads_39_ckpt109,5_vs_5
3454,3,5,less_then_partially_randomized_entropy_checkpoints_bots_4_heads_39_ckpt109,2,reward_shaping_checkpoints_bots_4_heads_1_ckpt360,5_vs_5
3455,-1,4,less_then_partially_randomized_entropy_checkpoints_bots_4_heads_39_ckpt109,5,reward_shaping_checkpoints_bots_4_heads_1_ckpt360,5_vs_5
3456,-7,1,less_then_partially_randomized_entropy_checkpoints_bots_4_heads_39_ckpt109,8,checkpoints_selfplay_e9_sp_ckpt274,5_vs_5
3457,-8,1,less_then_partially_randomized_entropy_checkpoints_bots_4_heads_39_ckpt109,9,checkpoints_selfplay_e9_sp_ckpt274,5_vs_5
3458,-7,0,less_then_partially_randomized_entropy_checkpoints_bots_4_heads_39_ckpt109,7,checkpoints_sp_c_nb_e2_ckpt667,5_vs_5
3459,-7,1,less_then_partially_randomized_entropy_checkpoints_bots_4_heads_39_ckpt109,8,checkpoints_sp_c_nb_e2_ckpt667,5_vs_5
3460,0,4,less_then_partially_randomized_entropy_checkpoints_bots_4_heads_39_ckpt109,4,m_sp_arch_medium_heads_conv16_0_bt_32_r313_m335,5_vs_5
3461,-5,2,less_then_partially_randomized_entropy_checkpoints_bots_4_heads_39_ckpt109,7,m_sp_arch_medium_heads_conv16_0_bt_32_r313_m335,5_vs_5
3462,-4,0,less_then_partially_randomized_entropy_checkpoints_bots_4_heads_39_ckpt109,4,m_sp_arch_longer_heads_bt_32_r201_m335,5_vs_5
3463,-5,1,less_then_partially_randomized_entropy_checkpoints_bots_4_heads_39_ckpt109,6,m_sp_arch_longer_heads_bt_32_r201_m335,5_vs_5
3464,-7,1,less_then_partially_randomized_entropy_checkpoints_bots_4_heads_39_ckpt109,8,m_sp_arch_medium_heads_bt_32_r201_m335,5_vs_5
3465,-9,1,less_then_partially_randomized_entropy_checkpoints_bots_4_heads_39_ckpt109,10,m_sp_arch_medium_heads_bt_32_r201_m335,5_vs_5
3466,-10,0,less_then_partially_randomized_entropy_checkpoints_bots_4_heads_39_ckpt109,10,m_sp_arch_4x1_bt_32_r201_m335,5_vs_5
3467,-13,0,less_then_partially_randomized_entropy_checkpoints_bots_4_heads_39_ckpt109,13,m_sp_arch_4x1_bt_32_r201_m335,5_vs_5
3468,-7,0,less_then_partially_randomized_entropy_checkpoints_bots_4_heads_39_ckpt109,7,m_sp_arch_4x1_bt_32_r201_cont3_m650,5_vs_5
3469,-12,0,less_then_partially_randomized_entropy_checkpoints_bots_4_heads_39_ckpt109,12,m_sp_arch_4x1_bt_32_r201_cont3_m650,5_vs_5
3470,-1,0,less_then_partially_randomized_entropy_checkpoints_bots_4_heads_39_ckpt109,1,explt_v0_7_2_m54,5_vs_5
3471,-4,0,less_then_partially_randomized_entropy_checkpoints_bots_4_heads_39_ckpt109,4,explt_v0_7_2_m54,5_vs_5
3472,-14,0,less_then_partially_randomized_entropy_checkpoints_bots_4_heads_39_ckpt109,14,m_sp_sc3v3_arch_2x1_32_r500_cont4x1_m224,5_vs_5
3473,-13,0,less_then_partially_randomized_entropy_checkpoints_bots_4_heads_39_ckpt109,13,m_sp_sc3v3_arch_2x1_32_r500_cont4x1_m224,5_vs_5
3474,-9,0,less_then_partially_randomized_entropy_checkpoints_bots_4_heads_39_ckpt109,9,m_sp_arch_4x1_bt_32_roles_r500_m335,5_vs_5
3475,-12,0,less_then_partially_randomized_entropy_checkpoints_bots_4_heads_39_ckpt109,12,m_sp_arch_4x1_bt_32_roles_r500_m335,5_vs_5
3476,10,10,f5v0to1to2t05_e2_ckpt291,0,easy_bots,5_vs_5
3477,9,9,f5v0to1to2t05_e2_ckpt291,0,easy_bots,5_vs_5
3478,9,10,f5v0to1to2t05_e2_ckpt291,1,easy_bots,5_vs_5
3479,8,8,f5v0to1to2t05_e2_ckpt291,0,easy_bots,5_vs_5
3480,9,9,f5v0to1to2t05_e2_ckpt291,0,medium_bots,5_vs_5_medium
3481,10,10,f5v0to1to2t05_e2_ckpt291,0,medium_bots,5_vs_5_medium
3482,4,6,f5v0to1to2t05_e2_ckpt291,2,medium_bots,5_vs_5_medium
3483,7,9,f5v0to1to2t05_e2_ckpt291,2,medium_bots,5_vs_5_medium
3484,7,7,f5v0to1to2t05_e2_ckpt291,0,hard_bots,5_vs_5_hard
3485,4,5,f5v0to1to2t05_e2_ckpt291,1,hard_bots,5_vs_5_hard
3486,2,5,f5v0to1to2t05_e2_ckpt291,3,hard_bots,5_vs_5_hard
3487,5,7,f5v0to1to2t05_e2_ckpt291,2,hard_bots,5_vs_5_hard
3488,2,3,f5v0to1to2t05_e2_ckpt291,1,f5v0to1to2t05_e2_ckpt291,5_vs_5
3489,-2,5,f5v0to1to2t05_e2_ckpt291,7,f5v0to1to2t05_e2_ckpt291,5_vs_5
3490,-5,1,f5v0to1to2t05_e2_ckpt291,6,f5v0to1to5_e2_ckpt252,5_vs_5
3491,1,5,f5v0to1to2t05_e2_ckpt291,4,f5v0to1to5_e2_ckpt252,5_vs_5
3492,8,8,f5v0to1to2t05_e2_ckpt291,0,scon_e3_p2_hard_ckpt840,5_vs_5
3493,3,3,f5v0to1to2t05_e2_ckpt291,0,scon_e3_p2_hard_ckpt840,5_vs_5
3494,4,4,f5v0to1to2t05_e2_ckpt291,0,less_then_partially_randomized_checkpoints_bots_4_heads_38_ckpt108,5_vs_5
3495,-1,1,f5v0to1to2t05_e2_ckpt291,2,less_then_partially_randomized_checkpoints_bots_4_heads_38_ckpt108,5_vs_5
3496,4,5,f5v0to1to2t05_e2_ckpt291,1,less_then_partially_randomized_entropy_checkpoints_bots_4_heads_39_ckpt109,5_vs_5
3497,0,5,f5v0to1to2t05_e2_ckpt291,5,less_then_partially_randomized_entropy_checkpoints_bots_4_heads_39_ckpt109,5_vs_5
3498,1,6,f5v0to1to2t05_e2_ckpt291,5,reward_shaping_checkpoints_bots_4_heads_1_ckpt360,5_vs_5
3499,2,4,f5v0to1to2t05_e2_ckpt291,2,reward_shaping_checkpoints_bots_4_heads_1_ckpt360,5_vs_5
3500,-5,1,f5v0to1to2t05_e2_ckpt291,6,checkpoints_selfplay_e9_sp_ckpt274,5_vs_5
3501,-6,1,f5v0to1to2t05_e2_ckpt291,7,checkpoints_selfplay_e9_sp_ckpt274,5_vs_5
3502,-4,0,f5v0to1to2t05_e2_ckpt291,4,checkpoints_sp_c_nb_e2_ckpt667,5_vs_5
3503,-2,0,f5v0to1to2t05_e2_ckpt291,2,checkpoints_sp_c_nb_e2_ckpt667,5_vs_5
3504,-3,2,f5v0to1to2t05_e2_ckpt291,5,m_sp_arch_medium_heads_conv16_0_bt_32_r313_m335,5_vs_5
3505,-3,1,f5v0to1to2t05_e2_ckpt291,4,m_sp_arch_medium_heads_conv16_0_bt_32_r313_m335,5_vs_5
3506,-3,2,f5v0to1to2t05_e2_ckpt291,5,m_sp_arch_longer_heads_bt_32_r201_m335,5_vs_5
3507,-4,0,f5v0to1to2t05_e2_ckpt291,4,m_sp_arch_longer_heads_bt_32_r201_m335,5_vs_5
3508,-2,2,f5v0to1to2t05_e2_ckpt291,4,m_sp_arch_medium_heads_bt_32_r201_m335,5_vs_5
3509,-7,0,f5v0to1to2t05_e2_ckpt291,7,m_sp_arch_medium_heads_bt_32_r201_m335,5_vs_5
3510,-8,1,f5v0to1to2t05_e2_ckpt291,9,m_sp_arch_4x1_bt_32_r201_m335,5_vs_5
3511,-9,0,f5v0to1to2t05_e2_ckpt291,9,m_sp_arch_4x1_bt_32_r201_m335,5_vs_5
3512,-10,0,f5v0to1to2t05_e2_ckpt291,10,m_sp_arch_4x1_bt_32_r201_cont3_m650,5_vs_5
3513,-11,0,f5v0to1to2t05_e2_ckpt291,11,m_sp_arch_4x1_bt_32_r201_cont3_m650,5_vs_5
3514,-1,1,f5v0to1to2t05_e2_ckpt291,2,explt_v0_7_2_m54,5_vs_5
3515,-2,0,f5v0to1to2t05_e2_ckpt291,2,explt_v0_7_2_m54,5_vs_5
3516,-10,2,f5v0to1to2t05_e2_ckpt291,12,m_sp_sc3v3_arch_2x1_32_r500_cont4x1_m224,5_vs_5
3517,-10,0,f5v0to1to2t05_e2_ckpt291,10,m_sp_sc3v3_arch_2x1_32_r500_cont4x1_m224,5_vs_5
3518,-8,3,f5v0to1to2t05_e2_ckpt291,11,m_sp_arch_4x1_bt_32_roles_r500_m335,5_vs_5
3519,-12,0,f5v0to1to2t05_e2_ckpt291,12,m_sp_arch_4x1_bt_32_roles_r500_m335,5_vs_5
