,left_minus_right_scores,left_scores,left_team,right_scores,right_team,scenario
0,4,6,checkpoints_selfplay_e9_sp_ckpt274,2,easy_bots,5_vs_5
1,0,4,checkpoints_selfplay_e9_sp_ckpt274,4,easy_bots,5_vs_5
2,-1,1,checkpoints_selfplay_e9_sp_ckpt274,2,easy_bots,5_vs_5
3,1,2,checkpoints_selfplay_e9_sp_ckpt274,1,easy_bots,5_vs_5
4,1,2,checkpoints_selfplay_e9_sp_ckpt274,1,easy_bots,5_vs_5
5,2,2,checkpoints_selfplay_e9_sp_ckpt274,0,easy_bots,5_vs_5
6,-3,0,checkpoints_selfplay_e9_sp_ckpt274,3,easy_bots,5_vs_5
7,0,5,checkpoints_selfplay_e9_sp_ckpt274,5,easy_bots,5_vs_5
8,0,4,checkpoints_selfplay_e9_sp_ckpt274,4,easy_bots,5_vs_5
9,0,1,checkpoints_selfplay_e9_sp_ckpt274,1,easy_bots,5_vs_5
10,2,4,checkpoints_selfplay_e9_sp_ckpt274,2,easy_bots,5_vs_5
11,2,2,checkpoints_selfplay_e9_sp_ckpt274,0,easy_bots,5_vs_5
12,3,5,checkpoints_selfplay_e9_sp_ckpt274,2,easy_bots,5_vs_5
13,0,0,checkpoints_selfplay_e9_sp_ckpt274,0,easy_bots,5_vs_5
14,2,3,checkpoints_selfplay_e9_sp_ckpt274,1,easy_bots,5_vs_5
15,2,4,checkpoints_selfplay_e9_sp_ckpt274,2,easy_bots,5_vs_5
16,2,3,checkpoints_selfplay_e9_sp_ckpt274,1,easy_bots,5_vs_5
17,3,3,checkpoints_selfplay_e9_sp_ckpt274,0,easy_bots,5_vs_5
18,-1,1,checkpoints_selfplay_e9_sp_ckpt274,2,easy_bots,5_vs_5
19,1,1,checkpoints_selfplay_e9_sp_ckpt274,0,easy_bots,5_vs_5
20,0,4,checkpoints_selfplay_e9_sp_ckpt274,4,medium_bots,5_vs_5_medium
21,-3,1,checkpoints_selfplay_e9_sp_ckpt274,4,medium_bots,5_vs_5_medium
22,0,2,checkpoints_selfplay_e9_sp_ckpt274,2,medium_bots,5_vs_5_medium
23,1,3,checkpoints_selfplay_e9_sp_ckpt274,2,medium_bots,5_vs_5_medium
24,1,3,checkpoints_selfplay_e9_sp_ckpt274,2,medium_bots,5_vs_5_medium
25,0,1,checkpoints_selfplay_e9_sp_ckpt274,1,medium_bots,5_vs_5_medium
26,0,4,checkpoints_selfplay_e9_sp_ckpt274,4,medium_bots,5_vs_5_medium
27,-2,2,checkpoints_selfplay_e9_sp_ckpt274,4,medium_bots,5_vs_5_medium
28,-1,2,checkpoints_selfplay_e9_sp_ckpt274,3,medium_bots,5_vs_5_medium
29,1,2,checkpoints_selfplay_e9_sp_ckpt274,1,medium_bots,5_vs_5_medium
30,-1,1,checkpoints_selfplay_e9_sp_ckpt274,2,medium_bots,5_vs_5_medium
31,-2,0,checkpoints_selfplay_e9_sp_ckpt274,2,medium_bots,5_vs_5_medium
32,1,3,checkpoints_selfplay_e9_sp_ckpt274,2,medium_bots,5_vs_5_medium
33,-2,1,checkpoints_selfplay_e9_sp_ckpt274,3,medium_bots,5_vs_5_medium
34,-3,2,checkpoints_selfplay_e9_sp_ckpt274,5,medium_bots,5_vs_5_medium
35,-1,0,checkpoints_selfplay_e9_sp_ckpt274,1,medium_bots,5_vs_5_medium
36,1,3,checkpoints_selfplay_e9_sp_ckpt274,2,medium_bots,5_vs_5_medium
37,1,3,checkpoints_selfplay_e9_sp_ckpt274,2,medium_bots,5_vs_5_medium
38,-1,1,checkpoints_selfplay_e9_sp_ckpt274,2,medium_bots,5_vs_5_medium
39,0,3,checkpoints_selfplay_e9_sp_ckpt274,3,medium_bots,5_vs_5_medium
40,-2,1,checkpoints_selfplay_e9_sp_ckpt274,3,hard_bots,5_vs_5_hard
41,-2,0,checkpoints_selfplay_e9_sp_ckpt274,2,hard_bots,5_vs_5_hard
42,-3,1,checkpoints_selfplay_e9_sp_ckpt274,4,hard_bots,5_vs_5_hard
43,1,3,checkpoints_selfplay_e9_sp_ckpt274,2,hard_bots,5_vs_5_hard
44,-2,1,checkpoints_selfplay_e9_sp_ckpt274,3,hard_bots,5_vs_5_hard
45,-1,0,checkpoints_selfplay_e9_sp_ckpt274,1,hard_bots,5_vs_5_hard
46,0,1,checkpoints_selfplay_e9_sp_ckpt274,1,hard_bots,5_vs_5_hard
47,0,3,checkpoints_selfplay_e9_sp_ckpt274,3,hard_bots,5_vs_5_hard
48,-2,0,checkpoints_selfplay_e9_sp_ckpt274,2,hard_bots,5_vs_5_hard
49,0,2,checkpoints_selfplay_e9_sp_ckpt274,2,hard_bots,5_vs_5_hard
50,-1,1,checkpoints_selfplay_e9_sp_ckpt274,2,hard_bots,5_vs_5_hard
51,1,1,checkpoints_selfplay_e9_sp_ckpt274,0,hard_bots,5_vs_5_hard
52,-1,1,checkpoints_selfplay_e9_sp_ckpt274,2,hard_bots,5_vs_5_hard
53,-3,0,checkpoints_selfplay_e9_sp_ckpt274,3,hard_bots,5_vs_5_hard
54,0,4,checkpoints_selfplay_e9_sp_ckpt274,4,hard_bots,5_vs_5_hard
55,-2,2,checkpoints_selfplay_e9_sp_ckpt274,4,hard_bots,5_vs_5_hard
56,-2,1,checkpoints_selfplay_e9_sp_ckpt274,3,hard_bots,5_vs_5_hard
57,-1,0,checkpoints_selfplay_e9_sp_ckpt274,1,hard_bots,5_vs_5_hard
58,-3,0,checkpoints_selfplay_e9_sp_ckpt274,3,hard_bots,5_vs_5_hard
59,-3,1,checkpoints_selfplay_e9_sp_ckpt274,4,hard_bots,5_vs_5_hard
60,11,14,checkpoints_selfplay_e9_sp_ckpt274,3,f5v0to1to2t05_e2_ckpt291,5_vs_5
61,6,8,checkpoints_selfplay_e9_sp_ckpt274,2,f5v0to1to2t05_e2_ckpt291,5_vs_5
62,6,8,checkpoints_selfplay_e9_sp_ckpt274,2,f5v0to1to2t05_e2_ckpt291,5_vs_5
63,7,10,checkpoints_selfplay_e9_sp_ckpt274,3,f5v0to1to2t05_e2_ckpt291,5_vs_5
64,5,8,checkpoints_selfplay_e9_sp_ckpt274,3,f5v0to1to2t05_e2_ckpt291,5_vs_5
65,9,10,checkpoints_selfplay_e9_sp_ckpt274,1,f5v0to1to2t05_e2_ckpt291,5_vs_5
66,12,13,checkpoints_selfplay_e9_sp_ckpt274,1,f5v0to1to2t05_e2_ckpt291,5_vs_5
67,7,8,checkpoints_selfplay_e9_sp_ckpt274,1,f5v0to1to2t05_e2_ckpt291,5_vs_5
68,11,12,checkpoints_selfplay_e9_sp_ckpt274,1,f5v0to1to2t05_e2_ckpt291,5_vs_5
69,8,10,checkpoints_selfplay_e9_sp_ckpt274,2,f5v0to1to2t05_e2_ckpt291,5_vs_5
70,10,11,checkpoints_selfplay_e9_sp_ckpt274,1,f5v0to1to5_e2_ckpt252,5_vs_5
71,7,9,checkpoints_selfplay_e9_sp_ckpt274,2,f5v0to1to5_e2_ckpt252,5_vs_5
72,-2,3,checkpoints_selfplay_e9_sp_ckpt274,5,f5v0to1to5_e2_ckpt252,5_vs_5
73,4,6,checkpoints_selfplay_e9_sp_ckpt274,2,f5v0to1to5_e2_ckpt252,5_vs_5
74,10,13,checkpoints_selfplay_e9_sp_ckpt274,3,f5v0to1to5_e2_ckpt252,5_vs_5
75,5,6,checkpoints_selfplay_e9_sp_ckpt274,1,f5v0to1to5_e2_ckpt252,5_vs_5
76,6,10,checkpoints_selfplay_e9_sp_ckpt274,4,f5v0to1to5_e2_ckpt252,5_vs_5
77,6,10,checkpoints_selfplay_e9_sp_ckpt274,4,f5v0to1to5_e2_ckpt252,5_vs_5
78,6,8,checkpoints_selfplay_e9_sp_ckpt274,2,f5v0to1to5_e2_ckpt252,5_vs_5
79,0,4,checkpoints_selfplay_e9_sp_ckpt274,4,f5v0to1to5_e2_ckpt252,5_vs_5
80,8,9,checkpoints_selfplay_e9_sp_ckpt274,1,scon_e3_p2_hard_ckpt840,5_vs_5
81,8,9,checkpoints_selfplay_e9_sp_ckpt274,1,scon_e3_p2_hard_ckpt840,5_vs_5
82,10,12,checkpoints_selfplay_e9_sp_ckpt274,2,scon_e3_p2_hard_ckpt840,5_vs_5
83,9,9,checkpoints_selfplay_e9_sp_ckpt274,0,scon_e3_p2_hard_ckpt840,5_vs_5
84,5,8,checkpoints_selfplay_e9_sp_ckpt274,3,scon_e3_p2_hard_ckpt840,5_vs_5
85,6,8,checkpoints_selfplay_e9_sp_ckpt274,2,scon_e3_p2_hard_ckpt840,5_vs_5
86,6,8,checkpoints_selfplay_e9_sp_ckpt274,2,scon_e3_p2_hard_ckpt840,5_vs_5
87,3,6,checkpoints_selfplay_e9_sp_ckpt274,3,scon_e3_p2_hard_ckpt840,5_vs_5
88,8,9,checkpoints_selfplay_e9_sp_ckpt274,1,scon_e3_p2_hard_ckpt840,5_vs_5
89,4,5,checkpoints_selfplay_e9_sp_ckpt274,1,scon_e3_p2_hard_ckpt840,5_vs_5
90,8,9,checkpoints_selfplay_e9_sp_ckpt274,1,less_then_partially_randomized_checkpoints_bots_4_heads_38_ckpt108,5_vs_5
91,6,8,checkpoints_selfplay_e9_sp_ckpt274,2,less_then_partially_randomized_checkpoints_bots_4_heads_38_ckpt108,5_vs_5
92,12,14,checkpoints_selfplay_e9_sp_ckpt274,2,less_then_partially_randomized_checkpoints_bots_4_heads_38_ckpt108,5_vs_5
93,3,4,checkpoints_selfplay_e9_sp_ckpt274,1,less_then_partially_randomized_checkpoints_bots_4_heads_38_ckpt108,5_vs_5
94,12,12,checkpoints_selfplay_e9_sp_ckpt274,0,less_then_partially_randomized_checkpoints_bots_4_heads_38_ckpt108,5_vs_5
95,7,10,checkpoints_selfplay_e9_sp_ckpt274,3,less_then_partially_randomized_checkpoints_bots_4_heads_38_ckpt108,5_vs_5
96,6,9,checkpoints_selfplay_e9_sp_ckpt274,3,less_then_partially_randomized_checkpoints_bots_4_heads_38_ckpt108,5_vs_5
97,7,9,checkpoints_selfplay_e9_sp_ckpt274,2,less_then_partially_randomized_checkpoints_bots_4_heads_38_ckpt108,5_vs_5
98,3,4,checkpoints_selfplay_e9_sp_ckpt274,1,less_then_partially_randomized_checkpoints_bots_4_heads_38_ckpt108,5_vs_5
99,7,11,checkpoints_selfplay_e9_sp_ckpt274,4,less_then_partially_randomized_checkpoints_bots_4_heads_38_ckpt108,5_vs_5
100,6,8,checkpoints_selfplay_e9_sp_ckpt274,2,less_then_partially_randomized_entropy_checkpoints_bots_4_heads_39_ckpt109,5_vs_5
101,9,12,checkpoints_selfplay_e9_sp_ckpt274,3,less_then_partially_randomized_entropy_checkpoints_bots_4_heads_39_ckpt109,5_vs_5
102,8,9,checkpoints_selfplay_e9_sp_ckpt274,1,less_then_partially_randomized_entropy_checkpoints_bots_4_heads_39_ckpt109,5_vs_5
103,2,6,checkpoints_selfplay_e9_sp_ckpt274,4,less_then_partially_randomized_entropy_checkpoints_bots_4_heads_39_ckpt109,5_vs_5
104,2,2,checkpoints_selfplay_e9_sp_ckpt274,0,less_then_partially_randomized_entropy_checkpoints_bots_4_heads_39_ckpt109,5_vs_5
105,9,9,checkpoints_selfplay_e9_sp_ckpt274,0,less_then_partially_randomized_entropy_checkpoints_bots_4_heads_39_ckpt109,5_vs_5
106,7,9,checkpoints_selfplay_e9_sp_ckpt274,2,less_then_partially_randomized_entropy_checkpoints_bots_4_heads_39_ckpt109,5_vs_5
107,5,8,checkpoints_selfplay_e9_sp_ckpt274,3,less_then_partially_randomized_entropy_checkpoints_bots_4_heads_39_ckpt109,5_vs_5
108,11,11,checkpoints_selfplay_e9_sp_ckpt274,0,less_then_partially_randomized_entropy_checkpoints_bots_4_heads_39_ckpt109,5_vs_5
109,6,8,checkpoints_selfplay_e9_sp_ckpt274,2,less_then_partially_randomized_entropy_checkpoints_bots_4_heads_39_ckpt109,5_vs_5
110,13,15,checkpoints_selfplay_e9_sp_ckpt274,2,reward_shaping_checkpoints_bots_4_heads_1_ckpt360,5_vs_5
111,6,9,checkpoints_selfplay_e9_sp_ckpt274,3,reward_shaping_checkpoints_bots_4_heads_1_ckpt360,5_vs_5
112,13,15,checkpoints_selfplay_e9_sp_ckpt274,2,reward_shaping_checkpoints_bots_4_heads_1_ckpt360,5_vs_5
113,8,10,checkpoints_selfplay_e9_sp_ckpt274,2,reward_shaping_checkpoints_bots_4_heads_1_ckpt360,5_vs_5
114,10,10,checkpoints_selfplay_e9_sp_ckpt274,0,reward_shaping_checkpoints_bots_4_heads_1_ckpt360,5_vs_5
115,6,7,checkpoints_selfplay_e9_sp_ckpt274,1,reward_shaping_checkpoints_bots_4_heads_1_ckpt360,5_vs_5
116,10,10,checkpoints_selfplay_e9_sp_ckpt274,0,reward_shaping_checkpoints_bots_4_heads_1_ckpt360,5_vs_5
117,11,11,checkpoints_selfplay_e9_sp_ckpt274,0,reward_shaping_checkpoints_bots_4_heads_1_ckpt360,5_vs_5
118,10,11,checkpoints_selfplay_e9_sp_ckpt274,1,reward_shaping_checkpoints_bots_4_heads_1_ckpt360,5_vs_5
119,7,10,checkpoints_selfplay_e9_sp_ckpt274,3,reward_shaping_checkpoints_bots_4_heads_1_ckpt360,5_vs_5
120,-4,2,checkpoints_selfplay_e9_sp_ckpt274,6,checkpoints_selfplay_e9_sp_ckpt274,5_vs_5
121,4,8,checkpoints_selfplay_e9_sp_ckpt274,4,checkpoints_selfplay_e9_sp_ckpt274,5_vs_5
122,0,4,checkpoints_selfplay_e9_sp_ckpt274,4,checkpoints_selfplay_e9_sp_ckpt274,5_vs_5
123,3,5,checkpoints_selfplay_e9_sp_ckpt274,2,checkpoints_selfplay_e9_sp_ckpt274,5_vs_5
124,1,4,checkpoints_selfplay_e9_sp_ckpt274,3,checkpoints_selfplay_e9_sp_ckpt274,5_vs_5
125,-2,5,checkpoints_selfplay_e9_sp_ckpt274,7,checkpoints_selfplay_e9_sp_ckpt274,5_vs_5
126,0,4,checkpoints_selfplay_e9_sp_ckpt274,4,checkpoints_selfplay_e9_sp_ckpt274,5_vs_5
127,-4,4,checkpoints_selfplay_e9_sp_ckpt274,8,checkpoints_selfplay_e9_sp_ckpt274,5_vs_5
128,6,8,checkpoints_selfplay_e9_sp_ckpt274,2,checkpoints_selfplay_e9_sp_ckpt274,5_vs_5
129,1,5,checkpoints_selfplay_e9_sp_ckpt274,4,checkpoints_selfplay_e9_sp_ckpt274,5_vs_5
130,-1,2,checkpoints_selfplay_e9_sp_ckpt274,3,checkpoints_sp_c_nb_e2_ckpt667,5_vs_5
131,-5,4,checkpoints_selfplay_e9_sp_ckpt274,9,checkpoints_sp_c_nb_e2_ckpt667,5_vs_5
132,-6,0,checkpoints_selfplay_e9_sp_ckpt274,6,checkpoints_sp_c_nb_e2_ckpt667,5_vs_5
133,-7,3,checkpoints_selfplay_e9_sp_ckpt274,10,checkpoints_sp_c_nb_e2_ckpt667,5_vs_5
134,-3,1,checkpoints_selfplay_e9_sp_ckpt274,4,checkpoints_sp_c_nb_e2_ckpt667,5_vs_5
135,-6,1,checkpoints_selfplay_e9_sp_ckpt274,7,checkpoints_sp_c_nb_e2_ckpt667,5_vs_5
136,-6,1,checkpoints_selfplay_e9_sp_ckpt274,7,checkpoints_sp_c_nb_e2_ckpt667,5_vs_5
137,-4,1,checkpoints_selfplay_e9_sp_ckpt274,5,checkpoints_sp_c_nb_e2_ckpt667,5_vs_5
138,-5,3,checkpoints_selfplay_e9_sp_ckpt274,8,checkpoints_sp_c_nb_e2_ckpt667,5_vs_5
139,-5,3,checkpoints_selfplay_e9_sp_ckpt274,8,checkpoints_sp_c_nb_e2_ckpt667,5_vs_5
140,11,11,checkpoints_selfplay_e9_sp_ckpt274,0,scenario_curriculum_ckpt830,5_vs_5
141,4,4,checkpoints_selfplay_e9_sp_ckpt274,0,scenario_curriculum_ckpt830,5_vs_5
142,9,9,checkpoints_selfplay_e9_sp_ckpt274,0,scenario_curriculum_ckpt830,5_vs_5
143,11,11,checkpoints_selfplay_e9_sp_ckpt274,0,scenario_curriculum_ckpt830,5_vs_5
144,10,10,checkpoints_selfplay_e9_sp_ckpt274,0,scenario_curriculum_ckpt830,5_vs_5
145,10,10,checkpoints_selfplay_e9_sp_ckpt274,0,scenario_curriculum_ckpt830,5_vs_5
146,6,6,checkpoints_selfplay_e9_sp_ckpt274,0,scenario_curriculum_ckpt830,5_vs_5
147,3,3,checkpoints_selfplay_e9_sp_ckpt274,0,scenario_curriculum_ckpt830,5_vs_5
148,1,1,checkpoints_selfplay_e9_sp_ckpt274,0,scenario_curriculum_ckpt830,5_vs_5
149,10,10,checkpoints_selfplay_e9_sp_ckpt274,0,scenario_curriculum_ckpt830,5_vs_5
150,0,2,checkpoints_selfplay_e9_sp_ckpt274,2,m_sp_arch_medium_heads_conv16_0_bt_32_r313_m335,5_vs_5
151,-2,3,checkpoints_selfplay_e9_sp_ckpt274,5,m_sp_arch_medium_heads_conv16_0_bt_32_r313_m335,5_vs_5
152,-1,1,checkpoints_selfplay_e9_sp_ckpt274,2,m_sp_arch_medium_heads_conv16_0_bt_32_r313_m335,5_vs_5
153,1,3,checkpoints_selfplay_e9_sp_ckpt274,2,m_sp_arch_medium_heads_conv16_0_bt_32_r313_m335,5_vs_5
154,2,3,checkpoints_selfplay_e9_sp_ckpt274,1,m_sp_arch_medium_heads_conv16_0_bt_32_r313_m335,5_vs_5
155,1,4,checkpoints_selfplay_e9_sp_ckpt274,3,m_sp_arch_medium_heads_conv16_0_bt_32_r313_m335,5_vs_5
156,-4,0,checkpoints_selfplay_e9_sp_ckpt274,4,m_sp_arch_medium_heads_conv16_0_bt_32_r313_m335,5_vs_5
157,-3,3,checkpoints_selfplay_e9_sp_ckpt274,6,m_sp_arch_medium_heads_conv16_0_bt_32_r313_m335,5_vs_5
158,-2,2,checkpoints_selfplay_e9_sp_ckpt274,4,m_sp_arch_medium_heads_conv16_0_bt_32_r313_m335,5_vs_5
159,3,4,checkpoints_selfplay_e9_sp_ckpt274,1,m_sp_arch_medium_heads_conv16_0_bt_32_r313_m335,5_vs_5
160,-2,3,checkpoints_selfplay_e9_sp_ckpt274,5,m_sp_arch_longer_heads_bt_32_r201_m335,5_vs_5
161,0,3,checkpoints_selfplay_e9_sp_ckpt274,3,m_sp_arch_longer_heads_bt_32_r201_m335,5_vs_5
162,0,2,checkpoints_selfplay_e9_sp_ckpt274,2,m_sp_arch_longer_heads_bt_32_r201_m335,5_vs_5
163,2,6,checkpoints_selfplay_e9_sp_ckpt274,4,m_sp_arch_longer_heads_bt_32_r201_m335,5_vs_5
164,-1,3,checkpoints_selfplay_e9_sp_ckpt274,4,m_sp_arch_longer_heads_bt_32_r201_m335,5_vs_5
165,-6,1,checkpoints_selfplay_e9_sp_ckpt274,7,m_sp_arch_longer_heads_bt_32_r201_m335,5_vs_5
166,-1,3,checkpoints_selfplay_e9_sp_ckpt274,4,m_sp_arch_longer_heads_bt_32_r201_m335,5_vs_5
167,1,3,checkpoints_selfplay_e9_sp_ckpt274,2,m_sp_arch_longer_heads_bt_32_r201_m335,5_vs_5
168,1,5,checkpoints_selfplay_e9_sp_ckpt274,4,m_sp_arch_longer_heads_bt_32_r201_m335,5_vs_5
169,-3,3,checkpoints_selfplay_e9_sp_ckpt274,6,m_sp_arch_longer_heads_bt_32_r201_m335,5_vs_5
170,2,5,checkpoints_selfplay_e9_sp_ckpt274,3,m_sp_arch_medium_heads_bt_32_r201_m335,5_vs_5
171,4,6,checkpoints_selfplay_e9_sp_ckpt274,2,m_sp_arch_medium_heads_bt_32_r201_m335,5_vs_5
172,2,3,checkpoints_selfplay_e9_sp_ckpt274,1,m_sp_arch_medium_heads_bt_32_r201_m335,5_vs_5
173,-1,3,checkpoints_selfplay_e9_sp_ckpt274,4,m_sp_arch_medium_heads_bt_32_r201_m335,5_vs_5
174,2,5,checkpoints_selfplay_e9_sp_ckpt274,3,m_sp_arch_medium_heads_bt_32_r201_m335,5_vs_5
175,0,3,checkpoints_selfplay_e9_sp_ckpt274,3,m_sp_arch_medium_heads_bt_32_r201_m335,5_vs_5
176,2,3,checkpoints_selfplay_e9_sp_ckpt274,1,m_sp_arch_medium_heads_bt_32_r201_m335,5_vs_5
177,5,6,checkpoints_selfplay_e9_sp_ckpt274,1,m_sp_arch_medium_heads_bt_32_r201_m335,5_vs_5
178,-3,1,checkpoints_selfplay_e9_sp_ckpt274,4,m_sp_arch_medium_heads_bt_32_r201_m335,5_vs_5
179,-2,1,checkpoints_selfplay_e9_sp_ckpt274,3,m_sp_arch_medium_heads_bt_32_r201_m335,5_vs_5
180,-7,0,checkpoints_selfplay_e9_sp_ckpt274,7,m_sp_arch_4x1_bt_32_r201_m335,5_vs_5
181,-3,1,checkpoints_selfplay_e9_sp_ckpt274,4,m_sp_arch_4x1_bt_32_r201_m335,5_vs_5
182,-9,0,checkpoints_selfplay_e9_sp_ckpt274,9,m_sp_arch_4x1_bt_32_r201_m335,5_vs_5
183,-9,0,checkpoints_selfplay_e9_sp_ckpt274,9,m_sp_arch_4x1_bt_32_r201_m335,5_vs_5
184,-4,2,checkpoints_selfplay_e9_sp_ckpt274,6,m_sp_arch_4x1_bt_32_r201_m335,5_vs_5
185,-5,0,checkpoints_selfplay_e9_sp_ckpt274,5,m_sp_arch_4x1_bt_32_r201_m335,5_vs_5
186,-7,2,checkpoints_selfplay_e9_sp_ckpt274,9,m_sp_arch_4x1_bt_32_r201_m335,5_vs_5
187,-4,1,checkpoints_selfplay_e9_sp_ckpt274,5,m_sp_arch_4x1_bt_32_r201_m335,5_vs_5
188,-4,2,checkpoints_selfplay_e9_sp_ckpt274,6,m_sp_arch_4x1_bt_32_r201_m335,5_vs_5
189,-5,1,checkpoints_selfplay_e9_sp_ckpt274,6,m_sp_arch_4x1_bt_32_r201_m335,5_vs_5
190,-1,1,checkpoints_selfplay_e9_sp_ckpt274,2,m_sp_arch_4x1_bt_32_r201_cont3_m650,5_vs_5
191,-5,0,checkpoints_selfplay_e9_sp_ckpt274,5,m_sp_arch_4x1_bt_32_r201_cont3_m650,5_vs_5
192,-9,2,checkpoints_selfplay_e9_sp_ckpt274,11,m_sp_arch_4x1_bt_32_r201_cont3_m650,5_vs_5
193,-4,2,checkpoints_selfplay_e9_sp_ckpt274,6,m_sp_arch_4x1_bt_32_r201_cont3_m650,5_vs_5
194,-7,0,checkpoints_selfplay_e9_sp_ckpt274,7,m_sp_arch_4x1_bt_32_r201_cont3_m650,5_vs_5
195,-4,1,checkpoints_selfplay_e9_sp_ckpt274,5,m_sp_arch_4x1_bt_32_r201_cont3_m650,5_vs_5
196,-8,0,checkpoints_selfplay_e9_sp_ckpt274,8,m_sp_arch_4x1_bt_32_r201_cont3_m650,5_vs_5
197,-5,0,checkpoints_selfplay_e9_sp_ckpt274,5,m_sp_arch_4x1_bt_32_r201_cont3_m650,5_vs_5
198,-6,0,checkpoints_selfplay_e9_sp_ckpt274,6,m_sp_arch_4x1_bt_32_r201_cont3_m650,5_vs_5
199,-6,1,checkpoints_selfplay_e9_sp_ckpt274,7,m_sp_arch_4x1_bt_32_r201_cont3_m650,5_vs_5
200,-3,1,checkpoints_selfplay_e9_sp_ckpt274,4,explt_v0_7_2_m54,5_vs_5
201,-4,0,checkpoints_selfplay_e9_sp_ckpt274,4,explt_v0_7_2_m54,5_vs_5
202,-1,1,checkpoints_selfplay_e9_sp_ckpt274,2,explt_v0_7_2_m54,5_vs_5
203,0,1,checkpoints_selfplay_e9_sp_ckpt274,1,explt_v0_7_2_m54,5_vs_5
204,0,1,checkpoints_selfplay_e9_sp_ckpt274,1,explt_v0_7_2_m54,5_vs_5
205,0,2,checkpoints_selfplay_e9_sp_ckpt274,2,explt_v0_7_2_m54,5_vs_5
206,-3,1,checkpoints_selfplay_e9_sp_ckpt274,4,explt_v0_7_2_m54,5_vs_5
207,-1,2,checkpoints_selfplay_e9_sp_ckpt274,3,explt_v0_7_2_m54,5_vs_5
208,-2,0,checkpoints_selfplay_e9_sp_ckpt274,2,explt_v0_7_2_m54,5_vs_5
209,-4,0,checkpoints_selfplay_e9_sp_ckpt274,4,explt_v0_7_2_m54,5_vs_5
210,-7,1,checkpoints_selfplay_e9_sp_ckpt274,8,m_sp_sc3v3_arch_2x1_32_r500_cont4x1_m224,5_vs_5
211,-2,1,checkpoints_selfplay_e9_sp_ckpt274,3,m_sp_sc3v3_arch_2x1_32_r500_cont4x1_m224,5_vs_5
212,-7,0,checkpoints_selfplay_e9_sp_ckpt274,7,m_sp_sc3v3_arch_2x1_32_r500_cont4x1_m224,5_vs_5
213,-6,2,checkpoints_selfplay_e9_sp_ckpt274,8,m_sp_sc3v3_arch_2x1_32_r500_cont4x1_m224,5_vs_5
214,-8,1,checkpoints_selfplay_e9_sp_ckpt274,9,m_sp_sc3v3_arch_2x1_32_r500_cont4x1_m224,5_vs_5
215,-4,4,checkpoints_selfplay_e9_sp_ckpt274,8,m_sp_sc3v3_arch_2x1_32_r500_cont4x1_m224,5_vs_5
216,-3,3,checkpoints_selfplay_e9_sp_ckpt274,6,m_sp_sc3v3_arch_2x1_32_r500_cont4x1_m224,5_vs_5
217,-4,2,checkpoints_selfplay_e9_sp_ckpt274,6,m_sp_sc3v3_arch_2x1_32_r500_cont4x1_m224,5_vs_5
218,-6,0,checkpoints_selfplay_e9_sp_ckpt274,6,m_sp_sc3v3_arch_2x1_32_r500_cont4x1_m224,5_vs_5
219,-3,3,checkpoints_selfplay_e9_sp_ckpt274,6,m_sp_sc3v3_arch_2x1_32_r500_cont4x1_m224,5_vs_5
220,-2,0,checkpoints_selfplay_e9_sp_ckpt274,2,m_sp_arch_4x1_bt_32_roles_r500_m335,5_vs_5
221,-4,1,checkpoints_selfplay_e9_sp_ckpt274,5,m_sp_arch_4x1_bt_32_roles_r500_m335,5_vs_5
222,-9,1,checkpoints_selfplay_e9_sp_ckpt274,10,m_sp_arch_4x1_bt_32_roles_r500_m335,5_vs_5
223,-4,2,checkpoints_selfplay_e9_sp_ckpt274,6,m_sp_arch_4x1_bt_32_roles_r500_m335,5_vs_5
224,-3,1,checkpoints_selfplay_e9_sp_ckpt274,4,m_sp_arch_4x1_bt_32_roles_r500_m335,5_vs_5
225,-1,3,checkpoints_selfplay_e9_sp_ckpt274,4,m_sp_arch_4x1_bt_32_roles_r500_m335,5_vs_5
226,-9,0,checkpoints_selfplay_e9_sp_ckpt274,9,m_sp_arch_4x1_bt_32_roles_r500_m335,5_vs_5
227,-4,3,checkpoints_selfplay_e9_sp_ckpt274,7,m_sp_arch_4x1_bt_32_roles_r500_m335,5_vs_5
228,-6,3,checkpoints_selfplay_e9_sp_ckpt274,9,m_sp_arch_4x1_bt_32_roles_r500_m335,5_vs_5
229,0,1,checkpoints_selfplay_e9_sp_ckpt274,1,m_sp_arch_4x1_bt_32_roles_r500_m335,5_vs_5
230,-4,0,m_sp_arch_longer_heads_bt_32_r201_m335,4,easy_bots,5_vs_5
231,0,0,m_sp_arch_longer_heads_bt_32_r201_m335,0,easy_bots,5_vs_5
232,0,1,m_sp_arch_longer_heads_bt_32_r201_m335,1,easy_bots,5_vs_5
233,-3,0,m_sp_arch_longer_heads_bt_32_r201_m335,3,easy_bots,5_vs_5
234,1,2,m_sp_arch_longer_heads_bt_32_r201_m335,1,easy_bots,5_vs_5
235,-2,0,m_sp_arch_longer_heads_bt_32_r201_m335,2,easy_bots,5_vs_5
236,-1,1,m_sp_arch_longer_heads_bt_32_r201_m335,2,easy_bots,5_vs_5
237,-4,0,m_sp_arch_longer_heads_bt_32_r201_m335,4,easy_bots,5_vs_5
238,1,2,m_sp_arch_longer_heads_bt_32_r201_m335,1,easy_bots,5_vs_5
239,0,0,m_sp_arch_longer_heads_bt_32_r201_m335,0,easy_bots,5_vs_5
240,2,3,m_sp_arch_longer_heads_bt_32_r201_m335,1,easy_bots,5_vs_5
241,-2,1,m_sp_arch_longer_heads_bt_32_r201_m335,3,easy_bots,5_vs_5
242,-3,1,m_sp_arch_longer_heads_bt_32_r201_m335,4,easy_bots,5_vs_5
243,-1,1,m_sp_arch_longer_heads_bt_32_r201_m335,2,easy_bots,5_vs_5
244,1,2,m_sp_arch_longer_heads_bt_32_r201_m335,1,easy_bots,5_vs_5
245,-2,2,m_sp_arch_longer_heads_bt_32_r201_m335,4,easy_bots,5_vs_5
246,1,1,m_sp_arch_longer_heads_bt_32_r201_m335,0,easy_bots,5_vs_5
247,-1,0,m_sp_arch_longer_heads_bt_32_r201_m335,1,easy_bots,5_vs_5
248,-1,0,m_sp_arch_longer_heads_bt_32_r201_m335,1,easy_bots,5_vs_5
249,-1,1,m_sp_arch_longer_heads_bt_32_r201_m335,2,easy_bots,5_vs_5
250,-2,0,m_sp_arch_longer_heads_bt_32_r201_m335,2,medium_bots,5_vs_5_medium
251,-2,0,m_sp_arch_longer_heads_bt_32_r201_m335,2,medium_bots,5_vs_5_medium
252,-1,1,m_sp_arch_longer_heads_bt_32_r201_m335,2,medium_bots,5_vs_5_medium
253,-2,0,m_sp_arch_longer_heads_bt_32_r201_m335,2,medium_bots,5_vs_5_medium
254,-1,1,m_sp_arch_longer_heads_bt_32_r201_m335,2,medium_bots,5_vs_5_medium
255,-4,0,m_sp_arch_longer_heads_bt_32_r201_m335,4,medium_bots,5_vs_5_medium
256,-2,1,m_sp_arch_longer_heads_bt_32_r201_m335,3,medium_bots,5_vs_5_medium
257,-1,1,m_sp_arch_longer_heads_bt_32_r201_m335,2,medium_bots,5_vs_5_medium
258,-1,1,m_sp_arch_longer_heads_bt_32_r201_m335,2,medium_bots,5_vs_5_medium
259,-4,0,m_sp_arch_longer_heads_bt_32_r201_m335,4,medium_bots,5_vs_5_medium
260,-3,0,m_sp_arch_longer_heads_bt_32_r201_m335,3,medium_bots,5_vs_5_medium
261,-1,0,m_sp_arch_longer_heads_bt_32_r201_m335,1,medium_bots,5_vs_5_medium
262,-1,1,m_sp_arch_longer_heads_bt_32_r201_m335,2,medium_bots,5_vs_5_medium
263,-4,0,m_sp_arch_longer_heads_bt_32_r201_m335,4,medium_bots,5_vs_5_medium
264,-3,0,m_sp_arch_longer_heads_bt_32_r201_m335,3,medium_bots,5_vs_5_medium
265,-1,0,m_sp_arch_longer_heads_bt_32_r201_m335,1,medium_bots,5_vs_5_medium
266,-1,0,m_sp_arch_longer_heads_bt_32_r201_m335,1,medium_bots,5_vs_5_medium
267,-1,0,m_sp_arch_longer_heads_bt_32_r201_m335,1,medium_bots,5_vs_5_medium
268,-1,1,m_sp_arch_longer_heads_bt_32_r201_m335,2,medium_bots,5_vs_5_medium
269,-3,0,m_sp_arch_longer_heads_bt_32_r201_m335,3,medium_bots,5_vs_5_medium
270,0,0,m_sp_arch_longer_heads_bt_32_r201_m335,0,hard_bots,5_vs_5_hard
271,-2,0,m_sp_arch_longer_heads_bt_32_r201_m335,2,hard_bots,5_vs_5_hard
272,-2,2,m_sp_arch_longer_heads_bt_32_r201_m335,4,hard_bots,5_vs_5_hard
273,-4,0,m_sp_arch_longer_heads_bt_32_r201_m335,4,hard_bots,5_vs_5_hard
274,-3,1,m_sp_arch_longer_heads_bt_32_r201_m335,4,hard_bots,5_vs_5_hard
275,-2,0,m_sp_arch_longer_heads_bt_32_r201_m335,2,hard_bots,5_vs_5_hard
276,-3,0,m_sp_arch_longer_heads_bt_32_r201_m335,3,hard_bots,5_vs_5_hard
277,-2,1,m_sp_arch_longer_heads_bt_32_r201_m335,3,hard_bots,5_vs_5_hard
278,-2,2,m_sp_arch_longer_heads_bt_32_r201_m335,4,hard_bots,5_vs_5_hard
279,-3,0,m_sp_arch_longer_heads_bt_32_r201_m335,3,hard_bots,5_vs_5_hard
280,-3,0,m_sp_arch_longer_heads_bt_32_r201_m335,3,hard_bots,5_vs_5_hard
281,-3,1,m_sp_arch_longer_heads_bt_32_r201_m335,4,hard_bots,5_vs_5_hard
282,-1,0,m_sp_arch_longer_heads_bt_32_r201_m335,1,hard_bots,5_vs_5_hard
283,-1,1,m_sp_arch_longer_heads_bt_32_r201_m335,2,hard_bots,5_vs_5_hard
284,-1,0,m_sp_arch_longer_heads_bt_32_r201_m335,1,hard_bots,5_vs_5_hard
285,-2,0,m_sp_arch_longer_heads_bt_32_r201_m335,2,hard_bots,5_vs_5_hard
286,-2,0,m_sp_arch_longer_heads_bt_32_r201_m335,2,hard_bots,5_vs_5_hard
287,-1,0,m_sp_arch_longer_heads_bt_32_r201_m335,1,hard_bots,5_vs_5_hard
288,-1,0,m_sp_arch_longer_heads_bt_32_r201_m335,1,hard_bots,5_vs_5_hard
289,-1,0,m_sp_arch_longer_heads_bt_32_r201_m335,1,hard_bots,5_vs_5_hard
290,2,5,m_sp_arch_longer_heads_bt_32_r201_m335,3,f5v0to1to2t05_e2_ckpt291,5_vs_5
291,6,7,m_sp_arch_longer_heads_bt_32_r201_m335,1,f5v0to1to2t05_e2_ckpt291,5_vs_5
292,0,2,m_sp_arch_longer_heads_bt_32_r201_m335,2,f5v0to1to2t05_e2_ckpt291,5_vs_5
293,0,3,m_sp_arch_longer_heads_bt_32_r201_m335,3,f5v0to1to2t05_e2_ckpt291,5_vs_5
294,3,6,m_sp_arch_longer_heads_bt_32_r201_m335,3,f5v0to1to2t05_e2_ckpt291,5_vs_5
295,8,8,m_sp_arch_longer_heads_bt_32_r201_m335,0,f5v0to1to2t05_e2_ckpt291,5_vs_5
296,5,7,m_sp_arch_longer_heads_bt_32_r201_m335,2,f5v0to1to2t05_e2_ckpt291,5_vs_5
297,3,4,m_sp_arch_longer_heads_bt_32_r201_m335,1,f5v0to1to2t05_e2_ckpt291,5_vs_5
298,1,2,m_sp_arch_longer_heads_bt_32_r201_m335,1,f5v0to1to2t05_e2_ckpt291,5_vs_5
299,3,4,m_sp_arch_longer_heads_bt_32_r201_m335,1,f5v0to1to2t05_e2_ckpt291,5_vs_5
300,3,5,m_sp_arch_longer_heads_bt_32_r201_m335,2,f5v0to1to5_e2_ckpt252,5_vs_5
301,-2,3,m_sp_arch_longer_heads_bt_32_r201_m335,5,f5v0to1to5_e2_ckpt252,5_vs_5
302,3,3,m_sp_arch_longer_heads_bt_32_r201_m335,0,f5v0to1to5_e2_ckpt252,5_vs_5
303,1,4,m_sp_arch_longer_heads_bt_32_r201_m335,3,f5v0to1to5_e2_ckpt252,5_vs_5
304,3,3,m_sp_arch_longer_heads_bt_32_r201_m335,0,f5v0to1to5_e2_ckpt252,5_vs_5
305,-1,2,m_sp_arch_longer_heads_bt_32_r201_m335,3,f5v0to1to5_e2_ckpt252,5_vs_5
306,2,4,m_sp_arch_longer_heads_bt_32_r201_m335,2,f5v0to1to5_e2_ckpt252,5_vs_5
307,4,6,m_sp_arch_longer_heads_bt_32_r201_m335,2,f5v0to1to5_e2_ckpt252,5_vs_5
308,4,5,m_sp_arch_longer_heads_bt_32_r201_m335,1,f5v0to1to5_e2_ckpt252,5_vs_5
309,0,2,m_sp_arch_longer_heads_bt_32_r201_m335,2,f5v0to1to5_e2_ckpt252,5_vs_5
310,3,5,m_sp_arch_longer_heads_bt_32_r201_m335,2,scon_e3_p2_hard_ckpt840,5_vs_5
311,3,4,m_sp_arch_longer_heads_bt_32_r201_m335,1,scon_e3_p2_hard_ckpt840,5_vs_5
312,3,3,m_sp_arch_longer_heads_bt_32_r201_m335,0,scon_e3_p2_hard_ckpt840,5_vs_5
313,6,6,m_sp_arch_longer_heads_bt_32_r201_m335,0,scon_e3_p2_hard_ckpt840,5_vs_5
314,4,7,m_sp_arch_longer_heads_bt_32_r201_m335,3,scon_e3_p2_hard_ckpt840,5_vs_5
315,5,5,m_sp_arch_longer_heads_bt_32_r201_m335,0,scon_e3_p2_hard_ckpt840,5_vs_5
316,5,5,m_sp_arch_longer_heads_bt_32_r201_m335,0,scon_e3_p2_hard_ckpt840,5_vs_5
317,7,8,m_sp_arch_longer_heads_bt_32_r201_m335,1,scon_e3_p2_hard_ckpt840,5_vs_5
318,5,6,m_sp_arch_longer_heads_bt_32_r201_m335,1,scon_e3_p2_hard_ckpt840,5_vs_5
319,1,1,m_sp_arch_longer_heads_bt_32_r201_m335,0,scon_e3_p2_hard_ckpt840,5_vs_5
320,7,7,m_sp_arch_longer_heads_bt_32_r201_m335,0,less_then_partially_randomized_checkpoints_bots_4_heads_38_ckpt108,5_vs_5
321,4,5,m_sp_arch_longer_heads_bt_32_r201_m335,1,less_then_partially_randomized_checkpoints_bots_4_heads_38_ckpt108,5_vs_5
322,6,7,m_sp_arch_longer_heads_bt_32_r201_m335,1,less_then_partially_randomized_checkpoints_bots_4_heads_38_ckpt108,5_vs_5
323,3,3,m_sp_arch_longer_heads_bt_32_r201_m335,0,less_then_partially_randomized_checkpoints_bots_4_heads_38_ckpt108,5_vs_5
324,6,7,m_sp_arch_longer_heads_bt_32_r201_m335,1,less_then_partially_randomized_checkpoints_bots_4_heads_38_ckpt108,5_vs_5
325,3,3,m_sp_arch_longer_heads_bt_32_r201_m335,0,less_then_partially_randomized_checkpoints_bots_4_heads_38_ckpt108,5_vs_5
326,4,5,m_sp_arch_longer_heads_bt_32_r201_m335,1,less_then_partially_randomized_checkpoints_bots_4_heads_38_ckpt108,5_vs_5
327,2,4,m_sp_arch_longer_heads_bt_32_r201_m335,2,less_then_partially_randomized_checkpoints_bots_4_heads_38_ckpt108,5_vs_5
328,4,5,m_sp_arch_longer_heads_bt_32_r201_m335,1,less_then_partially_randomized_checkpoints_bots_4_heads_38_ckpt108,5_vs_5
329,5,5,m_sp_arch_longer_heads_bt_32_r201_m335,0,less_then_partially_randomized_checkpoints_bots_4_heads_38_ckpt108,5_vs_5
330,4,4,m_sp_arch_longer_heads_bt_32_r201_m335,0,less_then_partially_randomized_entropy_checkpoints_bots_4_heads_39_ckpt109,5_vs_5
331,4,4,m_sp_arch_longer_heads_bt_32_r201_m335,0,less_then_partially_randomized_entropy_checkpoints_bots_4_heads_39_ckpt109,5_vs_5
332,3,5,m_sp_arch_longer_heads_bt_32_r201_m335,2,less_then_partially_randomized_entropy_checkpoints_bots_4_heads_39_ckpt109,5_vs_5
333,4,4,m_sp_arch_longer_heads_bt_32_r201_m335,0,less_then_partially_randomized_entropy_checkpoints_bots_4_heads_39_ckpt109,5_vs_5
334,7,8,m_sp_arch_longer_heads_bt_32_r201_m335,1,less_then_partially_randomized_entropy_checkpoints_bots_4_heads_39_ckpt109,5_vs_5
335,4,4,m_sp_arch_longer_heads_bt_32_r201_m335,0,less_then_partially_randomized_entropy_checkpoints_bots_4_heads_39_ckpt109,5_vs_5
336,6,6,m_sp_arch_longer_heads_bt_32_r201_m335,0,less_then_partially_randomized_entropy_checkpoints_bots_4_heads_39_ckpt109,5_vs_5
337,1,2,m_sp_arch_longer_heads_bt_32_r201_m335,1,less_then_partially_randomized_entropy_checkpoints_bots_4_heads_39_ckpt109,5_vs_5
338,3,3,m_sp_arch_longer_heads_bt_32_r201_m335,0,less_then_partially_randomized_entropy_checkpoints_bots_4_heads_39_ckpt109,5_vs_5
339,4,4,m_sp_arch_longer_heads_bt_32_r201_m335,0,less_then_partially_randomized_entropy_checkpoints_bots_4_heads_39_ckpt109,5_vs_5
340,7,7,m_sp_arch_longer_heads_bt_32_r201_m335,0,reward_shaping_checkpoints_bots_4_heads_1_ckpt360,5_vs_5
341,7,7,m_sp_arch_longer_heads_bt_32_r201_m335,0,reward_shaping_checkpoints_bots_4_heads_1_ckpt360,5_vs_5
342,5,6,m_sp_arch_longer_heads_bt_32_r201_m335,1,reward_shaping_checkpoints_bots_4_heads_1_ckpt360,5_vs_5
343,6,6,m_sp_arch_longer_heads_bt_32_r201_m335,0,reward_shaping_checkpoints_bots_4_heads_1_ckpt360,5_vs_5
344,4,6,m_sp_arch_longer_heads_bt_32_r201_m335,2,reward_shaping_checkpoints_bots_4_heads_1_ckpt360,5_vs_5
345,3,4,m_sp_arch_longer_heads_bt_32_r201_m335,1,reward_shaping_checkpoints_bots_4_heads_1_ckpt360,5_vs_5
346,3,4,m_sp_arch_longer_heads_bt_32_r201_m335,1,reward_shaping_checkpoints_bots_4_heads_1_ckpt360,5_vs_5
347,4,4,m_sp_arch_longer_heads_bt_32_r201_m335,0,reward_shaping_checkpoints_bots_4_heads_1_ckpt360,5_vs_5
348,7,7,m_sp_arch_longer_heads_bt_32_r201_m335,0,reward_shaping_checkpoints_bots_4_heads_1_ckpt360,5_vs_5
349,4,5,m_sp_arch_longer_heads_bt_32_r201_m335,1,reward_shaping_checkpoints_bots_4_heads_1_ckpt360,5_vs_5
350,3,3,m_sp_arch_longer_heads_bt_32_r201_m335,0,checkpoints_selfplay_e9_sp_ckpt274,5_vs_5
351,1,3,m_sp_arch_longer_heads_bt_32_r201_m335,2,checkpoints_selfplay_e9_sp_ckpt274,5_vs_5
352,1,1,m_sp_arch_longer_heads_bt_32_r201_m335,0,checkpoints_selfplay_e9_sp_ckpt274,5_vs_5
353,0,2,m_sp_arch_longer_heads_bt_32_r201_m335,2,checkpoints_selfplay_e9_sp_ckpt274,5_vs_5
354,1,2,m_sp_arch_longer_heads_bt_32_r201_m335,1,checkpoints_selfplay_e9_sp_ckpt274,5_vs_5
355,1,2,m_sp_arch_longer_heads_bt_32_r201_m335,1,checkpoints_selfplay_e9_sp_ckpt274,5_vs_5
356,2,5,m_sp_arch_longer_heads_bt_32_r201_m335,3,checkpoints_selfplay_e9_sp_ckpt274,5_vs_5
357,0,2,m_sp_arch_longer_heads_bt_32_r201_m335,2,checkpoints_selfplay_e9_sp_ckpt274,5_vs_5
358,1,4,m_sp_arch_longer_heads_bt_32_r201_m335,3,checkpoints_selfplay_e9_sp_ckpt274,5_vs_5
359,-3,2,m_sp_arch_longer_heads_bt_32_r201_m335,5,checkpoints_selfplay_e9_sp_ckpt274,5_vs_5
360,-3,1,m_sp_arch_longer_heads_bt_32_r201_m335,4,checkpoints_sp_c_nb_e2_ckpt667,5_vs_5
361,-2,1,m_sp_arch_longer_heads_bt_32_r201_m335,3,checkpoints_sp_c_nb_e2_ckpt667,5_vs_5
362,-1,2,m_sp_arch_longer_heads_bt_32_r201_m335,3,checkpoints_sp_c_nb_e2_ckpt667,5_vs_5
363,-7,2,m_sp_arch_longer_heads_bt_32_r201_m335,9,checkpoints_sp_c_nb_e2_ckpt667,5_vs_5
364,-2,2,m_sp_arch_longer_heads_bt_32_r201_m335,4,checkpoints_sp_c_nb_e2_ckpt667,5_vs_5
365,-1,4,m_sp_arch_longer_heads_bt_32_r201_m335,5,checkpoints_sp_c_nb_e2_ckpt667,5_vs_5
366,-3,1,m_sp_arch_longer_heads_bt_32_r201_m335,4,checkpoints_sp_c_nb_e2_ckpt667,5_vs_5
367,-1,1,m_sp_arch_longer_heads_bt_32_r201_m335,2,checkpoints_sp_c_nb_e2_ckpt667,5_vs_5
368,-4,1,m_sp_arch_longer_heads_bt_32_r201_m335,5,checkpoints_sp_c_nb_e2_ckpt667,5_vs_5
369,-2,2,m_sp_arch_longer_heads_bt_32_r201_m335,4,checkpoints_sp_c_nb_e2_ckpt667,5_vs_5
370,2,2,m_sp_arch_longer_heads_bt_32_r201_m335,0,scenario_curriculum_ckpt830,5_vs_5
371,6,6,m_sp_arch_longer_heads_bt_32_r201_m335,0,scenario_curriculum_ckpt830,5_vs_5
372,2,2,m_sp_arch_longer_heads_bt_32_r201_m335,0,scenario_curriculum_ckpt830,5_vs_5
373,3,3,m_sp_arch_longer_heads_bt_32_r201_m335,0,scenario_curriculum_ckpt830,5_vs_5
374,0,0,m_sp_arch_longer_heads_bt_32_r201_m335,0,scenario_curriculum_ckpt830,5_vs_5
375,2,2,m_sp_arch_longer_heads_bt_32_r201_m335,0,scenario_curriculum_ckpt830,5_vs_5
376,4,4,m_sp_arch_longer_heads_bt_32_r201_m335,0,scenario_curriculum_ckpt830,5_vs_5
377,1,1,m_sp_arch_longer_heads_bt_32_r201_m335,0,scenario_curriculum_ckpt830,5_vs_5
378,0,0,m_sp_arch_longer_heads_bt_32_r201_m335,0,scenario_curriculum_ckpt830,5_vs_5
379,3,3,m_sp_arch_longer_heads_bt_32_r201_m335,0,scenario_curriculum_ckpt830,5_vs_5
380,-3,0,m_sp_arch_longer_heads_bt_32_r201_m335,3,m_sp_arch_medium_heads_conv16_0_bt_32_r313_m335,5_vs_5
381,-1,2,m_sp_arch_longer_heads_bt_32_r201_m335,3,m_sp_arch_medium_heads_conv16_0_bt_32_r313_m335,5_vs_5
382,-1,1,m_sp_arch_longer_heads_bt_32_r201_m335,2,m_sp_arch_medium_heads_conv16_0_bt_32_r313_m335,5_vs_5
383,-1,1,m_sp_arch_longer_heads_bt_32_r201_m335,2,m_sp_arch_medium_heads_conv16_0_bt_32_r313_m335,5_vs_5
384,0,4,m_sp_arch_longer_heads_bt_32_r201_m335,4,m_sp_arch_medium_heads_conv16_0_bt_32_r313_m335,5_vs_5
385,1,2,m_sp_arch_longer_heads_bt_32_r201_m335,1,m_sp_arch_medium_heads_conv16_0_bt_32_r313_m335,5_vs_5
386,3,4,m_sp_arch_longer_heads_bt_32_r201_m335,1,m_sp_arch_medium_heads_conv16_0_bt_32_r313_m335,5_vs_5
387,1,2,m_sp_arch_longer_heads_bt_32_r201_m335,1,m_sp_arch_medium_heads_conv16_0_bt_32_r313_m335,5_vs_5
388,4,4,m_sp_arch_longer_heads_bt_32_r201_m335,0,m_sp_arch_medium_heads_conv16_0_bt_32_r313_m335,5_vs_5
389,-2,0,m_sp_arch_longer_heads_bt_32_r201_m335,2,m_sp_arch_medium_heads_conv16_0_bt_32_r313_m335,5_vs_5
390,1,2,m_sp_arch_longer_heads_bt_32_r201_m335,1,m_sp_arch_longer_heads_bt_32_r201_m335,5_vs_5
391,0,0,m_sp_arch_longer_heads_bt_32_r201_m335,0,m_sp_arch_longer_heads_bt_32_r201_m335,5_vs_5
392,0,1,m_sp_arch_longer_heads_bt_32_r201_m335,1,m_sp_arch_longer_heads_bt_32_r201_m335,5_vs_5
393,0,4,m_sp_arch_longer_heads_bt_32_r201_m335,4,m_sp_arch_longer_heads_bt_32_r201_m335,5_vs_5
394,-4,0,m_sp_arch_longer_heads_bt_32_r201_m335,4,m_sp_arch_longer_heads_bt_32_r201_m335,5_vs_5
395,2,3,m_sp_arch_longer_heads_bt_32_r201_m335,1,m_sp_arch_longer_heads_bt_32_r201_m335,5_vs_5
396,2,2,m_sp_arch_longer_heads_bt_32_r201_m335,0,m_sp_arch_longer_heads_bt_32_r201_m335,5_vs_5
397,4,4,m_sp_arch_longer_heads_bt_32_r201_m335,0,m_sp_arch_longer_heads_bt_32_r201_m335,5_vs_5
398,-2,1,m_sp_arch_longer_heads_bt_32_r201_m335,3,m_sp_arch_longer_heads_bt_32_r201_m335,5_vs_5
399,-1,1,m_sp_arch_longer_heads_bt_32_r201_m335,2,m_sp_arch_longer_heads_bt_32_r201_m335,5_vs_5
400,-2,2,m_sp_arch_longer_heads_bt_32_r201_m335,4,m_sp_arch_medium_heads_bt_32_r201_m335,5_vs_5
401,0,2,m_sp_arch_longer_heads_bt_32_r201_m335,2,m_sp_arch_medium_heads_bt_32_r201_m335,5_vs_5
402,-1,3,m_sp_arch_longer_heads_bt_32_r201_m335,4,m_sp_arch_medium_heads_bt_32_r201_m335,5_vs_5
403,-1,1,m_sp_arch_longer_heads_bt_32_r201_m335,2,m_sp_arch_medium_heads_bt_32_r201_m335,5_vs_5
404,0,2,m_sp_arch_longer_heads_bt_32_r201_m335,2,m_sp_arch_medium_heads_bt_32_r201_m335,5_vs_5
405,1,2,m_sp_arch_longer_heads_bt_32_r201_m335,1,m_sp_arch_medium_heads_bt_32_r201_m335,5_vs_5
406,2,4,m_sp_arch_longer_heads_bt_32_r201_m335,2,m_sp_arch_medium_heads_bt_32_r201_m335,5_vs_5
407,2,4,m_sp_arch_longer_heads_bt_32_r201_m335,2,m_sp_arch_medium_heads_bt_32_r201_m335,5_vs_5
408,2,2,m_sp_arch_longer_heads_bt_32_r201_m335,0,m_sp_arch_medium_heads_bt_32_r201_m335,5_vs_5
409,1,1,m_sp_arch_longer_heads_bt_32_r201_m335,0,m_sp_arch_medium_heads_bt_32_r201_m335,5_vs_5
410,-3,3,m_sp_arch_longer_heads_bt_32_r201_m335,6,m_sp_arch_4x1_bt_32_r201_m335,5_vs_5
411,-2,0,m_sp_arch_longer_heads_bt_32_r201_m335,2,m_sp_arch_4x1_bt_32_r201_m335,5_vs_5
412,-2,2,m_sp_arch_longer_heads_bt_32_r201_m335,4,m_sp_arch_4x1_bt_32_r201_m335,5_vs_5
413,-5,1,m_sp_arch_longer_heads_bt_32_r201_m335,6,m_sp_arch_4x1_bt_32_r201_m335,5_vs_5
414,-5,0,m_sp_arch_longer_heads_bt_32_r201_m335,5,m_sp_arch_4x1_bt_32_r201_m335,5_vs_5
415,-8,1,m_sp_arch_longer_heads_bt_32_r201_m335,9,m_sp_arch_4x1_bt_32_r201_m335,5_vs_5
416,-2,2,m_sp_arch_longer_heads_bt_32_r201_m335,4,m_sp_arch_4x1_bt_32_r201_m335,5_vs_5
417,-2,1,m_sp_arch_longer_heads_bt_32_r201_m335,3,m_sp_arch_4x1_bt_32_r201_m335,5_vs_5
418,-3,1,m_sp_arch_longer_heads_bt_32_r201_m335,4,m_sp_arch_4x1_bt_32_r201_m335,5_vs_5
419,-5,2,m_sp_arch_longer_heads_bt_32_r201_m335,7,m_sp_arch_4x1_bt_32_r201_m335,5_vs_5
420,-6,0,m_sp_arch_longer_heads_bt_32_r201_m335,6,m_sp_arch_4x1_bt_32_r201_cont3_m650,5_vs_5
421,-6,0,m_sp_arch_longer_heads_bt_32_r201_m335,6,m_sp_arch_4x1_bt_32_r201_cont3_m650,5_vs_5
422,-5,1,m_sp_arch_longer_heads_bt_32_r201_m335,6,m_sp_arch_4x1_bt_32_r201_cont3_m650,5_vs_5
423,-4,2,m_sp_arch_longer_heads_bt_32_r201_m335,6,m_sp_arch_4x1_bt_32_r201_cont3_m650,5_vs_5
424,-4,1,m_sp_arch_longer_heads_bt_32_r201_m335,5,m_sp_arch_4x1_bt_32_r201_cont3_m650,5_vs_5
425,-7,0,m_sp_arch_longer_heads_bt_32_r201_m335,7,m_sp_arch_4x1_bt_32_r201_cont3_m650,5_vs_5
426,-1,2,m_sp_arch_longer_heads_bt_32_r201_m335,3,m_sp_arch_4x1_bt_32_r201_cont3_m650,5_vs_5
427,-5,1,m_sp_arch_longer_heads_bt_32_r201_m335,6,m_sp_arch_4x1_bt_32_r201_cont3_m650,5_vs_5
428,-5,2,m_sp_arch_longer_heads_bt_32_r201_m335,7,m_sp_arch_4x1_bt_32_r201_cont3_m650,5_vs_5
429,-5,0,m_sp_arch_longer_heads_bt_32_r201_m335,5,m_sp_arch_4x1_bt_32_r201_cont3_m650,5_vs_5
430,-2,1,m_sp_arch_longer_heads_bt_32_r201_m335,3,explt_v0_7_2_m54,5_vs_5
431,0,1,m_sp_arch_longer_heads_bt_32_r201_m335,1,explt_v0_7_2_m54,5_vs_5
432,-2,0,m_sp_arch_longer_heads_bt_32_r201_m335,2,explt_v0_7_2_m54,5_vs_5
433,-3,1,m_sp_arch_longer_heads_bt_32_r201_m335,4,explt_v0_7_2_m54,5_vs_5
434,-3,0,m_sp_arch_longer_heads_bt_32_r201_m335,3,explt_v0_7_2_m54,5_vs_5
435,-2,0,m_sp_arch_longer_heads_bt_32_r201_m335,2,explt_v0_7_2_m54,5_vs_5
436,-1,1,m_sp_arch_longer_heads_bt_32_r201_m335,2,explt_v0_7_2_m54,5_vs_5
437,-1,0,m_sp_arch_longer_heads_bt_32_r201_m335,1,explt_v0_7_2_m54,5_vs_5
438,1,3,m_sp_arch_longer_heads_bt_32_r201_m335,2,explt_v0_7_2_m54,5_vs_5
439,-3,0,m_sp_arch_longer_heads_bt_32_r201_m335,3,explt_v0_7_2_m54,5_vs_5
440,0,2,m_sp_arch_longer_heads_bt_32_r201_m335,2,m_sp_sc3v3_arch_2x1_32_r500_cont4x1_m224,5_vs_5
441,2,3,m_sp_arch_longer_heads_bt_32_r201_m335,1,m_sp_sc3v3_arch_2x1_32_r500_cont4x1_m224,5_vs_5
442,-3,1,m_sp_arch_longer_heads_bt_32_r201_m335,4,m_sp_sc3v3_arch_2x1_32_r500_cont4x1_m224,5_vs_5
443,-4,0,m_sp_arch_longer_heads_bt_32_r201_m335,4,m_sp_sc3v3_arch_2x1_32_r500_cont4x1_m224,5_vs_5
444,-4,1,m_sp_arch_longer_heads_bt_32_r201_m335,5,m_sp_sc3v3_arch_2x1_32_r500_cont4x1_m224,5_vs_5
445,-6,0,m_sp_arch_longer_heads_bt_32_r201_m335,6,m_sp_sc3v3_arch_2x1_32_r500_cont4x1_m224,5_vs_5
446,-4,1,m_sp_arch_longer_heads_bt_32_r201_m335,5,m_sp_sc3v3_arch_2x1_32_r500_cont4x1_m224,5_vs_5
447,-1,2,m_sp_arch_longer_heads_bt_32_r201_m335,3,m_sp_sc3v3_arch_2x1_32_r500_cont4x1_m224,5_vs_5
448,-1,1,m_sp_arch_longer_heads_bt_32_r201_m335,2,m_sp_sc3v3_arch_2x1_32_r500_cont4x1_m224,5_vs_5
449,-4,1,m_sp_arch_longer_heads_bt_32_r201_m335,5,m_sp_sc3v3_arch_2x1_32_r500_cont4x1_m224,5_vs_5
450,-5,2,m_sp_arch_longer_heads_bt_32_r201_m335,7,m_sp_arch_4x1_bt_32_roles_r500_m335,5_vs_5
451,-4,1,m_sp_arch_longer_heads_bt_32_r201_m335,5,m_sp_arch_4x1_bt_32_roles_r500_m335,5_vs_5
452,0,1,m_sp_arch_longer_heads_bt_32_r201_m335,1,m_sp_arch_4x1_bt_32_roles_r500_m335,5_vs_5
453,-6,0,m_sp_arch_longer_heads_bt_32_r201_m335,6,m_sp_arch_4x1_bt_32_roles_r500_m335,5_vs_5
454,-6,0,m_sp_arch_longer_heads_bt_32_r201_m335,6,m_sp_arch_4x1_bt_32_roles_r500_m335,5_vs_5
455,-4,1,m_sp_arch_longer_heads_bt_32_r201_m335,5,m_sp_arch_4x1_bt_32_roles_r500_m335,5_vs_5
456,-6,1,m_sp_arch_longer_heads_bt_32_r201_m335,7,m_sp_arch_4x1_bt_32_roles_r500_m335,5_vs_5
457,-10,0,m_sp_arch_longer_heads_bt_32_r201_m335,10,m_sp_arch_4x1_bt_32_roles_r500_m335,5_vs_5
458,-4,0,m_sp_arch_longer_heads_bt_32_r201_m335,4,m_sp_arch_4x1_bt_32_roles_r500_m335,5_vs_5
459,-3,2,m_sp_arch_longer_heads_bt_32_r201_m335,5,m_sp_arch_4x1_bt_32_roles_r500_m335,5_vs_5
460,0,0,m_sp_arch_medium_heads_bt_32_r201_m335,0,easy_bots,5_vs_5
461,0,1,m_sp_arch_medium_heads_bt_32_r201_m335,1,easy_bots,5_vs_5
462,1,1,m_sp_arch_medium_heads_bt_32_r201_m335,0,easy_bots,5_vs_5
463,0,2,m_sp_arch_medium_heads_bt_32_r201_m335,2,easy_bots,5_vs_5
464,1,1,m_sp_arch_medium_heads_bt_32_r201_m335,0,easy_bots,5_vs_5
465,3,3,m_sp_arch_medium_heads_bt_32_r201_m335,0,easy_bots,5_vs_5
466,-1,2,m_sp_arch_medium_heads_bt_32_r201_m335,3,easy_bots,5_vs_5
467,-1,0,m_sp_arch_medium_heads_bt_32_r201_m335,1,easy_bots,5_vs_5
468,-1,3,m_sp_arch_medium_heads_bt_32_r201_m335,4,easy_bots,5_vs_5
469,0,1,m_sp_arch_medium_heads_bt_32_r201_m335,1,easy_bots,5_vs_5
470,0,1,m_sp_arch_medium_heads_bt_32_r201_m335,1,easy_bots,5_vs_5
471,1,2,m_sp_arch_medium_heads_bt_32_r201_m335,1,easy_bots,5_vs_5
472,0,1,m_sp_arch_medium_heads_bt_32_r201_m335,1,easy_bots,5_vs_5
473,0,0,m_sp_arch_medium_heads_bt_32_r201_m335,0,easy_bots,5_vs_5
474,-1,1,m_sp_arch_medium_heads_bt_32_r201_m335,2,easy_bots,5_vs_5
475,-2,0,m_sp_arch_medium_heads_bt_32_r201_m335,2,easy_bots,5_vs_5
476,-2,2,m_sp_arch_medium_heads_bt_32_r201_m335,4,easy_bots,5_vs_5
477,0,2,m_sp_arch_medium_heads_bt_32_r201_m335,2,easy_bots,5_vs_5
478,0,0,m_sp_arch_medium_heads_bt_32_r201_m335,0,easy_bots,5_vs_5
479,1,2,m_sp_arch_medium_heads_bt_32_r201_m335,1,easy_bots,5_vs_5
480,-3,0,m_sp_arch_medium_heads_bt_32_r201_m335,3,medium_bots,5_vs_5_medium
481,-2,2,m_sp_arch_medium_heads_bt_32_r201_m335,4,medium_bots,5_vs_5_medium
482,0,0,m_sp_arch_medium_heads_bt_32_r201_m335,0,medium_bots,5_vs_5_medium
483,-3,1,m_sp_arch_medium_heads_bt_32_r201_m335,4,medium_bots,5_vs_5_medium
484,-1,0,m_sp_arch_medium_heads_bt_32_r201_m335,1,medium_bots,5_vs_5_medium
485,-3,0,m_sp_arch_medium_heads_bt_32_r201_m335,3,medium_bots,5_vs_5_medium
486,0,1,m_sp_arch_medium_heads_bt_32_r201_m335,1,medium_bots,5_vs_5_medium
487,-2,1,m_sp_arch_medium_heads_bt_32_r201_m335,3,medium_bots,5_vs_5_medium
488,-3,0,m_sp_arch_medium_heads_bt_32_r201_m335,3,medium_bots,5_vs_5_medium
489,-1,1,m_sp_arch_medium_heads_bt_32_r201_m335,2,medium_bots,5_vs_5_medium
490,2,3,m_sp_arch_medium_heads_bt_32_r201_m335,1,medium_bots,5_vs_5_medium
491,0,1,m_sp_arch_medium_heads_bt_32_r201_m335,1,medium_bots,5_vs_5_medium
492,-1,0,m_sp_arch_medium_heads_bt_32_r201_m335,1,medium_bots,5_vs_5_medium
493,-1,2,m_sp_arch_medium_heads_bt_32_r201_m335,3,medium_bots,5_vs_5_medium
494,-2,0,m_sp_arch_medium_heads_bt_32_r201_m335,2,medium_bots,5_vs_5_medium
495,-1,0,m_sp_arch_medium_heads_bt_32_r201_m335,1,medium_bots,5_vs_5_medium
496,-2,0,m_sp_arch_medium_heads_bt_32_r201_m335,2,medium_bots,5_vs_5_medium
497,-2,0,m_sp_arch_medium_heads_bt_32_r201_m335,2,medium_bots,5_vs_5_medium
498,-1,0,m_sp_arch_medium_heads_bt_32_r201_m335,1,medium_bots,5_vs_5_medium
499,0,1,m_sp_arch_medium_heads_bt_32_r201_m335,1,medium_bots,5_vs_5_medium
500,-1,0,m_sp_arch_medium_heads_bt_32_r201_m335,1,hard_bots,5_vs_5_hard
501,-3,1,m_sp_arch_medium_heads_bt_32_r201_m335,4,hard_bots,5_vs_5_hard
502,-1,1,m_sp_arch_medium_heads_bt_32_r201_m335,2,hard_bots,5_vs_5_hard
503,-4,0,m_sp_arch_medium_heads_bt_32_r201_m335,4,hard_bots,5_vs_5_hard
504,0,1,m_sp_arch_medium_heads_bt_32_r201_m335,1,hard_bots,5_vs_5_hard
505,-2,0,m_sp_arch_medium_heads_bt_32_r201_m335,2,hard_bots,5_vs_5_hard
506,0,1,m_sp_arch_medium_heads_bt_32_r201_m335,1,hard_bots,5_vs_5_hard
507,0,1,m_sp_arch_medium_heads_bt_32_r201_m335,1,hard_bots,5_vs_5_hard
508,-3,0,m_sp_arch_medium_heads_bt_32_r201_m335,3,hard_bots,5_vs_5_hard
509,-4,0,m_sp_arch_medium_heads_bt_32_r201_m335,4,hard_bots,5_vs_5_hard
510,0,1,m_sp_arch_medium_heads_bt_32_r201_m335,1,hard_bots,5_vs_5_hard
511,-1,2,m_sp_arch_medium_heads_bt_32_r201_m335,3,hard_bots,5_vs_5_hard
512,-1,0,m_sp_arch_medium_heads_bt_32_r201_m335,1,hard_bots,5_vs_5_hard
513,-2,0,m_sp_arch_medium_heads_bt_32_r201_m335,2,hard_bots,5_vs_5_hard
514,-3,2,m_sp_arch_medium_heads_bt_32_r201_m335,5,hard_bots,5_vs_5_hard
515,0,0,m_sp_arch_medium_heads_bt_32_r201_m335,0,hard_bots,5_vs_5_hard
516,-1,0,m_sp_arch_medium_heads_bt_32_r201_m335,1,hard_bots,5_vs_5_hard
517,-2,0,m_sp_arch_medium_heads_bt_32_r201_m335,2,hard_bots,5_vs_5_hard
518,-1,1,m_sp_arch_medium_heads_bt_32_r201_m335,2,hard_bots,5_vs_5_hard
519,-2,0,m_sp_arch_medium_heads_bt_32_r201_m335,2,hard_bots,5_vs_5_hard
520,7,7,m_sp_arch_medium_heads_bt_32_r201_m335,0,f5v0to1to2t05_e2_ckpt291,5_vs_5
521,3,5,m_sp_arch_medium_heads_bt_32_r201_m335,2,f5v0to1to2t05_e2_ckpt291,5_vs_5
522,7,9,m_sp_arch_medium_heads_bt_32_r201_m335,2,f5v0to1to2t05_e2_ckpt291,5_vs_5
523,7,10,m_sp_arch_medium_heads_bt_32_r201_m335,3,f5v0to1to2t05_e2_ckpt291,5_vs_5
524,1,5,m_sp_arch_medium_heads_bt_32_r201_m335,4,f5v0to1to2t05_e2_ckpt291,5_vs_5
525,2,3,m_sp_arch_medium_heads_bt_32_r201_m335,1,f5v0to1to2t05_e2_ckpt291,5_vs_5
526,6,6,m_sp_arch_medium_heads_bt_32_r201_m335,0,f5v0to1to2t05_e2_ckpt291,5_vs_5
527,2,4,m_sp_arch_medium_heads_bt_32_r201_m335,2,f5v0to1to2t05_e2_ckpt291,5_vs_5
528,2,4,m_sp_arch_medium_heads_bt_32_r201_m335,2,f5v0to1to2t05_e2_ckpt291,5_vs_5
529,3,5,m_sp_arch_medium_heads_bt_32_r201_m335,2,f5v0to1to2t05_e2_ckpt291,5_vs_5
530,4,6,m_sp_arch_medium_heads_bt_32_r201_m335,2,f5v0to1to5_e2_ckpt252,5_vs_5
531,3,4,m_sp_arch_medium_heads_bt_32_r201_m335,1,f5v0to1to5_e2_ckpt252,5_vs_5
532,4,5,m_sp_arch_medium_heads_bt_32_r201_m335,1,f5v0to1to5_e2_ckpt252,5_vs_5
533,3,5,m_sp_arch_medium_heads_bt_32_r201_m335,2,f5v0to1to5_e2_ckpt252,5_vs_5
534,5,6,m_sp_arch_medium_heads_bt_32_r201_m335,1,f5v0to1to5_e2_ckpt252,5_vs_5
535,4,4,m_sp_arch_medium_heads_bt_32_r201_m335,0,f5v0to1to5_e2_ckpt252,5_vs_5
536,4,6,m_sp_arch_medium_heads_bt_32_r201_m335,2,f5v0to1to5_e2_ckpt252,5_vs_5
537,4,5,m_sp_arch_medium_heads_bt_32_r201_m335,1,f5v0to1to5_e2_ckpt252,5_vs_5
538,4,5,m_sp_arch_medium_heads_bt_32_r201_m335,1,f5v0to1to5_e2_ckpt252,5_vs_5
539,1,3,m_sp_arch_medium_heads_bt_32_r201_m335,2,f5v0to1to5_e2_ckpt252,5_vs_5
540,7,7,m_sp_arch_medium_heads_bt_32_r201_m335,0,scon_e3_p2_hard_ckpt840,5_vs_5
541,5,7,m_sp_arch_medium_heads_bt_32_r201_m335,2,scon_e3_p2_hard_ckpt840,5_vs_5
542,4,6,m_sp_arch_medium_heads_bt_32_r201_m335,2,scon_e3_p2_hard_ckpt840,5_vs_5
543,5,5,m_sp_arch_medium_heads_bt_32_r201_m335,0,scon_e3_p2_hard_ckpt840,5_vs_5
544,7,8,m_sp_arch_medium_heads_bt_32_r201_m335,1,scon_e3_p2_hard_ckpt840,5_vs_5
545,10,11,m_sp_arch_medium_heads_bt_32_r201_m335,1,scon_e3_p2_hard_ckpt840,5_vs_5
546,9,10,m_sp_arch_medium_heads_bt_32_r201_m335,1,scon_e3_p2_hard_ckpt840,5_vs_5
547,4,5,m_sp_arch_medium_heads_bt_32_r201_m335,1,scon_e3_p2_hard_ckpt840,5_vs_5
548,6,7,m_sp_arch_medium_heads_bt_32_r201_m335,1,scon_e3_p2_hard_ckpt840,5_vs_5
549,6,6,m_sp_arch_medium_heads_bt_32_r201_m335,0,scon_e3_p2_hard_ckpt840,5_vs_5
550,2,7,m_sp_arch_medium_heads_bt_32_r201_m335,5,less_then_partially_randomized_checkpoints_bots_4_heads_38_ckpt108,5_vs_5
551,6,6,m_sp_arch_medium_heads_bt_32_r201_m335,0,less_then_partially_randomized_checkpoints_bots_4_heads_38_ckpt108,5_vs_5
552,4,6,m_sp_arch_medium_heads_bt_32_r201_m335,2,less_then_partially_randomized_checkpoints_bots_4_heads_38_ckpt108,5_vs_5
553,7,8,m_sp_arch_medium_heads_bt_32_r201_m335,1,less_then_partially_randomized_checkpoints_bots_4_heads_38_ckpt108,5_vs_5
554,5,6,m_sp_arch_medium_heads_bt_32_r201_m335,1,less_then_partially_randomized_checkpoints_bots_4_heads_38_ckpt108,5_vs_5
555,5,7,m_sp_arch_medium_heads_bt_32_r201_m335,2,less_then_partially_randomized_checkpoints_bots_4_heads_38_ckpt108,5_vs_5
556,5,8,m_sp_arch_medium_heads_bt_32_r201_m335,3,less_then_partially_randomized_checkpoints_bots_4_heads_38_ckpt108,5_vs_5
557,7,8,m_sp_arch_medium_heads_bt_32_r201_m335,1,less_then_partially_randomized_checkpoints_bots_4_heads_38_ckpt108,5_vs_5
558,10,11,m_sp_arch_medium_heads_bt_32_r201_m335,1,less_then_partially_randomized_checkpoints_bots_4_heads_38_ckpt108,5_vs_5
559,7,10,m_sp_arch_medium_heads_bt_32_r201_m335,3,less_then_partially_randomized_checkpoints_bots_4_heads_38_ckpt108,5_vs_5
560,7,7,m_sp_arch_medium_heads_bt_32_r201_m335,0,less_then_partially_randomized_entropy_checkpoints_bots_4_heads_39_ckpt109,5_vs_5
561,3,4,m_sp_arch_medium_heads_bt_32_r201_m335,1,less_then_partially_randomized_entropy_checkpoints_bots_4_heads_39_ckpt109,5_vs_5
562,8,8,m_sp_arch_medium_heads_bt_32_r201_m335,0,less_then_partially_randomized_entropy_checkpoints_bots_4_heads_39_ckpt109,5_vs_5
563,7,8,m_sp_arch_medium_heads_bt_32_r201_m335,1,less_then_partially_randomized_entropy_checkpoints_bots_4_heads_39_ckpt109,5_vs_5
564,7,7,m_sp_arch_medium_heads_bt_32_r201_m335,0,less_then_partially_randomized_entropy_checkpoints_bots_4_heads_39_ckpt109,5_vs_5
565,5,8,m_sp_arch_medium_heads_bt_32_r201_m335,3,less_then_partially_randomized_entropy_checkpoints_bots_4_heads_39_ckpt109,5_vs_5
566,4,4,m_sp_arch_medium_heads_bt_32_r201_m335,0,less_then_partially_randomized_entropy_checkpoints_bots_4_heads_39_ckpt109,5_vs_5
567,7,9,m_sp_arch_medium_heads_bt_32_r201_m335,2,less_then_partially_randomized_entropy_checkpoints_bots_4_heads_39_ckpt109,5_vs_5
568,4,6,m_sp_arch_medium_heads_bt_32_r201_m335,2,less_then_partially_randomized_entropy_checkpoints_bots_4_heads_39_ckpt109,5_vs_5
569,7,8,m_sp_arch_medium_heads_bt_32_r201_m335,1,less_then_partially_randomized_entropy_checkpoints_bots_4_heads_39_ckpt109,5_vs_5
570,5,6,m_sp_arch_medium_heads_bt_32_r201_m335,1,reward_shaping_checkpoints_bots_4_heads_1_ckpt360,5_vs_5
571,6,6,m_sp_arch_medium_heads_bt_32_r201_m335,0,reward_shaping_checkpoints_bots_4_heads_1_ckpt360,5_vs_5
572,2,2,m_sp_arch_medium_heads_bt_32_r201_m335,0,reward_shaping_checkpoints_bots_4_heads_1_ckpt360,5_vs_5
573,10,10,m_sp_arch_medium_heads_bt_32_r201_m335,0,reward_shaping_checkpoints_bots_4_heads_1_ckpt360,5_vs_5
574,6,7,m_sp_arch_medium_heads_bt_32_r201_m335,1,reward_shaping_checkpoints_bots_4_heads_1_ckpt360,5_vs_5
575,7,7,m_sp_arch_medium_heads_bt_32_r201_m335,0,reward_shaping_checkpoints_bots_4_heads_1_ckpt360,5_vs_5
576,8,9,m_sp_arch_medium_heads_bt_32_r201_m335,1,reward_shaping_checkpoints_bots_4_heads_1_ckpt360,5_vs_5
577,7,7,m_sp_arch_medium_heads_bt_32_r201_m335,0,reward_shaping_checkpoints_bots_4_heads_1_ckpt360,5_vs_5
578,10,12,m_sp_arch_medium_heads_bt_32_r201_m335,2,reward_shaping_checkpoints_bots_4_heads_1_ckpt360,5_vs_5
579,6,6,m_sp_arch_medium_heads_bt_32_r201_m335,0,reward_shaping_checkpoints_bots_4_heads_1_ckpt360,5_vs_5
580,-1,2,m_sp_arch_medium_heads_bt_32_r201_m335,3,checkpoints_selfplay_e9_sp_ckpt274,5_vs_5
581,-1,3,m_sp_arch_medium_heads_bt_32_r201_m335,4,checkpoints_selfplay_e9_sp_ckpt274,5_vs_5
582,-2,4,m_sp_arch_medium_heads_bt_32_r201_m335,6,checkpoints_selfplay_e9_sp_ckpt274,5_vs_5
583,-1,3,m_sp_arch_medium_heads_bt_32_r201_m335,4,checkpoints_selfplay_e9_sp_ckpt274,5_vs_5
584,-1,2,m_sp_arch_medium_heads_bt_32_r201_m335,3,checkpoints_selfplay_e9_sp_ckpt274,5_vs_5
585,2,6,m_sp_arch_medium_heads_bt_32_r201_m335,4,checkpoints_selfplay_e9_sp_ckpt274,5_vs_5
586,1,3,m_sp_arch_medium_heads_bt_32_r201_m335,2,checkpoints_selfplay_e9_sp_ckpt274,5_vs_5
587,-3,1,m_sp_arch_medium_heads_bt_32_r201_m335,4,checkpoints_selfplay_e9_sp_ckpt274,5_vs_5
588,-2,4,m_sp_arch_medium_heads_bt_32_r201_m335,6,checkpoints_selfplay_e9_sp_ckpt274,5_vs_5
589,-1,2,m_sp_arch_medium_heads_bt_32_r201_m335,3,checkpoints_selfplay_e9_sp_ckpt274,5_vs_5
590,-3,0,m_sp_arch_medium_heads_bt_32_r201_m335,3,checkpoints_sp_c_nb_e2_ckpt667,5_vs_5
591,-4,2,m_sp_arch_medium_heads_bt_32_r201_m335,6,checkpoints_sp_c_nb_e2_ckpt667,5_vs_5
592,0,3,m_sp_arch_medium_heads_bt_32_r201_m335,3,checkpoints_sp_c_nb_e2_ckpt667,5_vs_5
593,-1,0,m_sp_arch_medium_heads_bt_32_r201_m335,1,checkpoints_sp_c_nb_e2_ckpt667,5_vs_5
594,-1,2,m_sp_arch_medium_heads_bt_32_r201_m335,3,checkpoints_sp_c_nb_e2_ckpt667,5_vs_5
595,-4,2,m_sp_arch_medium_heads_bt_32_r201_m335,6,checkpoints_sp_c_nb_e2_ckpt667,5_vs_5
596,-1,3,m_sp_arch_medium_heads_bt_32_r201_m335,4,checkpoints_sp_c_nb_e2_ckpt667,5_vs_5
597,-2,2,m_sp_arch_medium_heads_bt_32_r201_m335,4,checkpoints_sp_c_nb_e2_ckpt667,5_vs_5
598,-7,0,m_sp_arch_medium_heads_bt_32_r201_m335,7,checkpoints_sp_c_nb_e2_ckpt667,5_vs_5
599,-6,3,m_sp_arch_medium_heads_bt_32_r201_m335,9,checkpoints_sp_c_nb_e2_ckpt667,5_vs_5
600,1,1,m_sp_arch_medium_heads_bt_32_r201_m335,0,scenario_curriculum_ckpt830,5_vs_5
601,2,2,m_sp_arch_medium_heads_bt_32_r201_m335,0,scenario_curriculum_ckpt830,5_vs_5
602,3,3,m_sp_arch_medium_heads_bt_32_r201_m335,0,scenario_curriculum_ckpt830,5_vs_5
603,1,1,m_sp_arch_medium_heads_bt_32_r201_m335,0,scenario_curriculum_ckpt830,5_vs_5
604,1,1,m_sp_arch_medium_heads_bt_32_r201_m335,0,scenario_curriculum_ckpt830,5_vs_5
605,2,2,m_sp_arch_medium_heads_bt_32_r201_m335,0,scenario_curriculum_ckpt830,5_vs_5
606,1,1,m_sp_arch_medium_heads_bt_32_r201_m335,0,scenario_curriculum_ckpt830,5_vs_5
607,8,8,m_sp_arch_medium_heads_bt_32_r201_m335,0,scenario_curriculum_ckpt830,5_vs_5
608,5,5,m_sp_arch_medium_heads_bt_32_r201_m335,0,scenario_curriculum_ckpt830,5_vs_5
609,0,0,m_sp_arch_medium_heads_bt_32_r201_m335,0,scenario_curriculum_ckpt830,5_vs_5
610,-1,2,m_sp_arch_medium_heads_bt_32_r201_m335,3,m_sp_arch_medium_heads_conv16_0_bt_32_r313_m335,5_vs_5
611,-1,4,m_sp_arch_medium_heads_bt_32_r201_m335,5,m_sp_arch_medium_heads_conv16_0_bt_32_r313_m335,5_vs_5
612,-4,0,m_sp_arch_medium_heads_bt_32_r201_m335,4,m_sp_arch_medium_heads_conv16_0_bt_32_r313_m335,5_vs_5
613,0,1,m_sp_arch_medium_heads_bt_32_r201_m335,1,m_sp_arch_medium_heads_conv16_0_bt_32_r313_m335,5_vs_5
614,-2,1,m_sp_arch_medium_heads_bt_32_r201_m335,3,m_sp_arch_medium_heads_conv16_0_bt_32_r313_m335,5_vs_5
615,-1,0,m_sp_arch_medium_heads_bt_32_r201_m335,1,m_sp_arch_medium_heads_conv16_0_bt_32_r313_m335,5_vs_5
616,-2,1,m_sp_arch_medium_heads_bt_32_r201_m335,3,m_sp_arch_medium_heads_conv16_0_bt_32_r313_m335,5_vs_5
617,-2,1,m_sp_arch_medium_heads_bt_32_r201_m335,3,m_sp_arch_medium_heads_conv16_0_bt_32_r313_m335,5_vs_5
618,-2,0,m_sp_arch_medium_heads_bt_32_r201_m335,2,m_sp_arch_medium_heads_conv16_0_bt_32_r313_m335,5_vs_5
619,-3,0,m_sp_arch_medium_heads_bt_32_r201_m335,3,m_sp_arch_medium_heads_conv16_0_bt_32_r313_m335,5_vs_5
620,0,2,m_sp_arch_medium_heads_bt_32_r201_m335,2,m_sp_arch_longer_heads_bt_32_r201_m335,5_vs_5
621,1,4,m_sp_arch_medium_heads_bt_32_r201_m335,3,m_sp_arch_longer_heads_bt_32_r201_m335,5_vs_5
622,-2,1,m_sp_arch_medium_heads_bt_32_r201_m335,3,m_sp_arch_longer_heads_bt_32_r201_m335,5_vs_5
623,1,3,m_sp_arch_medium_heads_bt_32_r201_m335,2,m_sp_arch_longer_heads_bt_32_r201_m335,5_vs_5
624,-2,1,m_sp_arch_medium_heads_bt_32_r201_m335,3,m_sp_arch_longer_heads_bt_32_r201_m335,5_vs_5
625,2,5,m_sp_arch_medium_heads_bt_32_r201_m335,3,m_sp_arch_longer_heads_bt_32_r201_m335,5_vs_5
626,3,5,m_sp_arch_medium_heads_bt_32_r201_m335,2,m_sp_arch_longer_heads_bt_32_r201_m335,5_vs_5
627,-1,0,m_sp_arch_medium_heads_bt_32_r201_m335,1,m_sp_arch_longer_heads_bt_32_r201_m335,5_vs_5
628,-1,1,m_sp_arch_medium_heads_bt_32_r201_m335,2,m_sp_arch_longer_heads_bt_32_r201_m335,5_vs_5
629,2,3,m_sp_arch_medium_heads_bt_32_r201_m335,1,m_sp_arch_longer_heads_bt_32_r201_m335,5_vs_5
630,-1,1,m_sp_arch_medium_heads_bt_32_r201_m335,2,m_sp_arch_medium_heads_bt_32_r201_m335,5_vs_5
631,-1,0,m_sp_arch_medium_heads_bt_32_r201_m335,1,m_sp_arch_medium_heads_bt_32_r201_m335,5_vs_5
632,1,3,m_sp_arch_medium_heads_bt_32_r201_m335,2,m_sp_arch_medium_heads_bt_32_r201_m335,5_vs_5
633,-1,0,m_sp_arch_medium_heads_bt_32_r201_m335,1,m_sp_arch_medium_heads_bt_32_r201_m335,5_vs_5
634,-1,0,m_sp_arch_medium_heads_bt_32_r201_m335,1,m_sp_arch_medium_heads_bt_32_r201_m335,5_vs_5
635,3,3,m_sp_arch_medium_heads_bt_32_r201_m335,0,m_sp_arch_medium_heads_bt_32_r201_m335,5_vs_5
636,0,1,m_sp_arch_medium_heads_bt_32_r201_m335,1,m_sp_arch_medium_heads_bt_32_r201_m335,5_vs_5
637,-2,1,m_sp_arch_medium_heads_bt_32_r201_m335,3,m_sp_arch_medium_heads_bt_32_r201_m335,5_vs_5
638,0,3,m_sp_arch_medium_heads_bt_32_r201_m335,3,m_sp_arch_medium_heads_bt_32_r201_m335,5_vs_5
639,0,3,m_sp_arch_medium_heads_bt_32_r201_m335,3,m_sp_arch_medium_heads_bt_32_r201_m335,5_vs_5
640,-7,0,m_sp_arch_medium_heads_bt_32_r201_m335,7,m_sp_arch_4x1_bt_32_r201_m335,5_vs_5
641,-5,0,m_sp_arch_medium_heads_bt_32_r201_m335,5,m_sp_arch_4x1_bt_32_r201_m335,5_vs_5
642,-5,1,m_sp_arch_medium_heads_bt_32_r201_m335,6,m_sp_arch_4x1_bt_32_r201_m335,5_vs_5
643,-6,1,m_sp_arch_medium_heads_bt_32_r201_m335,7,m_sp_arch_4x1_bt_32_r201_m335,5_vs_5
644,-4,0,m_sp_arch_medium_heads_bt_32_r201_m335,4,m_sp_arch_4x1_bt_32_r201_m335,5_vs_5
645,-6,0,m_sp_arch_medium_heads_bt_32_r201_m335,6,m_sp_arch_4x1_bt_32_r201_m335,5_vs_5
646,-8,0,m_sp_arch_medium_heads_bt_32_r201_m335,8,m_sp_arch_4x1_bt_32_r201_m335,5_vs_5
647,-5,0,m_sp_arch_medium_heads_bt_32_r201_m335,5,m_sp_arch_4x1_bt_32_r201_m335,5_vs_5
648,-7,0,m_sp_arch_medium_heads_bt_32_r201_m335,7,m_sp_arch_4x1_bt_32_r201_m335,5_vs_5
649,-1,1,m_sp_arch_medium_heads_bt_32_r201_m335,2,m_sp_arch_4x1_bt_32_r201_m335,5_vs_5
650,-5,1,m_sp_arch_medium_heads_bt_32_r201_m335,6,m_sp_arch_4x1_bt_32_r201_cont3_m650,5_vs_5
651,-4,1,m_sp_arch_medium_heads_bt_32_r201_m335,5,m_sp_arch_4x1_bt_32_r201_cont3_m650,5_vs_5
652,-3,1,m_sp_arch_medium_heads_bt_32_r201_m335,4,m_sp_arch_4x1_bt_32_r201_cont3_m650,5_vs_5
653,-11,0,m_sp_arch_medium_heads_bt_32_r201_m335,11,m_sp_arch_4x1_bt_32_r201_cont3_m650,5_vs_5
654,-2,0,m_sp_arch_medium_heads_bt_32_r201_m335,2,m_sp_arch_4x1_bt_32_r201_cont3_m650,5_vs_5
655,-8,0,m_sp_arch_medium_heads_bt_32_r201_m335,8,m_sp_arch_4x1_bt_32_r201_cont3_m650,5_vs_5
656,-2,0,m_sp_arch_medium_heads_bt_32_r201_m335,2,m_sp_arch_4x1_bt_32_r201_cont3_m650,5_vs_5
657,-4,1,m_sp_arch_medium_heads_bt_32_r201_m335,5,m_sp_arch_4x1_bt_32_r201_cont3_m650,5_vs_5
658,-5,0,m_sp_arch_medium_heads_bt_32_r201_m335,5,m_sp_arch_4x1_bt_32_r201_cont3_m650,5_vs_5
659,-5,1,m_sp_arch_medium_heads_bt_32_r201_m335,6,m_sp_arch_4x1_bt_32_r201_cont3_m650,5_vs_5
660,-2,0,m_sp_arch_medium_heads_bt_32_r201_m335,2,explt_v0_7_2_m54,5_vs_5
661,-2,1,m_sp_arch_medium_heads_bt_32_r201_m335,3,explt_v0_7_2_m54,5_vs_5
662,1,2,m_sp_arch_medium_heads_bt_32_r201_m335,1,explt_v0_7_2_m54,5_vs_5
663,-3,0,m_sp_arch_medium_heads_bt_32_r201_m335,3,explt_v0_7_2_m54,5_vs_5
664,-4,0,m_sp_arch_medium_heads_bt_32_r201_m335,4,explt_v0_7_2_m54,5_vs_5
665,-2,1,m_sp_arch_medium_heads_bt_32_r201_m335,3,explt_v0_7_2_m54,5_vs_5
666,-6,0,m_sp_arch_medium_heads_bt_32_r201_m335,6,explt_v0_7_2_m54,5_vs_5
667,-4,0,m_sp_arch_medium_heads_bt_32_r201_m335,4,explt_v0_7_2_m54,5_vs_5
668,-1,1,m_sp_arch_medium_heads_bt_32_r201_m335,2,explt_v0_7_2_m54,5_vs_5
669,-4,1,m_sp_arch_medium_heads_bt_32_r201_m335,5,explt_v0_7_2_m54,5_vs_5
670,-3,2,m_sp_arch_medium_heads_bt_32_r201_m335,5,m_sp_sc3v3_arch_2x1_32_r500_cont4x1_m224,5_vs_5
671,-6,0,m_sp_arch_medium_heads_bt_32_r201_m335,6,m_sp_sc3v3_arch_2x1_32_r500_cont4x1_m224,5_vs_5
672,-3,2,m_sp_arch_medium_heads_bt_32_r201_m335,5,m_sp_sc3v3_arch_2x1_32_r500_cont4x1_m224,5_vs_5
673,0,3,m_sp_arch_medium_heads_bt_32_r201_m335,3,m_sp_sc3v3_arch_2x1_32_r500_cont4x1_m224,5_vs_5
674,-6,1,m_sp_arch_medium_heads_bt_32_r201_m335,7,m_sp_sc3v3_arch_2x1_32_r500_cont4x1_m224,5_vs_5
675,-2,3,m_sp_arch_medium_heads_bt_32_r201_m335,5,m_sp_sc3v3_arch_2x1_32_r500_cont4x1_m224,5_vs_5
676,-5,3,m_sp_arch_medium_heads_bt_32_r201_m335,8,m_sp_sc3v3_arch_2x1_32_r500_cont4x1_m224,5_vs_5
677,-2,3,m_sp_arch_medium_heads_bt_32_r201_m335,5,m_sp_sc3v3_arch_2x1_32_r500_cont4x1_m224,5_vs_5
678,-5,2,m_sp_arch_medium_heads_bt_32_r201_m335,7,m_sp_sc3v3_arch_2x1_32_r500_cont4x1_m224,5_vs_5
679,-3,1,m_sp_arch_medium_heads_bt_32_r201_m335,4,m_sp_sc3v3_arch_2x1_32_r500_cont4x1_m224,5_vs_5
680,-7,1,m_sp_arch_medium_heads_bt_32_r201_m335,8,m_sp_arch_4x1_bt_32_roles_r500_m335,5_vs_5
681,-6,0,m_sp_arch_medium_heads_bt_32_r201_m335,6,m_sp_arch_4x1_bt_32_roles_r500_m335,5_vs_5
682,-8,1,m_sp_arch_medium_heads_bt_32_r201_m335,9,m_sp_arch_4x1_bt_32_roles_r500_m335,5_vs_5
683,-4,1,m_sp_arch_medium_heads_bt_32_r201_m335,5,m_sp_arch_4x1_bt_32_roles_r500_m335,5_vs_5
684,-7,0,m_sp_arch_medium_heads_bt_32_r201_m335,7,m_sp_arch_4x1_bt_32_roles_r500_m335,5_vs_5
685,-7,0,m_sp_arch_medium_heads_bt_32_r201_m335,7,m_sp_arch_4x1_bt_32_roles_r500_m335,5_vs_5
686,-4,3,m_sp_arch_medium_heads_bt_32_r201_m335,7,m_sp_arch_4x1_bt_32_roles_r500_m335,5_vs_5
687,-5,0,m_sp_arch_medium_heads_bt_32_r201_m335,5,m_sp_arch_4x1_bt_32_roles_r500_m335,5_vs_5
688,-9,0,m_sp_arch_medium_heads_bt_32_r201_m335,9,m_sp_arch_4x1_bt_32_roles_r500_m335,5_vs_5
689,-9,0,m_sp_arch_medium_heads_bt_32_r201_m335,9,m_sp_arch_4x1_bt_32_roles_r500_m335,5_vs_5
690,0,4,checkpoints_selfplay_e9_sp_ckpt335_1370M,4,easy_bots,5_vs_5
691,1,3,checkpoints_selfplay_e9_sp_ckpt335_1370M,2,easy_bots,5_vs_5
692,4,5,checkpoints_selfplay_e9_sp_ckpt335_1370M,1,easy_bots,5_vs_5
693,1,2,checkpoints_selfplay_e9_sp_ckpt335_1370M,1,easy_bots,5_vs_5
694,2,2,checkpoints_selfplay_e9_sp_ckpt335_1370M,0,easy_bots,5_vs_5
695,0,2,checkpoints_selfplay_e9_sp_ckpt335_1370M,2,easy_bots,5_vs_5
696,0,3,checkpoints_selfplay_e9_sp_ckpt335_1370M,3,easy_bots,5_vs_5
697,1,2,checkpoints_selfplay_e9_sp_ckpt335_1370M,1,easy_bots,5_vs_5
698,1,2,checkpoints_selfplay_e9_sp_ckpt335_1370M,1,easy_bots,5_vs_5
699,-2,1,checkpoints_selfplay_e9_sp_ckpt335_1370M,3,easy_bots,5_vs_5
700,-1,3,checkpoints_selfplay_e9_sp_ckpt335_1370M,4,easy_bots,5_vs_5
701,3,3,checkpoints_selfplay_e9_sp_ckpt335_1370M,0,easy_bots,5_vs_5
702,3,4,checkpoints_selfplay_e9_sp_ckpt335_1370M,1,easy_bots,5_vs_5
703,2,2,checkpoints_selfplay_e9_sp_ckpt335_1370M,0,easy_bots,5_vs_5
704,3,5,checkpoints_selfplay_e9_sp_ckpt335_1370M,2,easy_bots,5_vs_5
705,-1,1,checkpoints_selfplay_e9_sp_ckpt335_1370M,2,easy_bots,5_vs_5
706,2,6,checkpoints_selfplay_e9_sp_ckpt335_1370M,4,easy_bots,5_vs_5
707,0,1,checkpoints_selfplay_e9_sp_ckpt335_1370M,1,easy_bots,5_vs_5
708,4,5,checkpoints_selfplay_e9_sp_ckpt335_1370M,1,easy_bots,5_vs_5
709,1,2,checkpoints_selfplay_e9_sp_ckpt335_1370M,1,easy_bots,5_vs_5
710,1,3,checkpoints_selfplay_e9_sp_ckpt335_1370M,2,medium_bots,5_vs_5_medium
711,-2,1,checkpoints_selfplay_e9_sp_ckpt335_1370M,3,medium_bots,5_vs_5_medium
712,0,2,checkpoints_selfplay_e9_sp_ckpt335_1370M,2,medium_bots,5_vs_5_medium
713,1,4,checkpoints_selfplay_e9_sp_ckpt335_1370M,3,medium_bots,5_vs_5_medium
714,1,2,checkpoints_selfplay_e9_sp_ckpt335_1370M,1,medium_bots,5_vs_5_medium
715,-3,3,checkpoints_selfplay_e9_sp_ckpt335_1370M,6,medium_bots,5_vs_5_medium
716,-1,0,checkpoints_selfplay_e9_sp_ckpt335_1370M,1,medium_bots,5_vs_5_medium
717,1,1,checkpoints_selfplay_e9_sp_ckpt335_1370M,0,medium_bots,5_vs_5_medium
718,1,1,checkpoints_selfplay_e9_sp_ckpt335_1370M,0,medium_bots,5_vs_5_medium
719,0,1,checkpoints_selfplay_e9_sp_ckpt335_1370M,1,medium_bots,5_vs_5_medium
720,-1,1,checkpoints_selfplay_e9_sp_ckpt335_1370M,2,medium_bots,5_vs_5_medium
721,1,2,checkpoints_selfplay_e9_sp_ckpt335_1370M,1,medium_bots,5_vs_5_medium
722,0,1,checkpoints_selfplay_e9_sp_ckpt335_1370M,1,medium_bots,5_vs_5_medium
723,-2,1,checkpoints_selfplay_e9_sp_ckpt335_1370M,3,medium_bots,5_vs_5_medium
724,0,1,checkpoints_selfplay_e9_sp_ckpt335_1370M,1,medium_bots,5_vs_5_medium
725,-1,1,checkpoints_selfplay_e9_sp_ckpt335_1370M,2,medium_bots,5_vs_5_medium
726,0,2,checkpoints_selfplay_e9_sp_ckpt335_1370M,2,medium_bots,5_vs_5_medium
727,-5,0,checkpoints_selfplay_e9_sp_ckpt335_1370M,5,medium_bots,5_vs_5_medium
728,1,1,checkpoints_selfplay_e9_sp_ckpt335_1370M,0,medium_bots,5_vs_5_medium
729,-1,0,checkpoints_selfplay_e9_sp_ckpt335_1370M,1,medium_bots,5_vs_5_medium
730,-3,0,checkpoints_selfplay_e9_sp_ckpt335_1370M,3,hard_bots,5_vs_5_hard
731,-4,0,checkpoints_selfplay_e9_sp_ckpt335_1370M,4,hard_bots,5_vs_5_hard
732,-2,1,checkpoints_selfplay_e9_sp_ckpt335_1370M,3,hard_bots,5_vs_5_hard
733,-1,0,checkpoints_selfplay_e9_sp_ckpt335_1370M,1,hard_bots,5_vs_5_hard
734,-3,0,checkpoints_selfplay_e9_sp_ckpt335_1370M,3,hard_bots,5_vs_5_hard
735,-2,1,checkpoints_selfplay_e9_sp_ckpt335_1370M,3,hard_bots,5_vs_5_hard
736,-3,0,checkpoints_selfplay_e9_sp_ckpt335_1370M,3,hard_bots,5_vs_5_hard
737,-1,1,checkpoints_selfplay_e9_sp_ckpt335_1370M,2,hard_bots,5_vs_5_hard
738,-3,0,checkpoints_selfplay_e9_sp_ckpt335_1370M,3,hard_bots,5_vs_5_hard
739,0,0,checkpoints_selfplay_e9_sp_ckpt335_1370M,0,hard_bots,5_vs_5_hard
740,-3,0,checkpoints_selfplay_e9_sp_ckpt335_1370M,3,hard_bots,5_vs_5_hard
741,-1,0,checkpoints_selfplay_e9_sp_ckpt335_1370M,1,hard_bots,5_vs_5_hard
742,0,2,checkpoints_selfplay_e9_sp_ckpt335_1370M,2,hard_bots,5_vs_5_hard
743,0,2,checkpoints_selfplay_e9_sp_ckpt335_1370M,2,hard_bots,5_vs_5_hard
744,-2,0,checkpoints_selfplay_e9_sp_ckpt335_1370M,2,hard_bots,5_vs_5_hard
745,-2,1,checkpoints_selfplay_e9_sp_ckpt335_1370M,3,hard_bots,5_vs_5_hard
746,-3,0,checkpoints_selfplay_e9_sp_ckpt335_1370M,3,hard_bots,5_vs_5_hard
747,-1,0,checkpoints_selfplay_e9_sp_ckpt335_1370M,1,hard_bots,5_vs_5_hard
748,-4,0,checkpoints_selfplay_e9_sp_ckpt335_1370M,4,hard_bots,5_vs_5_hard
749,-2,0,checkpoints_selfplay_e9_sp_ckpt335_1370M,2,hard_bots,5_vs_5_hard
750,12,12,checkpoints_selfplay_e9_sp_ckpt335_1370M,0,f5v0to1to2t05_e2_ckpt291,5_vs_5
751,6,8,checkpoints_selfplay_e9_sp_ckpt335_1370M,2,f5v0to1to2t05_e2_ckpt291,5_vs_5
752,11,13,checkpoints_selfplay_e9_sp_ckpt335_1370M,2,f5v0to1to2t05_e2_ckpt291,5_vs_5
753,4,5,checkpoints_selfplay_e9_sp_ckpt335_1370M,1,f5v0to1to2t05_e2_ckpt291,5_vs_5
754,10,12,checkpoints_selfplay_e9_sp_ckpt335_1370M,2,f5v0to1to2t05_e2_ckpt291,5_vs_5
755,4,6,checkpoints_selfplay_e9_sp_ckpt335_1370M,2,f5v0to1to2t05_e2_ckpt291,5_vs_5
756,2,3,checkpoints_selfplay_e9_sp_ckpt335_1370M,1,f5v0to1to2t05_e2_ckpt291,5_vs_5
757,7,8,checkpoints_selfplay_e9_sp_ckpt335_1370M,1,f5v0to1to2t05_e2_ckpt291,5_vs_5
758,7,9,checkpoints_selfplay_e9_sp_ckpt335_1370M,2,f5v0to1to2t05_e2_ckpt291,5_vs_5
759,4,6,checkpoints_selfplay_e9_sp_ckpt335_1370M,2,f5v0to1to2t05_e2_ckpt291,5_vs_5
760,4,7,checkpoints_selfplay_e9_sp_ckpt335_1370M,3,f5v0to1to2t05_e2_ckpt291,5_vs_5
761,4,6,checkpoints_selfplay_e9_sp_ckpt335_1370M,2,f5v0to1to2t05_e2_ckpt291,5_vs_5
762,10,11,checkpoints_selfplay_e9_sp_ckpt335_1370M,1,f5v0to1to2t05_e2_ckpt291,5_vs_5
763,7,9,checkpoints_selfplay_e9_sp_ckpt335_1370M,2,f5v0to1to2t05_e2_ckpt291,5_vs_5
764,10,10,checkpoints_selfplay_e9_sp_ckpt335_1370M,0,f5v0to1to2t05_e2_ckpt291,5_vs_5
765,5,6,checkpoints_selfplay_e9_sp_ckpt335_1370M,1,f5v0to1to2t05_e2_ckpt291,5_vs_5
766,11,13,checkpoints_selfplay_e9_sp_ckpt335_1370M,2,f5v0to1to2t05_e2_ckpt291,5_vs_5
767,10,10,checkpoints_selfplay_e9_sp_ckpt335_1370M,0,f5v0to1to2t05_e2_ckpt291,5_vs_5
768,9,10,checkpoints_selfplay_e9_sp_ckpt335_1370M,1,f5v0to1to2t05_e2_ckpt291,5_vs_5
769,11,12,checkpoints_selfplay_e9_sp_ckpt335_1370M,1,f5v0to1to2t05_e2_ckpt291,5_vs_5
770,6,8,checkpoints_selfplay_e9_sp_ckpt335_1370M,2,f5v0to1to5_e2_ckpt252,5_vs_5
771,10,11,checkpoints_selfplay_e9_sp_ckpt335_1370M,1,f5v0to1to5_e2_ckpt252,5_vs_5
772,9,10,checkpoints_selfplay_e9_sp_ckpt335_1370M,1,f5v0to1to5_e2_ckpt252,5_vs_5
773,0,4,checkpoints_selfplay_e9_sp_ckpt335_1370M,4,f5v0to1to5_e2_ckpt252,5_vs_5
774,5,7,checkpoints_selfplay_e9_sp_ckpt335_1370M,2,f5v0to1to5_e2_ckpt252,5_vs_5
775,6,6,checkpoints_selfplay_e9_sp_ckpt335_1370M,0,f5v0to1to5_e2_ckpt252,5_vs_5
776,5,5,checkpoints_selfplay_e9_sp_ckpt335_1370M,0,f5v0to1to5_e2_ckpt252,5_vs_5
777,5,6,checkpoints_selfplay_e9_sp_ckpt335_1370M,1,f5v0to1to5_e2_ckpt252,5_vs_5
778,2,3,checkpoints_selfplay_e9_sp_ckpt335_1370M,1,f5v0to1to5_e2_ckpt252,5_vs_5
779,3,8,checkpoints_selfplay_e9_sp_ckpt335_1370M,5,f5v0to1to5_e2_ckpt252,5_vs_5
780,8,9,checkpoints_selfplay_e9_sp_ckpt335_1370M,1,f5v0to1to5_e2_ckpt252,5_vs_5
781,4,6,checkpoints_selfplay_e9_sp_ckpt335_1370M,2,f5v0to1to5_e2_ckpt252,5_vs_5
782,4,6,checkpoints_selfplay_e9_sp_ckpt335_1370M,2,f5v0to1to5_e2_ckpt252,5_vs_5
783,6,7,checkpoints_selfplay_e9_sp_ckpt335_1370M,1,f5v0to1to5_e2_ckpt252,5_vs_5
784,5,6,checkpoints_selfplay_e9_sp_ckpt335_1370M,1,f5v0to1to5_e2_ckpt252,5_vs_5
785,5,7,checkpoints_selfplay_e9_sp_ckpt335_1370M,2,f5v0to1to5_e2_ckpt252,5_vs_5
786,6,7,checkpoints_selfplay_e9_sp_ckpt335_1370M,1,f5v0to1to5_e2_ckpt252,5_vs_5
787,7,9,checkpoints_selfplay_e9_sp_ckpt335_1370M,2,f5v0to1to5_e2_ckpt252,5_vs_5
788,7,8,checkpoints_selfplay_e9_sp_ckpt335_1370M,1,f5v0to1to5_e2_ckpt252,5_vs_5
789,5,7,checkpoints_selfplay_e9_sp_ckpt335_1370M,2,f5v0to1to5_e2_ckpt252,5_vs_5
790,1,1,checkpoints_selfplay_e9_sp_ckpt335_1370M,0,scon_e3_p2_hard_ckpt840,5_vs_5
791,10,13,checkpoints_selfplay_e9_sp_ckpt335_1370M,3,scon_e3_p2_hard_ckpt840,5_vs_5
792,12,13,checkpoints_selfplay_e9_sp_ckpt335_1370M,1,scon_e3_p2_hard_ckpt840,5_vs_5
793,9,9,checkpoints_selfplay_e9_sp_ckpt335_1370M,0,scon_e3_p2_hard_ckpt840,5_vs_5
794,7,7,checkpoints_selfplay_e9_sp_ckpt335_1370M,0,scon_e3_p2_hard_ckpt840,5_vs_5
795,8,9,checkpoints_selfplay_e9_sp_ckpt335_1370M,1,scon_e3_p2_hard_ckpt840,5_vs_5
796,6,7,checkpoints_selfplay_e9_sp_ckpt335_1370M,1,scon_e3_p2_hard_ckpt840,5_vs_5
797,8,8,checkpoints_selfplay_e9_sp_ckpt335_1370M,0,scon_e3_p2_hard_ckpt840,5_vs_5
798,3,3,checkpoints_selfplay_e9_sp_ckpt335_1370M,0,scon_e3_p2_hard_ckpt840,5_vs_5
799,7,7,checkpoints_selfplay_e9_sp_ckpt335_1370M,0,scon_e3_p2_hard_ckpt840,5_vs_5
800,5,6,checkpoints_selfplay_e9_sp_ckpt335_1370M,1,scon_e3_p2_hard_ckpt840,5_vs_5
801,12,12,checkpoints_selfplay_e9_sp_ckpt335_1370M,0,scon_e3_p2_hard_ckpt840,5_vs_5
802,6,7,checkpoints_selfplay_e9_sp_ckpt335_1370M,1,scon_e3_p2_hard_ckpt840,5_vs_5
803,5,7,checkpoints_selfplay_e9_sp_ckpt335_1370M,2,scon_e3_p2_hard_ckpt840,5_vs_5
804,7,7,checkpoints_selfplay_e9_sp_ckpt335_1370M,0,scon_e3_p2_hard_ckpt840,5_vs_5
805,10,10,checkpoints_selfplay_e9_sp_ckpt335_1370M,0,scon_e3_p2_hard_ckpt840,5_vs_5
806,10,11,checkpoints_selfplay_e9_sp_ckpt335_1370M,1,scon_e3_p2_hard_ckpt840,5_vs_5
807,9,9,checkpoints_selfplay_e9_sp_ckpt335_1370M,0,scon_e3_p2_hard_ckpt840,5_vs_5
808,11,11,checkpoints_selfplay_e9_sp_ckpt335_1370M,0,scon_e3_p2_hard_ckpt840,5_vs_5
809,8,8,checkpoints_selfplay_e9_sp_ckpt335_1370M,0,scon_e3_p2_hard_ckpt840,5_vs_5
810,11,12,checkpoints_selfplay_e9_sp_ckpt335_1370M,1,less_then_partially_randomized_checkpoints_bots_4_heads_38_ckpt108,5_vs_5
811,7,9,checkpoints_selfplay_e9_sp_ckpt335_1370M,2,less_then_partially_randomized_checkpoints_bots_4_heads_38_ckpt108,5_vs_5
812,7,10,checkpoints_selfplay_e9_sp_ckpt335_1370M,3,less_then_partially_randomized_checkpoints_bots_4_heads_38_ckpt108,5_vs_5
813,7,9,checkpoints_selfplay_e9_sp_ckpt335_1370M,2,less_then_partially_randomized_checkpoints_bots_4_heads_38_ckpt108,5_vs_5
814,11,12,checkpoints_selfplay_e9_sp_ckpt335_1370M,1,less_then_partially_randomized_checkpoints_bots_4_heads_38_ckpt108,5_vs_5
815,13,13,checkpoints_selfplay_e9_sp_ckpt335_1370M,0,less_then_partially_randomized_checkpoints_bots_4_heads_38_ckpt108,5_vs_5
816,8,8,checkpoints_selfplay_e9_sp_ckpt335_1370M,0,less_then_partially_randomized_checkpoints_bots_4_heads_38_ckpt108,5_vs_5
817,15,15,checkpoints_selfplay_e9_sp_ckpt335_1370M,0,less_then_partially_randomized_checkpoints_bots_4_heads_38_ckpt108,5_vs_5
818,9,9,checkpoints_selfplay_e9_sp_ckpt335_1370M,0,less_then_partially_randomized_checkpoints_bots_4_heads_38_ckpt108,5_vs_5
819,8,11,checkpoints_selfplay_e9_sp_ckpt335_1370M,3,less_then_partially_randomized_checkpoints_bots_4_heads_38_ckpt108,5_vs_5
820,16,17,checkpoints_selfplay_e9_sp_ckpt335_1370M,1,less_then_partially_randomized_checkpoints_bots_4_heads_38_ckpt108,5_vs_5
821,6,6,checkpoints_selfplay_e9_sp_ckpt335_1370M,0,less_then_partially_randomized_checkpoints_bots_4_heads_38_ckpt108,5_vs_5
822,8,9,checkpoints_selfplay_e9_sp_ckpt335_1370M,1,less_then_partially_randomized_checkpoints_bots_4_heads_38_ckpt108,5_vs_5
823,11,11,checkpoints_selfplay_e9_sp_ckpt335_1370M,0,less_then_partially_randomized_checkpoints_bots_4_heads_38_ckpt108,5_vs_5
824,10,11,checkpoints_selfplay_e9_sp_ckpt335_1370M,1,less_then_partially_randomized_checkpoints_bots_4_heads_38_ckpt108,5_vs_5
825,16,16,checkpoints_selfplay_e9_sp_ckpt335_1370M,0,less_then_partially_randomized_checkpoints_bots_4_heads_38_ckpt108,5_vs_5
826,11,11,checkpoints_selfplay_e9_sp_ckpt335_1370M,0,less_then_partially_randomized_checkpoints_bots_4_heads_38_ckpt108,5_vs_5
827,12,13,checkpoints_selfplay_e9_sp_ckpt335_1370M,1,less_then_partially_randomized_checkpoints_bots_4_heads_38_ckpt108,5_vs_5
828,10,11,checkpoints_selfplay_e9_sp_ckpt335_1370M,1,less_then_partially_randomized_checkpoints_bots_4_heads_38_ckpt108,5_vs_5
829,13,13,checkpoints_selfplay_e9_sp_ckpt335_1370M,0,less_then_partially_randomized_checkpoints_bots_4_heads_38_ckpt108,5_vs_5
830,11,12,checkpoints_selfplay_e9_sp_ckpt335_1370M,1,less_then_partially_randomized_entropy_checkpoints_bots_4_heads_39_ckpt109,5_vs_5
831,9,9,checkpoints_selfplay_e9_sp_ckpt335_1370M,0,less_then_partially_randomized_entropy_checkpoints_bots_4_heads_39_ckpt109,5_vs_5
832,9,10,checkpoints_selfplay_e9_sp_ckpt335_1370M,1,less_then_partially_randomized_entropy_checkpoints_bots_4_heads_39_ckpt109,5_vs_5
833,7,9,checkpoints_selfplay_e9_sp_ckpt335_1370M,2,less_then_partially_randomized_entropy_checkpoints_bots_4_heads_39_ckpt109,5_vs_5
834,12,13,checkpoints_selfplay_e9_sp_ckpt335_1370M,1,less_then_partially_randomized_entropy_checkpoints_bots_4_heads_39_ckpt109,5_vs_5
835,7,8,checkpoints_selfplay_e9_sp_ckpt335_1370M,1,less_then_partially_randomized_entropy_checkpoints_bots_4_heads_39_ckpt109,5_vs_5
836,10,10,checkpoints_selfplay_e9_sp_ckpt335_1370M,0,less_then_partially_randomized_entropy_checkpoints_bots_4_heads_39_ckpt109,5_vs_5
837,6,8,checkpoints_selfplay_e9_sp_ckpt335_1370M,2,less_then_partially_randomized_entropy_checkpoints_bots_4_heads_39_ckpt109,5_vs_5
838,8,8,checkpoints_selfplay_e9_sp_ckpt335_1370M,0,less_then_partially_randomized_entropy_checkpoints_bots_4_heads_39_ckpt109,5_vs_5
839,3,8,checkpoints_selfplay_e9_sp_ckpt335_1370M,5,less_then_partially_randomized_entropy_checkpoints_bots_4_heads_39_ckpt109,5_vs_5
840,14,14,checkpoints_selfplay_e9_sp_ckpt335_1370M,0,less_then_partially_randomized_entropy_checkpoints_bots_4_heads_39_ckpt109,5_vs_5
841,5,7,checkpoints_selfplay_e9_sp_ckpt335_1370M,2,less_then_partially_randomized_entropy_checkpoints_bots_4_heads_39_ckpt109,5_vs_5
842,14,14,checkpoints_selfplay_e9_sp_ckpt335_1370M,0,less_then_partially_randomized_entropy_checkpoints_bots_4_heads_39_ckpt109,5_vs_5
843,9,11,checkpoints_selfplay_e9_sp_ckpt335_1370M,2,less_then_partially_randomized_entropy_checkpoints_bots_4_heads_39_ckpt109,5_vs_5
844,4,7,checkpoints_selfplay_e9_sp_ckpt335_1370M,3,less_then_partially_randomized_entropy_checkpoints_bots_4_heads_39_ckpt109,5_vs_5
845,8,9,checkpoints_selfplay_e9_sp_ckpt335_1370M,1,less_then_partially_randomized_entropy_checkpoints_bots_4_heads_39_ckpt109,5_vs_5
846,6,7,checkpoints_selfplay_e9_sp_ckpt335_1370M,1,less_then_partially_randomized_entropy_checkpoints_bots_4_heads_39_ckpt109,5_vs_5
847,9,10,checkpoints_selfplay_e9_sp_ckpt335_1370M,1,less_then_partially_randomized_entropy_checkpoints_bots_4_heads_39_ckpt109,5_vs_5
848,10,11,checkpoints_selfplay_e9_sp_ckpt335_1370M,1,less_then_partially_randomized_entropy_checkpoints_bots_4_heads_39_ckpt109,5_vs_5
849,10,12,checkpoints_selfplay_e9_sp_ckpt335_1370M,2,less_then_partially_randomized_entropy_checkpoints_bots_4_heads_39_ckpt109,5_vs_5
850,13,13,checkpoints_selfplay_e9_sp_ckpt335_1370M,0,reward_shaping_checkpoints_bots_4_heads_1_ckpt360,5_vs_5
851,12,12,checkpoints_selfplay_e9_sp_ckpt335_1370M,0,reward_shaping_checkpoints_bots_4_heads_1_ckpt360,5_vs_5
852,11,13,checkpoints_selfplay_e9_sp_ckpt335_1370M,2,reward_shaping_checkpoints_bots_4_heads_1_ckpt360,5_vs_5
853,9,10,checkpoints_selfplay_e9_sp_ckpt335_1370M,1,reward_shaping_checkpoints_bots_4_heads_1_ckpt360,5_vs_5
854,6,9,checkpoints_selfplay_e9_sp_ckpt335_1370M,3,reward_shaping_checkpoints_bots_4_heads_1_ckpt360,5_vs_5
855,15,15,checkpoints_selfplay_e9_sp_ckpt335_1370M,0,reward_shaping_checkpoints_bots_4_heads_1_ckpt360,5_vs_5
856,10,11,checkpoints_selfplay_e9_sp_ckpt335_1370M,1,reward_shaping_checkpoints_bots_4_heads_1_ckpt360,5_vs_5
857,12,12,checkpoints_selfplay_e9_sp_ckpt335_1370M,0,reward_shaping_checkpoints_bots_4_heads_1_ckpt360,5_vs_5
858,11,11,checkpoints_selfplay_e9_sp_ckpt335_1370M,0,reward_shaping_checkpoints_bots_4_heads_1_ckpt360,5_vs_5
859,11,11,checkpoints_selfplay_e9_sp_ckpt335_1370M,0,reward_shaping_checkpoints_bots_4_heads_1_ckpt360,5_vs_5
860,12,12,checkpoints_selfplay_e9_sp_ckpt335_1370M,0,reward_shaping_checkpoints_bots_4_heads_1_ckpt360,5_vs_5
861,11,12,checkpoints_selfplay_e9_sp_ckpt335_1370M,1,reward_shaping_checkpoints_bots_4_heads_1_ckpt360,5_vs_5
862,10,10,checkpoints_selfplay_e9_sp_ckpt335_1370M,0,reward_shaping_checkpoints_bots_4_heads_1_ckpt360,5_vs_5
863,10,10,checkpoints_selfplay_e9_sp_ckpt335_1370M,0,reward_shaping_checkpoints_bots_4_heads_1_ckpt360,5_vs_5
864,8,9,checkpoints_selfplay_e9_sp_ckpt335_1370M,1,reward_shaping_checkpoints_bots_4_heads_1_ckpt360,5_vs_5
865,8,10,checkpoints_selfplay_e9_sp_ckpt335_1370M,2,reward_shaping_checkpoints_bots_4_heads_1_ckpt360,5_vs_5
866,12,14,checkpoints_selfplay_e9_sp_ckpt335_1370M,2,reward_shaping_checkpoints_bots_4_heads_1_ckpt360,5_vs_5
867,5,6,checkpoints_selfplay_e9_sp_ckpt335_1370M,1,reward_shaping_checkpoints_bots_4_heads_1_ckpt360,5_vs_5
868,9,10,checkpoints_selfplay_e9_sp_ckpt335_1370M,1,reward_shaping_checkpoints_bots_4_heads_1_ckpt360,5_vs_5
869,8,8,checkpoints_selfplay_e9_sp_ckpt335_1370M,0,reward_shaping_checkpoints_bots_4_heads_1_ckpt360,5_vs_5
870,0,3,checkpoints_selfplay_e9_sp_ckpt335_1370M,3,checkpoints_selfplay_e9_sp_ckpt274,5_vs_5
871,0,4,checkpoints_selfplay_e9_sp_ckpt335_1370M,4,checkpoints_selfplay_e9_sp_ckpt274,5_vs_5
872,1,4,checkpoints_selfplay_e9_sp_ckpt335_1370M,3,checkpoints_selfplay_e9_sp_ckpt274,5_vs_5
873,3,5,checkpoints_selfplay_e9_sp_ckpt335_1370M,2,checkpoints_selfplay_e9_sp_ckpt274,5_vs_5
874,0,5,checkpoints_selfplay_e9_sp_ckpt335_1370M,5,checkpoints_selfplay_e9_sp_ckpt274,5_vs_5
875,3,7,checkpoints_selfplay_e9_sp_ckpt335_1370M,4,checkpoints_selfplay_e9_sp_ckpt274,5_vs_5
876,3,6,checkpoints_selfplay_e9_sp_ckpt335_1370M,3,checkpoints_selfplay_e9_sp_ckpt274,5_vs_5
877,2,6,checkpoints_selfplay_e9_sp_ckpt335_1370M,4,checkpoints_selfplay_e9_sp_ckpt274,5_vs_5
878,1,4,checkpoints_selfplay_e9_sp_ckpt335_1370M,3,checkpoints_selfplay_e9_sp_ckpt274,5_vs_5
879,5,7,checkpoints_selfplay_e9_sp_ckpt335_1370M,2,checkpoints_selfplay_e9_sp_ckpt274,5_vs_5
880,2,5,checkpoints_selfplay_e9_sp_ckpt335_1370M,3,checkpoints_selfplay_e9_sp_ckpt274,5_vs_5
881,-1,5,checkpoints_selfplay_e9_sp_ckpt335_1370M,6,checkpoints_selfplay_e9_sp_ckpt274,5_vs_5
882,-3,2,checkpoints_selfplay_e9_sp_ckpt335_1370M,5,checkpoints_selfplay_e9_sp_ckpt274,5_vs_5
883,3,7,checkpoints_selfplay_e9_sp_ckpt335_1370M,4,checkpoints_selfplay_e9_sp_ckpt274,5_vs_5
884,5,5,checkpoints_selfplay_e9_sp_ckpt335_1370M,0,checkpoints_selfplay_e9_sp_ckpt274,5_vs_5
885,2,4,checkpoints_selfplay_e9_sp_ckpt335_1370M,2,checkpoints_selfplay_e9_sp_ckpt274,5_vs_5
886,2,6,checkpoints_selfplay_e9_sp_ckpt335_1370M,4,checkpoints_selfplay_e9_sp_ckpt274,5_vs_5
887,6,6,checkpoints_selfplay_e9_sp_ckpt335_1370M,0,checkpoints_selfplay_e9_sp_ckpt274,5_vs_5
888,7,9,checkpoints_selfplay_e9_sp_ckpt335_1370M,2,checkpoints_selfplay_e9_sp_ckpt274,5_vs_5
889,2,7,checkpoints_selfplay_e9_sp_ckpt335_1370M,5,checkpoints_selfplay_e9_sp_ckpt274,5_vs_5
890,4,6,checkpoints_selfplay_e9_sp_ckpt335_1370M,2,checkpoints_selfplay_e9_sp_ckpt335_1370M,5_vs_5
891,-2,5,checkpoints_selfplay_e9_sp_ckpt335_1370M,7,checkpoints_selfplay_e9_sp_ckpt335_1370M,5_vs_5
892,-2,5,checkpoints_selfplay_e9_sp_ckpt335_1370M,7,checkpoints_selfplay_e9_sp_ckpt335_1370M,5_vs_5
893,4,7,checkpoints_selfplay_e9_sp_ckpt335_1370M,3,checkpoints_selfplay_e9_sp_ckpt335_1370M,5_vs_5
894,2,5,checkpoints_selfplay_e9_sp_ckpt335_1370M,3,checkpoints_selfplay_e9_sp_ckpt335_1370M,5_vs_5
895,5,6,checkpoints_selfplay_e9_sp_ckpt335_1370M,1,checkpoints_selfplay_e9_sp_ckpt335_1370M,5_vs_5
896,-1,3,checkpoints_selfplay_e9_sp_ckpt335_1370M,4,checkpoints_selfplay_e9_sp_ckpt335_1370M,5_vs_5
897,-3,3,checkpoints_selfplay_e9_sp_ckpt335_1370M,6,checkpoints_selfplay_e9_sp_ckpt335_1370M,5_vs_5
898,2,7,checkpoints_selfplay_e9_sp_ckpt335_1370M,5,checkpoints_selfplay_e9_sp_ckpt335_1370M,5_vs_5
899,4,7,checkpoints_selfplay_e9_sp_ckpt335_1370M,3,checkpoints_selfplay_e9_sp_ckpt335_1370M,5_vs_5
900,1,4,checkpoints_selfplay_e9_sp_ckpt335_1370M,3,checkpoints_selfplay_e9_sp_ckpt335_1370M,5_vs_5
901,-2,4,checkpoints_selfplay_e9_sp_ckpt335_1370M,6,checkpoints_selfplay_e9_sp_ckpt335_1370M,5_vs_5
902,2,5,checkpoints_selfplay_e9_sp_ckpt335_1370M,3,checkpoints_selfplay_e9_sp_ckpt335_1370M,5_vs_5
903,3,8,checkpoints_selfplay_e9_sp_ckpt335_1370M,5,checkpoints_selfplay_e9_sp_ckpt335_1370M,5_vs_5
904,-1,5,checkpoints_selfplay_e9_sp_ckpt335_1370M,6,checkpoints_selfplay_e9_sp_ckpt335_1370M,5_vs_5
905,-2,4,checkpoints_selfplay_e9_sp_ckpt335_1370M,6,checkpoints_selfplay_e9_sp_ckpt335_1370M,5_vs_5
906,2,4,checkpoints_selfplay_e9_sp_ckpt335_1370M,2,checkpoints_selfplay_e9_sp_ckpt335_1370M,5_vs_5
907,-1,4,checkpoints_selfplay_e9_sp_ckpt335_1370M,5,checkpoints_selfplay_e9_sp_ckpt335_1370M,5_vs_5
908,7,9,checkpoints_selfplay_e9_sp_ckpt335_1370M,2,checkpoints_selfplay_e9_sp_ckpt335_1370M,5_vs_5
909,3,5,checkpoints_selfplay_e9_sp_ckpt335_1370M,2,checkpoints_selfplay_e9_sp_ckpt335_1370M,5_vs_5
910,-1,0,checkpoints_selfplay_e9_sp_ckpt335_1370M,1,checkpoints_sp_c_nb_e2_ckpt667,5_vs_5
911,-2,3,checkpoints_selfplay_e9_sp_ckpt335_1370M,5,checkpoints_sp_c_nb_e2_ckpt667,5_vs_5
912,2,4,checkpoints_selfplay_e9_sp_ckpt335_1370M,2,checkpoints_sp_c_nb_e2_ckpt667,5_vs_5
913,-6,3,checkpoints_selfplay_e9_sp_ckpt335_1370M,9,checkpoints_sp_c_nb_e2_ckpt667,5_vs_5
914,-5,3,checkpoints_selfplay_e9_sp_ckpt335_1370M,8,checkpoints_sp_c_nb_e2_ckpt667,5_vs_5
915,-5,3,checkpoints_selfplay_e9_sp_ckpt335_1370M,8,checkpoints_sp_c_nb_e2_ckpt667,5_vs_5
916,-4,2,checkpoints_selfplay_e9_sp_ckpt335_1370M,6,checkpoints_sp_c_nb_e2_ckpt667,5_vs_5
917,-1,5,checkpoints_selfplay_e9_sp_ckpt335_1370M,6,checkpoints_sp_c_nb_e2_ckpt667,5_vs_5
918,-3,2,checkpoints_selfplay_e9_sp_ckpt335_1370M,5,checkpoints_sp_c_nb_e2_ckpt667,5_vs_5
919,-4,4,checkpoints_selfplay_e9_sp_ckpt335_1370M,8,checkpoints_sp_c_nb_e2_ckpt667,5_vs_5
920,0,4,checkpoints_selfplay_e9_sp_ckpt335_1370M,4,checkpoints_sp_c_nb_e2_ckpt667,5_vs_5
921,-7,1,checkpoints_selfplay_e9_sp_ckpt335_1370M,8,checkpoints_sp_c_nb_e2_ckpt667,5_vs_5
922,-7,1,checkpoints_selfplay_e9_sp_ckpt335_1370M,8,checkpoints_sp_c_nb_e2_ckpt667,5_vs_5
923,-6,2,checkpoints_selfplay_e9_sp_ckpt335_1370M,8,checkpoints_sp_c_nb_e2_ckpt667,5_vs_5
924,-4,2,checkpoints_selfplay_e9_sp_ckpt335_1370M,6,checkpoints_sp_c_nb_e2_ckpt667,5_vs_5
925,-1,5,checkpoints_selfplay_e9_sp_ckpt335_1370M,6,checkpoints_sp_c_nb_e2_ckpt667,5_vs_5
926,-1,3,checkpoints_selfplay_e9_sp_ckpt335_1370M,4,checkpoints_sp_c_nb_e2_ckpt667,5_vs_5
927,-4,2,checkpoints_selfplay_e9_sp_ckpt335_1370M,6,checkpoints_sp_c_nb_e2_ckpt667,5_vs_5
928,-1,4,checkpoints_selfplay_e9_sp_ckpt335_1370M,5,checkpoints_sp_c_nb_e2_ckpt667,5_vs_5
929,-1,2,checkpoints_selfplay_e9_sp_ckpt335_1370M,3,checkpoints_sp_c_nb_e2_ckpt667,5_vs_5
930,12,12,checkpoints_selfplay_e9_sp_ckpt335_1370M,0,scenario_curriculum_ckpt830,5_vs_5
931,10,10,checkpoints_selfplay_e9_sp_ckpt335_1370M,0,scenario_curriculum_ckpt830,5_vs_5
932,10,10,checkpoints_selfplay_e9_sp_ckpt335_1370M,0,scenario_curriculum_ckpt830,5_vs_5
933,2,2,checkpoints_selfplay_e9_sp_ckpt335_1370M,0,scenario_curriculum_ckpt830,5_vs_5
934,10,10,checkpoints_selfplay_e9_sp_ckpt335_1370M,0,scenario_curriculum_ckpt830,5_vs_5
935,9,9,checkpoints_selfplay_e9_sp_ckpt335_1370M,0,scenario_curriculum_ckpt830,5_vs_5
936,3,3,checkpoints_selfplay_e9_sp_ckpt335_1370M,0,scenario_curriculum_ckpt830,5_vs_5
937,2,2,checkpoints_selfplay_e9_sp_ckpt335_1370M,0,scenario_curriculum_ckpt830,5_vs_5
938,13,13,checkpoints_selfplay_e9_sp_ckpt335_1370M,0,scenario_curriculum_ckpt830,5_vs_5
939,3,3,checkpoints_selfplay_e9_sp_ckpt335_1370M,0,scenario_curriculum_ckpt830,5_vs_5
940,5,5,checkpoints_selfplay_e9_sp_ckpt335_1370M,0,scenario_curriculum_ckpt830,5_vs_5
941,7,7,checkpoints_selfplay_e9_sp_ckpt335_1370M,0,scenario_curriculum_ckpt830,5_vs_5
942,9,10,checkpoints_selfplay_e9_sp_ckpt335_1370M,1,scenario_curriculum_ckpt830,5_vs_5
943,11,11,checkpoints_selfplay_e9_sp_ckpt335_1370M,0,scenario_curriculum_ckpt830,5_vs_5
944,13,13,checkpoints_selfplay_e9_sp_ckpt335_1370M,0,scenario_curriculum_ckpt830,5_vs_5
945,11,11,checkpoints_selfplay_e9_sp_ckpt335_1370M,0,scenario_curriculum_ckpt830,5_vs_5
946,6,6,checkpoints_selfplay_e9_sp_ckpt335_1370M,0,scenario_curriculum_ckpt830,5_vs_5
947,6,6,checkpoints_selfplay_e9_sp_ckpt335_1370M,0,scenario_curriculum_ckpt830,5_vs_5
948,10,10,checkpoints_selfplay_e9_sp_ckpt335_1370M,0,scenario_curriculum_ckpt830,5_vs_5
949,6,6,checkpoints_selfplay_e9_sp_ckpt335_1370M,0,scenario_curriculum_ckpt830,5_vs_5
950,5,6,checkpoints_selfplay_e9_sp_ckpt335_1370M,1,m_sp_arch_medium_heads_conv16_0_bt_32_r313_m335,5_vs_5
951,5,6,checkpoints_selfplay_e9_sp_ckpt335_1370M,1,m_sp_arch_medium_heads_conv16_0_bt_32_r313_m335,5_vs_5
952,-3,2,checkpoints_selfplay_e9_sp_ckpt335_1370M,5,m_sp_arch_medium_heads_conv16_0_bt_32_r313_m335,5_vs_5
953,-4,0,checkpoints_selfplay_e9_sp_ckpt335_1370M,4,m_sp_arch_medium_heads_conv16_0_bt_32_r313_m335,5_vs_5
954,-2,3,checkpoints_selfplay_e9_sp_ckpt335_1370M,5,m_sp_arch_medium_heads_conv16_0_bt_32_r313_m335,5_vs_5
955,-1,2,checkpoints_selfplay_e9_sp_ckpt335_1370M,3,m_sp_arch_medium_heads_conv16_0_bt_32_r313_m335,5_vs_5
956,-1,2,checkpoints_selfplay_e9_sp_ckpt335_1370M,3,m_sp_arch_medium_heads_conv16_0_bt_32_r313_m335,5_vs_5
957,-3,2,checkpoints_selfplay_e9_sp_ckpt335_1370M,5,m_sp_arch_medium_heads_conv16_0_bt_32_r313_m335,5_vs_5
958,-4,1,checkpoints_selfplay_e9_sp_ckpt335_1370M,5,m_sp_arch_medium_heads_conv16_0_bt_32_r313_m335,5_vs_5
959,3,5,checkpoints_selfplay_e9_sp_ckpt335_1370M,2,m_sp_arch_medium_heads_conv16_0_bt_32_r313_m335,5_vs_5
960,4,4,checkpoints_selfplay_e9_sp_ckpt335_1370M,0,m_sp_arch_medium_heads_conv16_0_bt_32_r313_m335,5_vs_5
961,2,4,checkpoints_selfplay_e9_sp_ckpt335_1370M,2,m_sp_arch_medium_heads_conv16_0_bt_32_r313_m335,5_vs_5
962,-2,4,checkpoints_selfplay_e9_sp_ckpt335_1370M,6,m_sp_arch_medium_heads_conv16_0_bt_32_r313_m335,5_vs_5
963,2,3,checkpoints_selfplay_e9_sp_ckpt335_1370M,1,m_sp_arch_medium_heads_conv16_0_bt_32_r313_m335,5_vs_5
964,2,2,checkpoints_selfplay_e9_sp_ckpt335_1370M,0,m_sp_arch_medium_heads_conv16_0_bt_32_r313_m335,5_vs_5
965,3,6,checkpoints_selfplay_e9_sp_ckpt335_1370M,3,m_sp_arch_medium_heads_conv16_0_bt_32_r313_m335,5_vs_5
966,5,6,checkpoints_selfplay_e9_sp_ckpt335_1370M,1,m_sp_arch_medium_heads_conv16_0_bt_32_r313_m335,5_vs_5
967,2,5,checkpoints_selfplay_e9_sp_ckpt335_1370M,3,m_sp_arch_medium_heads_conv16_0_bt_32_r313_m335,5_vs_5
968,-3,1,checkpoints_selfplay_e9_sp_ckpt335_1370M,4,m_sp_arch_medium_heads_conv16_0_bt_32_r313_m335,5_vs_5
969,-1,3,checkpoints_selfplay_e9_sp_ckpt335_1370M,4,m_sp_arch_medium_heads_conv16_0_bt_32_r313_m335,5_vs_5
970,2,3,checkpoints_selfplay_e9_sp_ckpt335_1370M,1,m_sp_arch_medium_heads_conv16_0_bt_32_r313_m288_1370M,5_vs_5
971,2,4,checkpoints_selfplay_e9_sp_ckpt335_1370M,2,m_sp_arch_medium_heads_conv16_0_bt_32_r313_m288_1370M,5_vs_5
972,1,2,checkpoints_selfplay_e9_sp_ckpt335_1370M,1,m_sp_arch_medium_heads_conv16_0_bt_32_r313_m288_1370M,5_vs_5
973,3,6,checkpoints_selfplay_e9_sp_ckpt335_1370M,3,m_sp_arch_medium_heads_conv16_0_bt_32_r313_m288_1370M,5_vs_5
974,2,5,checkpoints_selfplay_e9_sp_ckpt335_1370M,3,m_sp_arch_medium_heads_conv16_0_bt_32_r313_m288_1370M,5_vs_5
975,-1,0,checkpoints_selfplay_e9_sp_ckpt335_1370M,1,m_sp_arch_medium_heads_conv16_0_bt_32_r313_m288_1370M,5_vs_5
976,6,7,checkpoints_selfplay_e9_sp_ckpt335_1370M,1,m_sp_arch_medium_heads_conv16_0_bt_32_r313_m288_1370M,5_vs_5
977,3,5,checkpoints_selfplay_e9_sp_ckpt335_1370M,2,m_sp_arch_medium_heads_conv16_0_bt_32_r313_m288_1370M,5_vs_5
978,1,3,checkpoints_selfplay_e9_sp_ckpt335_1370M,2,m_sp_arch_medium_heads_conv16_0_bt_32_r313_m288_1370M,5_vs_5
979,4,7,checkpoints_selfplay_e9_sp_ckpt335_1370M,3,m_sp_arch_medium_heads_conv16_0_bt_32_r313_m288_1370M,5_vs_5
980,3,6,checkpoints_selfplay_e9_sp_ckpt335_1370M,3,m_sp_arch_medium_heads_conv16_0_bt_32_r313_m288_1370M,5_vs_5
981,0,5,checkpoints_selfplay_e9_sp_ckpt335_1370M,5,m_sp_arch_medium_heads_conv16_0_bt_32_r313_m288_1370M,5_vs_5
982,5,6,checkpoints_selfplay_e9_sp_ckpt335_1370M,1,m_sp_arch_medium_heads_conv16_0_bt_32_r313_m288_1370M,5_vs_5
983,1,5,checkpoints_selfplay_e9_sp_ckpt335_1370M,4,m_sp_arch_medium_heads_conv16_0_bt_32_r313_m288_1370M,5_vs_5
984,2,5,checkpoints_selfplay_e9_sp_ckpt335_1370M,3,m_sp_arch_medium_heads_conv16_0_bt_32_r313_m288_1370M,5_vs_5
985,1,3,checkpoints_selfplay_e9_sp_ckpt335_1370M,2,m_sp_arch_medium_heads_conv16_0_bt_32_r313_m288_1370M,5_vs_5
986,2,3,checkpoints_selfplay_e9_sp_ckpt335_1370M,1,m_sp_arch_medium_heads_conv16_0_bt_32_r313_m288_1370M,5_vs_5
987,3,4,checkpoints_selfplay_e9_sp_ckpt335_1370M,1,m_sp_arch_medium_heads_conv16_0_bt_32_r313_m288_1370M,5_vs_5
988,5,6,checkpoints_selfplay_e9_sp_ckpt335_1370M,1,m_sp_arch_medium_heads_conv16_0_bt_32_r313_m288_1370M,5_vs_5
989,1,5,checkpoints_selfplay_e9_sp_ckpt335_1370M,4,m_sp_arch_medium_heads_conv16_0_bt_32_r313_m288_1370M,5_vs_5
990,1,4,checkpoints_selfplay_e9_sp_ckpt335_1370M,3,m_sp_arch_longer_heads_bt_32_r201_m335,5_vs_5
991,-2,2,checkpoints_selfplay_e9_sp_ckpt335_1370M,4,m_sp_arch_longer_heads_bt_32_r201_m335,5_vs_5
992,1,3,checkpoints_selfplay_e9_sp_ckpt335_1370M,2,m_sp_arch_longer_heads_bt_32_r201_m335,5_vs_5
993,-2,1,checkpoints_selfplay_e9_sp_ckpt335_1370M,3,m_sp_arch_longer_heads_bt_32_r201_m335,5_vs_5
994,1,3,checkpoints_selfplay_e9_sp_ckpt335_1370M,2,m_sp_arch_longer_heads_bt_32_r201_m335,5_vs_5
995,0,3,checkpoints_selfplay_e9_sp_ckpt335_1370M,3,m_sp_arch_longer_heads_bt_32_r201_m335,5_vs_5
996,4,5,checkpoints_selfplay_e9_sp_ckpt335_1370M,1,m_sp_arch_longer_heads_bt_32_r201_m335,5_vs_5
997,3,4,checkpoints_selfplay_e9_sp_ckpt335_1370M,1,m_sp_arch_longer_heads_bt_32_r201_m335,5_vs_5
998,-5,1,checkpoints_selfplay_e9_sp_ckpt335_1370M,6,m_sp_arch_longer_heads_bt_32_r201_m335,5_vs_5
999,1,3,checkpoints_selfplay_e9_sp_ckpt335_1370M,2,m_sp_arch_longer_heads_bt_32_r201_m335,5_vs_5
1000,1,2,checkpoints_selfplay_e9_sp_ckpt335_1370M,1,m_sp_arch_longer_heads_bt_32_r201_m335,5_vs_5
1001,2,6,checkpoints_selfplay_e9_sp_ckpt335_1370M,4,m_sp_arch_longer_heads_bt_32_r201_m335,5_vs_5
1002,-3,0,checkpoints_selfplay_e9_sp_ckpt335_1370M,3,m_sp_arch_longer_heads_bt_32_r201_m335,5_vs_5
1003,-2,2,checkpoints_selfplay_e9_sp_ckpt335_1370M,4,m_sp_arch_longer_heads_bt_32_r201_m335,5_vs_5
1004,-1,0,checkpoints_selfplay_e9_sp_ckpt335_1370M,1,m_sp_arch_longer_heads_bt_32_r201_m335,5_vs_5
1005,2,3,checkpoints_selfplay_e9_sp_ckpt335_1370M,1,m_sp_arch_longer_heads_bt_32_r201_m335,5_vs_5
1006,-2,2,checkpoints_selfplay_e9_sp_ckpt335_1370M,4,m_sp_arch_longer_heads_bt_32_r201_m335,5_vs_5
1007,4,6,checkpoints_selfplay_e9_sp_ckpt335_1370M,2,m_sp_arch_longer_heads_bt_32_r201_m335,5_vs_5
1008,-1,3,checkpoints_selfplay_e9_sp_ckpt335_1370M,4,m_sp_arch_longer_heads_bt_32_r201_m335,5_vs_5
1009,-1,3,checkpoints_selfplay_e9_sp_ckpt335_1370M,4,m_sp_arch_longer_heads_bt_32_r201_m335,5_vs_5
1010,2,4,checkpoints_selfplay_e9_sp_ckpt335_1370M,2,m_sp_arch_longer_heads_bt_32_r310_m277_1370M,5_vs_5
1011,1,3,checkpoints_selfplay_e9_sp_ckpt335_1370M,2,m_sp_arch_longer_heads_bt_32_r310_m277_1370M,5_vs_5
1012,0,3,checkpoints_selfplay_e9_sp_ckpt335_1370M,3,m_sp_arch_longer_heads_bt_32_r310_m277_1370M,5_vs_5
1013,2,4,checkpoints_selfplay_e9_sp_ckpt335_1370M,2,m_sp_arch_longer_heads_bt_32_r310_m277_1370M,5_vs_5
1014,2,6,checkpoints_selfplay_e9_sp_ckpt335_1370M,4,m_sp_arch_longer_heads_bt_32_r310_m277_1370M,5_vs_5
1015,1,3,checkpoints_selfplay_e9_sp_ckpt335_1370M,2,m_sp_arch_longer_heads_bt_32_r310_m277_1370M,5_vs_5
1016,0,2,checkpoints_selfplay_e9_sp_ckpt335_1370M,2,m_sp_arch_longer_heads_bt_32_r310_m277_1370M,5_vs_5
1017,-1,1,checkpoints_selfplay_e9_sp_ckpt335_1370M,2,m_sp_arch_longer_heads_bt_32_r310_m277_1370M,5_vs_5
1018,-1,1,checkpoints_selfplay_e9_sp_ckpt335_1370M,2,m_sp_arch_longer_heads_bt_32_r310_m277_1370M,5_vs_5
1019,2,4,checkpoints_selfplay_e9_sp_ckpt335_1370M,2,m_sp_arch_longer_heads_bt_32_r310_m277_1370M,5_vs_5
1020,5,6,checkpoints_selfplay_e9_sp_ckpt335_1370M,1,m_sp_arch_longer_heads_bt_32_r310_m277_1370M,5_vs_5
1021,0,0,checkpoints_selfplay_e9_sp_ckpt335_1370M,0,m_sp_arch_longer_heads_bt_32_r310_m277_1370M,5_vs_5
1022,3,6,checkpoints_selfplay_e9_sp_ckpt335_1370M,3,m_sp_arch_longer_heads_bt_32_r310_m277_1370M,5_vs_5
1023,-1,2,checkpoints_selfplay_e9_sp_ckpt335_1370M,3,m_sp_arch_longer_heads_bt_32_r310_m277_1370M,5_vs_5
1024,0,4,checkpoints_selfplay_e9_sp_ckpt335_1370M,4,m_sp_arch_longer_heads_bt_32_r310_m277_1370M,5_vs_5
1025,2,5,checkpoints_selfplay_e9_sp_ckpt335_1370M,3,m_sp_arch_longer_heads_bt_32_r310_m277_1370M,5_vs_5
1026,0,4,checkpoints_selfplay_e9_sp_ckpt335_1370M,4,m_sp_arch_longer_heads_bt_32_r310_m277_1370M,5_vs_5
1027,2,6,checkpoints_selfplay_e9_sp_ckpt335_1370M,4,m_sp_arch_longer_heads_bt_32_r310_m277_1370M,5_vs_5
1028,1,3,checkpoints_selfplay_e9_sp_ckpt335_1370M,2,m_sp_arch_longer_heads_bt_32_r310_m277_1370M,5_vs_5
1029,4,5,checkpoints_selfplay_e9_sp_ckpt335_1370M,1,m_sp_arch_longer_heads_bt_32_r310_m277_1370M,5_vs_5
1030,-1,2,checkpoints_selfplay_e9_sp_ckpt335_1370M,3,m_sp_arch_medium_heads_bt_32_r201_m335,5_vs_5
1031,0,4,checkpoints_selfplay_e9_sp_ckpt335_1370M,4,m_sp_arch_medium_heads_bt_32_r201_m335,5_vs_5
1032,2,2,checkpoints_selfplay_e9_sp_ckpt335_1370M,0,m_sp_arch_medium_heads_bt_32_r201_m335,5_vs_5
1033,-1,2,checkpoints_selfplay_e9_sp_ckpt335_1370M,3,m_sp_arch_medium_heads_bt_32_r201_m335,5_vs_5
1034,3,5,checkpoints_selfplay_e9_sp_ckpt335_1370M,2,m_sp_arch_medium_heads_bt_32_r201_m335,5_vs_5
1035,0,3,checkpoints_selfplay_e9_sp_ckpt335_1370M,3,m_sp_arch_medium_heads_bt_32_r201_m335,5_vs_5
1036,4,5,checkpoints_selfplay_e9_sp_ckpt335_1370M,1,m_sp_arch_medium_heads_bt_32_r201_m335,5_vs_5
1037,1,6,checkpoints_selfplay_e9_sp_ckpt335_1370M,5,m_sp_arch_medium_heads_bt_32_r201_m335,5_vs_5
1038,2,3,checkpoints_selfplay_e9_sp_ckpt335_1370M,1,m_sp_arch_medium_heads_bt_32_r201_m335,5_vs_5
1039,6,6,checkpoints_selfplay_e9_sp_ckpt335_1370M,0,m_sp_arch_medium_heads_bt_32_r201_m335,5_vs_5
1040,4,7,checkpoints_selfplay_e9_sp_ckpt335_1370M,3,m_sp_arch_medium_heads_bt_32_r201_m335,5_vs_5
1041,-2,1,checkpoints_selfplay_e9_sp_ckpt335_1370M,3,m_sp_arch_medium_heads_bt_32_r201_m335,5_vs_5
1042,0,3,checkpoints_selfplay_e9_sp_ckpt335_1370M,3,m_sp_arch_medium_heads_bt_32_r201_m335,5_vs_5
1043,1,4,checkpoints_selfplay_e9_sp_ckpt335_1370M,3,m_sp_arch_medium_heads_bt_32_r201_m335,5_vs_5
1044,5,5,checkpoints_selfplay_e9_sp_ckpt335_1370M,0,m_sp_arch_medium_heads_bt_32_r201_m335,5_vs_5
1045,2,4,checkpoints_selfplay_e9_sp_ckpt335_1370M,2,m_sp_arch_medium_heads_bt_32_r201_m335,5_vs_5
1046,7,7,checkpoints_selfplay_e9_sp_ckpt335_1370M,0,m_sp_arch_medium_heads_bt_32_r201_m335,5_vs_5
1047,0,2,checkpoints_selfplay_e9_sp_ckpt335_1370M,2,m_sp_arch_medium_heads_bt_32_r201_m335,5_vs_5
1048,3,5,checkpoints_selfplay_e9_sp_ckpt335_1370M,2,m_sp_arch_medium_heads_bt_32_r201_m335,5_vs_5
1049,2,5,checkpoints_selfplay_e9_sp_ckpt335_1370M,3,m_sp_arch_medium_heads_bt_32_r201_m335,5_vs_5
1050,10,11,checkpoints_selfplay_e9_sp_ckpt335_1370M,1,m_sp_arch_medium_heads_bt_32_r201_m273_1370M,5_vs_5
1051,9,10,checkpoints_selfplay_e9_sp_ckpt335_1370M,1,m_sp_arch_medium_heads_bt_32_r201_m273_1370M,5_vs_5
1052,5,5,checkpoints_selfplay_e9_sp_ckpt335_1370M,0,m_sp_arch_medium_heads_bt_32_r201_m273_1370M,5_vs_5
1053,6,10,checkpoints_selfplay_e9_sp_ckpt335_1370M,4,m_sp_arch_medium_heads_bt_32_r201_m273_1370M,5_vs_5
1054,2,2,checkpoints_selfplay_e9_sp_ckpt335_1370M,0,m_sp_arch_medium_heads_bt_32_r201_m273_1370M,5_vs_5
1055,7,7,checkpoints_selfplay_e9_sp_ckpt335_1370M,0,m_sp_arch_medium_heads_bt_32_r201_m273_1370M,5_vs_5
1056,8,9,checkpoints_selfplay_e9_sp_ckpt335_1370M,1,m_sp_arch_medium_heads_bt_32_r201_m273_1370M,5_vs_5
1057,4,8,checkpoints_selfplay_e9_sp_ckpt335_1370M,4,m_sp_arch_medium_heads_bt_32_r201_m273_1370M,5_vs_5
1058,10,12,checkpoints_selfplay_e9_sp_ckpt335_1370M,2,m_sp_arch_medium_heads_bt_32_r201_m273_1370M,5_vs_5
1059,4,5,checkpoints_selfplay_e9_sp_ckpt335_1370M,1,m_sp_arch_medium_heads_bt_32_r201_m273_1370M,5_vs_5
1060,10,11,checkpoints_selfplay_e9_sp_ckpt335_1370M,1,m_sp_arch_medium_heads_bt_32_r201_m273_1370M,5_vs_5
1061,3,5,checkpoints_selfplay_e9_sp_ckpt335_1370M,2,m_sp_arch_medium_heads_bt_32_r201_m273_1370M,5_vs_5
1062,9,11,checkpoints_selfplay_e9_sp_ckpt335_1370M,2,m_sp_arch_medium_heads_bt_32_r201_m273_1370M,5_vs_5
1063,3,6,checkpoints_selfplay_e9_sp_ckpt335_1370M,3,m_sp_arch_medium_heads_bt_32_r201_m273_1370M,5_vs_5
1064,3,6,checkpoints_selfplay_e9_sp_ckpt335_1370M,3,m_sp_arch_medium_heads_bt_32_r201_m273_1370M,5_vs_5
1065,2,4,checkpoints_selfplay_e9_sp_ckpt335_1370M,2,m_sp_arch_medium_heads_bt_32_r201_m273_1370M,5_vs_5
1066,8,10,checkpoints_selfplay_e9_sp_ckpt335_1370M,2,m_sp_arch_medium_heads_bt_32_r201_m273_1370M,5_vs_5
1067,10,11,checkpoints_selfplay_e9_sp_ckpt335_1370M,1,m_sp_arch_medium_heads_bt_32_r201_m273_1370M,5_vs_5
1068,12,12,checkpoints_selfplay_e9_sp_ckpt335_1370M,0,m_sp_arch_medium_heads_bt_32_r201_m273_1370M,5_vs_5
1069,4,8,checkpoints_selfplay_e9_sp_ckpt335_1370M,4,m_sp_arch_medium_heads_bt_32_r201_m273_1370M,5_vs_5
1070,-3,1,checkpoints_selfplay_e9_sp_ckpt335_1370M,4,m_sp_arch_4x1_bt_32_r201_m335,5_vs_5
1071,-3,1,checkpoints_selfplay_e9_sp_ckpt335_1370M,4,m_sp_arch_4x1_bt_32_r201_m335,5_vs_5
1072,-2,3,checkpoints_selfplay_e9_sp_ckpt335_1370M,5,m_sp_arch_4x1_bt_32_r201_m335,5_vs_5
1073,-5,2,checkpoints_selfplay_e9_sp_ckpt335_1370M,7,m_sp_arch_4x1_bt_32_r201_m335,5_vs_5
1074,-3,4,checkpoints_selfplay_e9_sp_ckpt335_1370M,7,m_sp_arch_4x1_bt_32_r201_m335,5_vs_5
1075,-6,1,checkpoints_selfplay_e9_sp_ckpt335_1370M,7,m_sp_arch_4x1_bt_32_r201_m335,5_vs_5
1076,-4,1,checkpoints_selfplay_e9_sp_ckpt335_1370M,5,m_sp_arch_4x1_bt_32_r201_m335,5_vs_5
1077,-6,1,checkpoints_selfplay_e9_sp_ckpt335_1370M,7,m_sp_arch_4x1_bt_32_r201_m335,5_vs_5
1078,-5,1,checkpoints_selfplay_e9_sp_ckpt335_1370M,6,m_sp_arch_4x1_bt_32_r201_m335,5_vs_5
1079,-5,2,checkpoints_selfplay_e9_sp_ckpt335_1370M,7,m_sp_arch_4x1_bt_32_r201_m335,5_vs_5
1080,-3,2,checkpoints_selfplay_e9_sp_ckpt335_1370M,5,m_sp_arch_4x1_bt_32_r201_m335,5_vs_5
1081,-6,3,checkpoints_selfplay_e9_sp_ckpt335_1370M,9,m_sp_arch_4x1_bt_32_r201_m335,5_vs_5
1082,-7,0,checkpoints_selfplay_e9_sp_ckpt335_1370M,7,m_sp_arch_4x1_bt_32_r201_m335,5_vs_5
1083,-5,3,checkpoints_selfplay_e9_sp_ckpt335_1370M,8,m_sp_arch_4x1_bt_32_r201_m335,5_vs_5
1084,-10,0,checkpoints_selfplay_e9_sp_ckpt335_1370M,10,m_sp_arch_4x1_bt_32_r201_m335,5_vs_5
1085,-5,1,checkpoints_selfplay_e9_sp_ckpt335_1370M,6,m_sp_arch_4x1_bt_32_r201_m335,5_vs_5
1086,-1,4,checkpoints_selfplay_e9_sp_ckpt335_1370M,5,m_sp_arch_4x1_bt_32_r201_m335,5_vs_5
1087,-3,0,checkpoints_selfplay_e9_sp_ckpt335_1370M,3,m_sp_arch_4x1_bt_32_r201_m335,5_vs_5
1088,-5,4,checkpoints_selfplay_e9_sp_ckpt335_1370M,9,m_sp_arch_4x1_bt_32_r201_m335,5_vs_5
1089,-8,0,checkpoints_selfplay_e9_sp_ckpt335_1370M,8,m_sp_arch_4x1_bt_32_r201_m335,5_vs_5
1090,-6,0,checkpoints_selfplay_e9_sp_ckpt335_1370M,6,m_sp_arch_4x1_bt_32_r201_cont3_m650,5_vs_5
1091,-1,1,checkpoints_selfplay_e9_sp_ckpt335_1370M,2,m_sp_arch_4x1_bt_32_r201_cont3_m650,5_vs_5
1092,-3,2,checkpoints_selfplay_e9_sp_ckpt335_1370M,5,m_sp_arch_4x1_bt_32_r201_cont3_m650,5_vs_5
1093,-4,0,checkpoints_selfplay_e9_sp_ckpt335_1370M,4,m_sp_arch_4x1_bt_32_r201_cont3_m650,5_vs_5
1094,-3,2,checkpoints_selfplay_e9_sp_ckpt335_1370M,5,m_sp_arch_4x1_bt_32_r201_cont3_m650,5_vs_5
1095,-6,1,checkpoints_selfplay_e9_sp_ckpt335_1370M,7,m_sp_arch_4x1_bt_32_r201_cont3_m650,5_vs_5
1096,-4,1,checkpoints_selfplay_e9_sp_ckpt335_1370M,5,m_sp_arch_4x1_bt_32_r201_cont3_m650,5_vs_5
1097,-7,2,checkpoints_selfplay_e9_sp_ckpt335_1370M,9,m_sp_arch_4x1_bt_32_r201_cont3_m650,5_vs_5
1098,-2,1,checkpoints_selfplay_e9_sp_ckpt335_1370M,3,m_sp_arch_4x1_bt_32_r201_cont3_m650,5_vs_5
1099,-5,1,checkpoints_selfplay_e9_sp_ckpt335_1370M,6,m_sp_arch_4x1_bt_32_r201_cont3_m650,5_vs_5
1100,-5,2,checkpoints_selfplay_e9_sp_ckpt335_1370M,7,m_sp_arch_4x1_bt_32_r201_cont3_m650,5_vs_5
1101,-3,0,checkpoints_selfplay_e9_sp_ckpt335_1370M,3,m_sp_arch_4x1_bt_32_r201_cont3_m650,5_vs_5
1102,-3,3,checkpoints_selfplay_e9_sp_ckpt335_1370M,6,m_sp_arch_4x1_bt_32_r201_cont3_m650,5_vs_5
1103,-8,1,checkpoints_selfplay_e9_sp_ckpt335_1370M,9,m_sp_arch_4x1_bt_32_r201_cont3_m650,5_vs_5
1104,-3,1,checkpoints_selfplay_e9_sp_ckpt335_1370M,4,m_sp_arch_4x1_bt_32_r201_cont3_m650,5_vs_5
1105,-5,1,checkpoints_selfplay_e9_sp_ckpt335_1370M,6,m_sp_arch_4x1_bt_32_r201_cont3_m650,5_vs_5
1106,-7,0,checkpoints_selfplay_e9_sp_ckpt335_1370M,7,m_sp_arch_4x1_bt_32_r201_cont3_m650,5_vs_5
1107,-6,1,checkpoints_selfplay_e9_sp_ckpt335_1370M,7,m_sp_arch_4x1_bt_32_r201_cont3_m650,5_vs_5
1108,-7,1,checkpoints_selfplay_e9_sp_ckpt335_1370M,8,m_sp_arch_4x1_bt_32_r201_cont3_m650,5_vs_5
1109,-4,3,checkpoints_selfplay_e9_sp_ckpt335_1370M,7,m_sp_arch_4x1_bt_32_r201_cont3_m650,5_vs_5
1110,-1,1,checkpoints_selfplay_e9_sp_ckpt335_1370M,2,explt_v0_7_2_m54,5_vs_5
1111,2,3,checkpoints_selfplay_e9_sp_ckpt335_1370M,1,explt_v0_7_2_m54,5_vs_5
1112,-6,0,checkpoints_selfplay_e9_sp_ckpt335_1370M,6,explt_v0_7_2_m54,5_vs_5
1113,0,2,checkpoints_selfplay_e9_sp_ckpt335_1370M,2,explt_v0_7_2_m54,5_vs_5
1114,-2,2,checkpoints_selfplay_e9_sp_ckpt335_1370M,4,explt_v0_7_2_m54,5_vs_5
1115,2,2,checkpoints_selfplay_e9_sp_ckpt335_1370M,0,explt_v0_7_2_m54,5_vs_5
1116,0,0,checkpoints_selfplay_e9_sp_ckpt335_1370M,0,explt_v0_7_2_m54,5_vs_5
1117,-3,1,checkpoints_selfplay_e9_sp_ckpt335_1370M,4,explt_v0_7_2_m54,5_vs_5
1118,-2,0,checkpoints_selfplay_e9_sp_ckpt335_1370M,2,explt_v0_7_2_m54,5_vs_5
1119,0,1,checkpoints_selfplay_e9_sp_ckpt335_1370M,1,explt_v0_7_2_m54,5_vs_5
1120,0,0,checkpoints_selfplay_e9_sp_ckpt335_1370M,0,explt_v0_7_2_m54,5_vs_5
1121,1,2,checkpoints_selfplay_e9_sp_ckpt335_1370M,1,explt_v0_7_2_m54,5_vs_5
1122,-1,1,checkpoints_selfplay_e9_sp_ckpt335_1370M,2,explt_v0_7_2_m54,5_vs_5
1123,-1,1,checkpoints_selfplay_e9_sp_ckpt335_1370M,2,explt_v0_7_2_m54,5_vs_5
1124,-1,3,checkpoints_selfplay_e9_sp_ckpt335_1370M,4,explt_v0_7_2_m54,5_vs_5
1125,-2,1,checkpoints_selfplay_e9_sp_ckpt335_1370M,3,explt_v0_7_2_m54,5_vs_5
1126,-1,2,checkpoints_selfplay_e9_sp_ckpt335_1370M,3,explt_v0_7_2_m54,5_vs_5
1127,-1,2,checkpoints_selfplay_e9_sp_ckpt335_1370M,3,explt_v0_7_2_m54,5_vs_5
1128,-1,1,checkpoints_selfplay_e9_sp_ckpt335_1370M,2,explt_v0_7_2_m54,5_vs_5
1129,1,1,checkpoints_selfplay_e9_sp_ckpt335_1370M,0,explt_v0_7_2_m54,5_vs_5
1130,-3,2,checkpoints_selfplay_e9_sp_ckpt335_1370M,5,m_sp_sc3v3_arch_2x1_32_r500_cont4x1_m224,5_vs_5
1131,1,4,checkpoints_selfplay_e9_sp_ckpt335_1370M,3,m_sp_sc3v3_arch_2x1_32_r500_cont4x1_m224,5_vs_5
1132,-5,1,checkpoints_selfplay_e9_sp_ckpt335_1370M,6,m_sp_sc3v3_arch_2x1_32_r500_cont4x1_m224,5_vs_5
1133,-6,3,checkpoints_selfplay_e9_sp_ckpt335_1370M,9,m_sp_sc3v3_arch_2x1_32_r500_cont4x1_m224,5_vs_5
1134,-2,3,checkpoints_selfplay_e9_sp_ckpt335_1370M,5,m_sp_sc3v3_arch_2x1_32_r500_cont4x1_m224,5_vs_5
1135,2,6,checkpoints_selfplay_e9_sp_ckpt335_1370M,4,m_sp_sc3v3_arch_2x1_32_r500_cont4x1_m224,5_vs_5
1136,-8,0,checkpoints_selfplay_e9_sp_ckpt335_1370M,8,m_sp_sc3v3_arch_2x1_32_r500_cont4x1_m224,5_vs_5
1137,-8,1,checkpoints_selfplay_e9_sp_ckpt335_1370M,9,m_sp_sc3v3_arch_2x1_32_r500_cont4x1_m224,5_vs_5
1138,-1,4,checkpoints_selfplay_e9_sp_ckpt335_1370M,5,m_sp_sc3v3_arch_2x1_32_r500_cont4x1_m224,5_vs_5
1139,-6,0,checkpoints_selfplay_e9_sp_ckpt335_1370M,6,m_sp_sc3v3_arch_2x1_32_r500_cont4x1_m224,5_vs_5
1140,-6,1,checkpoints_selfplay_e9_sp_ckpt335_1370M,7,m_sp_sc3v3_arch_2x1_32_r500_cont4x1_m224,5_vs_5
1141,-6,2,checkpoints_selfplay_e9_sp_ckpt335_1370M,8,m_sp_sc3v3_arch_2x1_32_r500_cont4x1_m224,5_vs_5
1142,-1,2,checkpoints_selfplay_e9_sp_ckpt335_1370M,3,m_sp_sc3v3_arch_2x1_32_r500_cont4x1_m224,5_vs_5
1143,-8,1,checkpoints_selfplay_e9_sp_ckpt335_1370M,9,m_sp_sc3v3_arch_2x1_32_r500_cont4x1_m224,5_vs_5
1144,-5,2,checkpoints_selfplay_e9_sp_ckpt335_1370M,7,m_sp_sc3v3_arch_2x1_32_r500_cont4x1_m224,5_vs_5
1145,-6,0,checkpoints_selfplay_e9_sp_ckpt335_1370M,6,m_sp_sc3v3_arch_2x1_32_r500_cont4x1_m224,5_vs_5
1146,-6,3,checkpoints_selfplay_e9_sp_ckpt335_1370M,9,m_sp_sc3v3_arch_2x1_32_r500_cont4x1_m224,5_vs_5
1147,5,7,checkpoints_selfplay_e9_sp_ckpt335_1370M,2,m_sp_sc3v3_arch_2x1_32_r500_cont4x1_m224,5_vs_5
1148,-3,2,checkpoints_selfplay_e9_sp_ckpt335_1370M,5,m_sp_sc3v3_arch_2x1_32_r500_cont4x1_m224,5_vs_5
1149,-6,1,checkpoints_selfplay_e9_sp_ckpt335_1370M,7,m_sp_sc3v3_arch_2x1_32_r500_cont4x1_m224,5_vs_5
1150,-8,0,checkpoints_selfplay_e9_sp_ckpt335_1370M,8,m_sp_arch_4x1_bt_32_roles_r500_m335,5_vs_5
1151,-5,1,checkpoints_selfplay_e9_sp_ckpt335_1370M,6,m_sp_arch_4x1_bt_32_roles_r500_m335,5_vs_5
1152,-8,1,checkpoints_selfplay_e9_sp_ckpt335_1370M,9,m_sp_arch_4x1_bt_32_roles_r500_m335,5_vs_5
1153,-9,1,checkpoints_selfplay_e9_sp_ckpt335_1370M,10,m_sp_arch_4x1_bt_32_roles_r500_m335,5_vs_5
1154,-4,3,checkpoints_selfplay_e9_sp_ckpt335_1370M,7,m_sp_arch_4x1_bt_32_roles_r500_m335,5_vs_5
1155,-6,2,checkpoints_selfplay_e9_sp_ckpt335_1370M,8,m_sp_arch_4x1_bt_32_roles_r500_m335,5_vs_5
1156,-7,1,checkpoints_selfplay_e9_sp_ckpt335_1370M,8,m_sp_arch_4x1_bt_32_roles_r500_m335,5_vs_5
1157,-5,1,checkpoints_selfplay_e9_sp_ckpt335_1370M,6,m_sp_arch_4x1_bt_32_roles_r500_m335,5_vs_5
1158,-5,3,checkpoints_selfplay_e9_sp_ckpt335_1370M,8,m_sp_arch_4x1_bt_32_roles_r500_m335,5_vs_5
1159,-8,0,checkpoints_selfplay_e9_sp_ckpt335_1370M,8,m_sp_arch_4x1_bt_32_roles_r500_m335,5_vs_5
1160,-5,4,checkpoints_selfplay_e9_sp_ckpt335_1370M,9,m_sp_arch_4x1_bt_32_roles_r500_m335,5_vs_5
1161,-4,0,checkpoints_selfplay_e9_sp_ckpt335_1370M,4,m_sp_arch_4x1_bt_32_roles_r500_m335,5_vs_5
1162,2,5,checkpoints_selfplay_e9_sp_ckpt335_1370M,3,m_sp_arch_4x1_bt_32_roles_r500_m335,5_vs_5
1163,-7,1,checkpoints_selfplay_e9_sp_ckpt335_1370M,8,m_sp_arch_4x1_bt_32_roles_r500_m335,5_vs_5
1164,-2,2,checkpoints_selfplay_e9_sp_ckpt335_1370M,4,m_sp_arch_4x1_bt_32_roles_r500_m335,5_vs_5
1165,-8,1,checkpoints_selfplay_e9_sp_ckpt335_1370M,9,m_sp_arch_4x1_bt_32_roles_r500_m335,5_vs_5
1166,-2,3,checkpoints_selfplay_e9_sp_ckpt335_1370M,5,m_sp_arch_4x1_bt_32_roles_r500_m335,5_vs_5
1167,-5,4,checkpoints_selfplay_e9_sp_ckpt335_1370M,9,m_sp_arch_4x1_bt_32_roles_r500_m335,5_vs_5
1168,-6,2,checkpoints_selfplay_e9_sp_ckpt335_1370M,8,m_sp_arch_4x1_bt_32_roles_r500_m335,5_vs_5
1169,-2,4,checkpoints_selfplay_e9_sp_ckpt335_1370M,6,m_sp_arch_4x1_bt_32_roles_r500_m335,5_vs_5
1170,14,14,less_then_partially_randomized_entropy_checkpoints_bots_4_heads_39_ckpt109,0,easy_bots,5_vs_5
1171,11,12,less_then_partially_randomized_entropy_checkpoints_bots_4_heads_39_ckpt109,1,easy_bots,5_vs_5
1172,10,10,less_then_partially_randomized_entropy_checkpoints_bots_4_heads_39_ckpt109,0,easy_bots,5_vs_5
1173,11,11,less_then_partially_randomized_entropy_checkpoints_bots_4_heads_39_ckpt109,0,easy_bots,5_vs_5
1174,15,15,less_then_partially_randomized_entropy_checkpoints_bots_4_heads_39_ckpt109,0,easy_bots,5_vs_5
1175,12,12,less_then_partially_randomized_entropy_checkpoints_bots_4_heads_39_ckpt109,0,easy_bots,5_vs_5
1176,11,13,less_then_partially_randomized_entropy_checkpoints_bots_4_heads_39_ckpt109,2,easy_bots,5_vs_5
1177,9,10,less_then_partially_randomized_entropy_checkpoints_bots_4_heads_39_ckpt109,1,easy_bots,5_vs_5
1178,12,13,less_then_partially_randomized_entropy_checkpoints_bots_4_heads_39_ckpt109,1,easy_bots,5_vs_5
1179,15,15,less_then_partially_randomized_entropy_checkpoints_bots_4_heads_39_ckpt109,0,easy_bots,5_vs_5
1180,10,10,less_then_partially_randomized_entropy_checkpoints_bots_4_heads_39_ckpt109,0,easy_bots,5_vs_5
1181,6,8,less_then_partially_randomized_entropy_checkpoints_bots_4_heads_39_ckpt109,2,easy_bots,5_vs_5
1182,11,12,less_then_partially_randomized_entropy_checkpoints_bots_4_heads_39_ckpt109,1,easy_bots,5_vs_5
1183,7,9,less_then_partially_randomized_entropy_checkpoints_bots_4_heads_39_ckpt109,2,easy_bots,5_vs_5
1184,11,12,less_then_partially_randomized_entropy_checkpoints_bots_4_heads_39_ckpt109,1,easy_bots,5_vs_5
1185,17,17,less_then_partially_randomized_entropy_checkpoints_bots_4_heads_39_ckpt109,0,easy_bots,5_vs_5
1186,7,8,less_then_partially_randomized_entropy_checkpoints_bots_4_heads_39_ckpt109,1,easy_bots,5_vs_5
1187,12,13,less_then_partially_randomized_entropy_checkpoints_bots_4_heads_39_ckpt109,1,easy_bots,5_vs_5
1188,14,14,less_then_partially_randomized_entropy_checkpoints_bots_4_heads_39_ckpt109,0,easy_bots,5_vs_5
1189,8,9,less_then_partially_randomized_entropy_checkpoints_bots_4_heads_39_ckpt109,1,easy_bots,5_vs_5
1190,3,4,less_then_partially_randomized_entropy_checkpoints_bots_4_heads_39_ckpt109,1,medium_bots,5_vs_5_medium
1191,10,11,less_then_partially_randomized_entropy_checkpoints_bots_4_heads_39_ckpt109,1,medium_bots,5_vs_5_medium
1192,8,8,less_then_partially_randomized_entropy_checkpoints_bots_4_heads_39_ckpt109,0,medium_bots,5_vs_5_medium
1193,8,8,less_then_partially_randomized_entropy_checkpoints_bots_4_heads_39_ckpt109,0,medium_bots,5_vs_5_medium
1194,4,5,less_then_partially_randomized_entropy_checkpoints_bots_4_heads_39_ckpt109,1,medium_bots,5_vs_5_medium
1195,5,8,less_then_partially_randomized_entropy_checkpoints_bots_4_heads_39_ckpt109,3,medium_bots,5_vs_5_medium
1196,8,10,less_then_partially_randomized_entropy_checkpoints_bots_4_heads_39_ckpt109,2,medium_bots,5_vs_5_medium
1197,8,9,less_then_partially_randomized_entropy_checkpoints_bots_4_heads_39_ckpt109,1,medium_bots,5_vs_5_medium
1198,7,9,less_then_partially_randomized_entropy_checkpoints_bots_4_heads_39_ckpt109,2,medium_bots,5_vs_5_medium
1199,1,3,less_then_partially_randomized_entropy_checkpoints_bots_4_heads_39_ckpt109,2,medium_bots,5_vs_5_medium
1200,6,7,less_then_partially_randomized_entropy_checkpoints_bots_4_heads_39_ckpt109,1,medium_bots,5_vs_5_medium
1201,5,8,less_then_partially_randomized_entropy_checkpoints_bots_4_heads_39_ckpt109,3,medium_bots,5_vs_5_medium
1202,9,10,less_then_partially_randomized_entropy_checkpoints_bots_4_heads_39_ckpt109,1,medium_bots,5_vs_5_medium
1203,6,6,less_then_partially_randomized_entropy_checkpoints_bots_4_heads_39_ckpt109,0,medium_bots,5_vs_5_medium
1204,7,8,less_then_partially_randomized_entropy_checkpoints_bots_4_heads_39_ckpt109,1,medium_bots,5_vs_5_medium
1205,3,5,less_then_partially_randomized_entropy_checkpoints_bots_4_heads_39_ckpt109,2,medium_bots,5_vs_5_medium
1206,10,10,less_then_partially_randomized_entropy_checkpoints_bots_4_heads_39_ckpt109,0,medium_bots,5_vs_5_medium
1207,6,8,less_then_partially_randomized_entropy_checkpoints_bots_4_heads_39_ckpt109,2,medium_bots,5_vs_5_medium
1208,5,6,less_then_partially_randomized_entropy_checkpoints_bots_4_heads_39_ckpt109,1,medium_bots,5_vs_5_medium
1209,2,2,less_then_partially_randomized_entropy_checkpoints_bots_4_heads_39_ckpt109,0,medium_bots,5_vs_5_medium
1210,4,6,less_then_partially_randomized_entropy_checkpoints_bots_4_heads_39_ckpt109,2,hard_bots,5_vs_5_hard
1211,8,10,less_then_partially_randomized_entropy_checkpoints_bots_4_heads_39_ckpt109,2,hard_bots,5_vs_5_hard
1212,3,4,less_then_partially_randomized_entropy_checkpoints_bots_4_heads_39_ckpt109,1,hard_bots,5_vs_5_hard
1213,4,4,less_then_partially_randomized_entropy_checkpoints_bots_4_heads_39_ckpt109,0,hard_bots,5_vs_5_hard
1214,-1,1,less_then_partially_randomized_entropy_checkpoints_bots_4_heads_39_ckpt109,2,hard_bots,5_vs_5_hard
1215,8,9,less_then_partially_randomized_entropy_checkpoints_bots_4_heads_39_ckpt109,1,hard_bots,5_vs_5_hard
1216,5,6,less_then_partially_randomized_entropy_checkpoints_bots_4_heads_39_ckpt109,1,hard_bots,5_vs_5_hard
1217,1,3,less_then_partially_randomized_entropy_checkpoints_bots_4_heads_39_ckpt109,2,hard_bots,5_vs_5_hard
1218,6,7,less_then_partially_randomized_entropy_checkpoints_bots_4_heads_39_ckpt109,1,hard_bots,5_vs_5_hard
1219,2,4,less_then_partially_randomized_entropy_checkpoints_bots_4_heads_39_ckpt109,2,hard_bots,5_vs_5_hard
1220,7,8,less_then_partially_randomized_entropy_checkpoints_bots_4_heads_39_ckpt109,1,hard_bots,5_vs_5_hard
1221,1,2,less_then_partially_randomized_entropy_checkpoints_bots_4_heads_39_ckpt109,1,hard_bots,5_vs_5_hard
1222,5,7,less_then_partially_randomized_entropy_checkpoints_bots_4_heads_39_ckpt109,2,hard_bots,5_vs_5_hard
1223,5,6,less_then_partially_randomized_entropy_checkpoints_bots_4_heads_39_ckpt109,1,hard_bots,5_vs_5_hard
1224,8,8,less_then_partially_randomized_entropy_checkpoints_bots_4_heads_39_ckpt109,0,hard_bots,5_vs_5_hard
1225,2,5,less_then_partially_randomized_entropy_checkpoints_bots_4_heads_39_ckpt109,3,hard_bots,5_vs_5_hard
1226,2,2,less_then_partially_randomized_entropy_checkpoints_bots_4_heads_39_ckpt109,0,hard_bots,5_vs_5_hard
1227,4,6,less_then_partially_randomized_entropy_checkpoints_bots_4_heads_39_ckpt109,2,hard_bots,5_vs_5_hard
1228,0,2,less_then_partially_randomized_entropy_checkpoints_bots_4_heads_39_ckpt109,2,hard_bots,5_vs_5_hard
1229,4,5,less_then_partially_randomized_entropy_checkpoints_bots_4_heads_39_ckpt109,1,hard_bots,5_vs_5_hard
1230,-2,3,less_then_partially_randomized_entropy_checkpoints_bots_4_heads_39_ckpt109,5,f5v0to1to2t05_e2_ckpt291,5_vs_5
1231,-2,3,less_then_partially_randomized_entropy_checkpoints_bots_4_heads_39_ckpt109,5,f5v0to1to2t05_e2_ckpt291,5_vs_5
1232,0,4,less_then_partially_randomized_entropy_checkpoints_bots_4_heads_39_ckpt109,4,f5v0to1to2t05_e2_ckpt291,5_vs_5
1233,1,6,less_then_partially_randomized_entropy_checkpoints_bots_4_heads_39_ckpt109,5,f5v0to1to2t05_e2_ckpt291,5_vs_5
1234,-6,3,less_then_partially_randomized_entropy_checkpoints_bots_4_heads_39_ckpt109,9,f5v0to1to2t05_e2_ckpt291,5_vs_5
1235,0,3,less_then_partially_randomized_entropy_checkpoints_bots_4_heads_39_ckpt109,3,f5v0to1to2t05_e2_ckpt291,5_vs_5
1236,2,4,less_then_partially_randomized_entropy_checkpoints_bots_4_heads_39_ckpt109,2,f5v0to1to2t05_e2_ckpt291,5_vs_5
1237,0,4,less_then_partially_randomized_entropy_checkpoints_bots_4_heads_39_ckpt109,4,f5v0to1to2t05_e2_ckpt291,5_vs_5
1238,1,3,less_then_partially_randomized_entropy_checkpoints_bots_4_heads_39_ckpt109,2,f5v0to1to2t05_e2_ckpt291,5_vs_5
1239,5,6,less_then_partially_randomized_entropy_checkpoints_bots_4_heads_39_ckpt109,1,f5v0to1to2t05_e2_ckpt291,5_vs_5
1240,2,5,less_then_partially_randomized_entropy_checkpoints_bots_4_heads_39_ckpt109,3,f5v0to1to5_e2_ckpt252,5_vs_5
1241,-1,4,less_then_partially_randomized_entropy_checkpoints_bots_4_heads_39_ckpt109,5,f5v0to1to5_e2_ckpt252,5_vs_5
1242,-4,1,less_then_partially_randomized_entropy_checkpoints_bots_4_heads_39_ckpt109,5,f5v0to1to5_e2_ckpt252,5_vs_5
1243,4,5,less_then_partially_randomized_entropy_checkpoints_bots_4_heads_39_ckpt109,1,f5v0to1to5_e2_ckpt252,5_vs_5
1244,-4,4,less_then_partially_randomized_entropy_checkpoints_bots_4_heads_39_ckpt109,8,f5v0to1to5_e2_ckpt252,5_vs_5
1245,0,4,less_then_partially_randomized_entropy_checkpoints_bots_4_heads_39_ckpt109,4,f5v0to1to5_e2_ckpt252,5_vs_5
1246,-1,2,less_then_partially_randomized_entropy_checkpoints_bots_4_heads_39_ckpt109,3,f5v0to1to5_e2_ckpt252,5_vs_5
1247,-5,3,less_then_partially_randomized_entropy_checkpoints_bots_4_heads_39_ckpt109,8,f5v0to1to5_e2_ckpt252,5_vs_5
1248,0,5,less_then_partially_randomized_entropy_checkpoints_bots_4_heads_39_ckpt109,5,f5v0to1to5_e2_ckpt252,5_vs_5
1249,-2,2,less_then_partially_randomized_entropy_checkpoints_bots_4_heads_39_ckpt109,4,f5v0to1to5_e2_ckpt252,5_vs_5
1250,3,5,less_then_partially_randomized_entropy_checkpoints_bots_4_heads_39_ckpt109,2,scon_e3_p2_hard_ckpt840,5_vs_5
1251,-1,3,less_then_partially_randomized_entropy_checkpoints_bots_4_heads_39_ckpt109,4,scon_e3_p2_hard_ckpt840,5_vs_5
1252,1,3,less_then_partially_randomized_entropy_checkpoints_bots_4_heads_39_ckpt109,2,scon_e3_p2_hard_ckpt840,5_vs_5
1253,0,3,less_then_partially_randomized_entropy_checkpoints_bots_4_heads_39_ckpt109,3,scon_e3_p2_hard_ckpt840,5_vs_5
1254,2,3,less_then_partially_randomized_entropy_checkpoints_bots_4_heads_39_ckpt109,1,scon_e3_p2_hard_ckpt840,5_vs_5
1255,2,5,less_then_partially_randomized_entropy_checkpoints_bots_4_heads_39_ckpt109,3,scon_e3_p2_hard_ckpt840,5_vs_5
1256,6,8,less_then_partially_randomized_entropy_checkpoints_bots_4_heads_39_ckpt109,2,scon_e3_p2_hard_ckpt840,5_vs_5
1257,-5,0,less_then_partially_randomized_entropy_checkpoints_bots_4_heads_39_ckpt109,5,scon_e3_p2_hard_ckpt840,5_vs_5
1258,-2,2,less_then_partially_randomized_entropy_checkpoints_bots_4_heads_39_ckpt109,4,scon_e3_p2_hard_ckpt840,5_vs_5
1259,0,2,less_then_partially_randomized_entropy_checkpoints_bots_4_heads_39_ckpt109,2,scon_e3_p2_hard_ckpt840,5_vs_5
1260,1,4,less_then_partially_randomized_entropy_checkpoints_bots_4_heads_39_ckpt109,3,less_then_partially_randomized_checkpoints_bots_4_heads_38_ckpt108,5_vs_5
1261,4,6,less_then_partially_randomized_entropy_checkpoints_bots_4_heads_39_ckpt109,2,less_then_partially_randomized_checkpoints_bots_4_heads_38_ckpt108,5_vs_5
1262,1,5,less_then_partially_randomized_entropy_checkpoints_bots_4_heads_39_ckpt109,4,less_then_partially_randomized_checkpoints_bots_4_heads_38_ckpt108,5_vs_5
1263,2,5,less_then_partially_randomized_entropy_checkpoints_bots_4_heads_39_ckpt109,3,less_then_partially_randomized_checkpoints_bots_4_heads_38_ckpt108,5_vs_5
1264,1,5,less_then_partially_randomized_entropy_checkpoints_bots_4_heads_39_ckpt109,4,less_then_partially_randomized_checkpoints_bots_4_heads_38_ckpt108,5_vs_5
1265,0,3,less_then_partially_randomized_entropy_checkpoints_bots_4_heads_39_ckpt109,3,less_then_partially_randomized_checkpoints_bots_4_heads_38_ckpt108,5_vs_5
1266,1,6,less_then_partially_randomized_entropy_checkpoints_bots_4_heads_39_ckpt109,5,less_then_partially_randomized_checkpoints_bots_4_heads_38_ckpt108,5_vs_5
1267,2,5,less_then_partially_randomized_entropy_checkpoints_bots_4_heads_39_ckpt109,3,less_then_partially_randomized_checkpoints_bots_4_heads_38_ckpt108,5_vs_5
1268,-3,2,less_then_partially_randomized_entropy_checkpoints_bots_4_heads_39_ckpt109,5,less_then_partially_randomized_checkpoints_bots_4_heads_38_ckpt108,5_vs_5
1269,2,6,less_then_partially_randomized_entropy_checkpoints_bots_4_heads_39_ckpt109,4,less_then_partially_randomized_checkpoints_bots_4_heads_38_ckpt108,5_vs_5
1270,0,4,less_then_partially_randomized_entropy_checkpoints_bots_4_heads_39_ckpt109,4,less_then_partially_randomized_entropy_checkpoints_bots_4_heads_39_ckpt109,5_vs_5
1271,-3,4,less_then_partially_randomized_entropy_checkpoints_bots_4_heads_39_ckpt109,7,less_then_partially_randomized_entropy_checkpoints_bots_4_heads_39_ckpt109,5_vs_5
1272,1,4,less_then_partially_randomized_entropy_checkpoints_bots_4_heads_39_ckpt109,3,less_then_partially_randomized_entropy_checkpoints_bots_4_heads_39_ckpt109,5_vs_5
1273,1,5,less_then_partially_randomized_entropy_checkpoints_bots_4_heads_39_ckpt109,4,less_then_partially_randomized_entropy_checkpoints_bots_4_heads_39_ckpt109,5_vs_5
1274,5,8,less_then_partially_randomized_entropy_checkpoints_bots_4_heads_39_ckpt109,3,less_then_partially_randomized_entropy_checkpoints_bots_4_heads_39_ckpt109,5_vs_5
1275,3,4,less_then_partially_randomized_entropy_checkpoints_bots_4_heads_39_ckpt109,1,less_then_partially_randomized_entropy_checkpoints_bots_4_heads_39_ckpt109,5_vs_5
1276,2,6,less_then_partially_randomized_entropy_checkpoints_bots_4_heads_39_ckpt109,4,less_then_partially_randomized_entropy_checkpoints_bots_4_heads_39_ckpt109,5_vs_5
1277,0,4,less_then_partially_randomized_entropy_checkpoints_bots_4_heads_39_ckpt109,4,less_then_partially_randomized_entropy_checkpoints_bots_4_heads_39_ckpt109,5_vs_5
1278,0,4,less_then_partially_randomized_entropy_checkpoints_bots_4_heads_39_ckpt109,4,less_then_partially_randomized_entropy_checkpoints_bots_4_heads_39_ckpt109,5_vs_5
1279,-5,1,less_then_partially_randomized_entropy_checkpoints_bots_4_heads_39_ckpt109,6,less_then_partially_randomized_entropy_checkpoints_bots_4_heads_39_ckpt109,5_vs_5
1280,1,5,less_then_partially_randomized_entropy_checkpoints_bots_4_heads_39_ckpt109,4,reward_shaping_checkpoints_bots_4_heads_1_ckpt360,5_vs_5
1281,2,5,less_then_partially_randomized_entropy_checkpoints_bots_4_heads_39_ckpt109,3,reward_shaping_checkpoints_bots_4_heads_1_ckpt360,5_vs_5
1282,-1,3,less_then_partially_randomized_entropy_checkpoints_bots_4_heads_39_ckpt109,4,reward_shaping_checkpoints_bots_4_heads_1_ckpt360,5_vs_5
1283,2,4,less_then_partially_randomized_entropy_checkpoints_bots_4_heads_39_ckpt109,2,reward_shaping_checkpoints_bots_4_heads_1_ckpt360,5_vs_5
1284,2,6,less_then_partially_randomized_entropy_checkpoints_bots_4_heads_39_ckpt109,4,reward_shaping_checkpoints_bots_4_heads_1_ckpt360,5_vs_5
1285,0,3,less_then_partially_randomized_entropy_checkpoints_bots_4_heads_39_ckpt109,3,reward_shaping_checkpoints_bots_4_heads_1_ckpt360,5_vs_5
1286,-1,2,less_then_partially_randomized_entropy_checkpoints_bots_4_heads_39_ckpt109,3,reward_shaping_checkpoints_bots_4_heads_1_ckpt360,5_vs_5
1287,4,6,less_then_partially_randomized_entropy_checkpoints_bots_4_heads_39_ckpt109,2,reward_shaping_checkpoints_bots_4_heads_1_ckpt360,5_vs_5
1288,-1,2,less_then_partially_randomized_entropy_checkpoints_bots_4_heads_39_ckpt109,3,reward_shaping_checkpoints_bots_4_heads_1_ckpt360,5_vs_5
1289,-1,3,less_then_partially_randomized_entropy_checkpoints_bots_4_heads_39_ckpt109,4,reward_shaping_checkpoints_bots_4_heads_1_ckpt360,5_vs_5
1290,-9,1,less_then_partially_randomized_entropy_checkpoints_bots_4_heads_39_ckpt109,10,checkpoints_selfplay_e9_sp_ckpt274,5_vs_5
1291,-12,2,less_then_partially_randomized_entropy_checkpoints_bots_4_heads_39_ckpt109,14,checkpoints_selfplay_e9_sp_ckpt274,5_vs_5
1292,-8,1,less_then_partially_randomized_entropy_checkpoints_bots_4_heads_39_ckpt109,9,checkpoints_selfplay_e9_sp_ckpt274,5_vs_5
1293,-14,1,less_then_partially_randomized_entropy_checkpoints_bots_4_heads_39_ckpt109,15,checkpoints_selfplay_e9_sp_ckpt274,5_vs_5
1294,-4,5,less_then_partially_randomized_entropy_checkpoints_bots_4_heads_39_ckpt109,9,checkpoints_selfplay_e9_sp_ckpt274,5_vs_5
1295,-14,0,less_then_partially_randomized_entropy_checkpoints_bots_4_heads_39_ckpt109,14,checkpoints_selfplay_e9_sp_ckpt274,5_vs_5
1296,-8,1,less_then_partially_randomized_entropy_checkpoints_bots_4_heads_39_ckpt109,9,checkpoints_selfplay_e9_sp_ckpt274,5_vs_5
1297,-11,1,less_then_partially_randomized_entropy_checkpoints_bots_4_heads_39_ckpt109,12,checkpoints_selfplay_e9_sp_ckpt274,5_vs_5
1298,-8,3,less_then_partially_randomized_entropy_checkpoints_bots_4_heads_39_ckpt109,11,checkpoints_selfplay_e9_sp_ckpt274,5_vs_5
1299,-13,1,less_then_partially_randomized_entropy_checkpoints_bots_4_heads_39_ckpt109,14,checkpoints_selfplay_e9_sp_ckpt274,5_vs_5
1300,-5,1,less_then_partially_randomized_entropy_checkpoints_bots_4_heads_39_ckpt109,6,checkpoints_sp_c_nb_e2_ckpt667,5_vs_5
1301,-11,1,less_then_partially_randomized_entropy_checkpoints_bots_4_heads_39_ckpt109,12,checkpoints_sp_c_nb_e2_ckpt667,5_vs_5
1302,-3,0,less_then_partially_randomized_entropy_checkpoints_bots_4_heads_39_ckpt109,3,checkpoints_sp_c_nb_e2_ckpt667,5_vs_5
1303,-6,1,less_then_partially_randomized_entropy_checkpoints_bots_4_heads_39_ckpt109,7,checkpoints_sp_c_nb_e2_ckpt667,5_vs_5
1304,-3,1,less_then_partially_randomized_entropy_checkpoints_bots_4_heads_39_ckpt109,4,checkpoints_sp_c_nb_e2_ckpt667,5_vs_5
1305,-11,0,less_then_partially_randomized_entropy_checkpoints_bots_4_heads_39_ckpt109,11,checkpoints_sp_c_nb_e2_ckpt667,5_vs_5
1306,-2,2,less_then_partially_randomized_entropy_checkpoints_bots_4_heads_39_ckpt109,4,checkpoints_sp_c_nb_e2_ckpt667,5_vs_5
1307,-8,0,less_then_partially_randomized_entropy_checkpoints_bots_4_heads_39_ckpt109,8,checkpoints_sp_c_nb_e2_ckpt667,5_vs_5
1308,-8,0,less_then_partially_randomized_entropy_checkpoints_bots_4_heads_39_ckpt109,8,checkpoints_sp_c_nb_e2_ckpt667,5_vs_5
1309,-10,2,less_then_partially_randomized_entropy_checkpoints_bots_4_heads_39_ckpt109,12,checkpoints_sp_c_nb_e2_ckpt667,5_vs_5
1310,1,1,less_then_partially_randomized_entropy_checkpoints_bots_4_heads_39_ckpt109,0,scenario_curriculum_ckpt830,5_vs_5
1311,0,0,less_then_partially_randomized_entropy_checkpoints_bots_4_heads_39_ckpt109,0,scenario_curriculum_ckpt830,5_vs_5
1312,1,1,less_then_partially_randomized_entropy_checkpoints_bots_4_heads_39_ckpt109,0,scenario_curriculum_ckpt830,5_vs_5
1313,0,0,less_then_partially_randomized_entropy_checkpoints_bots_4_heads_39_ckpt109,0,scenario_curriculum_ckpt830,5_vs_5
1314,2,2,less_then_partially_randomized_entropy_checkpoints_bots_4_heads_39_ckpt109,0,scenario_curriculum_ckpt830,5_vs_5
1315,1,1,less_then_partially_randomized_entropy_checkpoints_bots_4_heads_39_ckpt109,0,scenario_curriculum_ckpt830,5_vs_5
1316,2,2,less_then_partially_randomized_entropy_checkpoints_bots_4_heads_39_ckpt109,0,scenario_curriculum_ckpt830,5_vs_5
1317,0,0,less_then_partially_randomized_entropy_checkpoints_bots_4_heads_39_ckpt109,0,scenario_curriculum_ckpt830,5_vs_5
1318,1,1,less_then_partially_randomized_entropy_checkpoints_bots_4_heads_39_ckpt109,0,scenario_curriculum_ckpt830,5_vs_5
1319,0,0,less_then_partially_randomized_entropy_checkpoints_bots_4_heads_39_ckpt109,0,scenario_curriculum_ckpt830,5_vs_5
1320,1,4,less_then_partially_randomized_entropy_checkpoints_bots_4_heads_39_ckpt109,3,m_sp_arch_medium_heads_conv16_0_bt_32_r313_m335,5_vs_5
1321,-2,1,less_then_partially_randomized_entropy_checkpoints_bots_4_heads_39_ckpt109,3,m_sp_arch_medium_heads_conv16_0_bt_32_r313_m335,5_vs_5
1322,0,3,less_then_partially_randomized_entropy_checkpoints_bots_4_heads_39_ckpt109,3,m_sp_arch_medium_heads_conv16_0_bt_32_r313_m335,5_vs_5
1323,0,2,less_then_partially_randomized_entropy_checkpoints_bots_4_heads_39_ckpt109,2,m_sp_arch_medium_heads_conv16_0_bt_32_r313_m335,5_vs_5
1324,3,4,less_then_partially_randomized_entropy_checkpoints_bots_4_heads_39_ckpt109,1,m_sp_arch_medium_heads_conv16_0_bt_32_r313_m335,5_vs_5
1325,1,2,less_then_partially_randomized_entropy_checkpoints_bots_4_heads_39_ckpt109,1,m_sp_arch_medium_heads_conv16_0_bt_32_r313_m335,5_vs_5
1326,0,3,less_then_partially_randomized_entropy_checkpoints_bots_4_heads_39_ckpt109,3,m_sp_arch_medium_heads_conv16_0_bt_32_r313_m335,5_vs_5
1327,0,2,less_then_partially_randomized_entropy_checkpoints_bots_4_heads_39_ckpt109,2,m_sp_arch_medium_heads_conv16_0_bt_32_r313_m335,5_vs_5
1328,1,3,less_then_partially_randomized_entropy_checkpoints_bots_4_heads_39_ckpt109,2,m_sp_arch_medium_heads_conv16_0_bt_32_r313_m335,5_vs_5
1329,2,5,less_then_partially_randomized_entropy_checkpoints_bots_4_heads_39_ckpt109,3,m_sp_arch_medium_heads_conv16_0_bt_32_r313_m335,5_vs_5
1330,-5,1,less_then_partially_randomized_entropy_checkpoints_bots_4_heads_39_ckpt109,6,m_sp_arch_longer_heads_bt_32_r201_m335,5_vs_5
1331,-2,2,less_then_partially_randomized_entropy_checkpoints_bots_4_heads_39_ckpt109,4,m_sp_arch_longer_heads_bt_32_r201_m335,5_vs_5
1332,-3,0,less_then_partially_randomized_entropy_checkpoints_bots_4_heads_39_ckpt109,3,m_sp_arch_longer_heads_bt_32_r201_m335,5_vs_5
1333,-7,1,less_then_partially_randomized_entropy_checkpoints_bots_4_heads_39_ckpt109,8,m_sp_arch_longer_heads_bt_32_r201_m335,5_vs_5
1334,-4,0,less_then_partially_randomized_entropy_checkpoints_bots_4_heads_39_ckpt109,4,m_sp_arch_longer_heads_bt_32_r201_m335,5_vs_5
1335,-6,1,less_then_partially_randomized_entropy_checkpoints_bots_4_heads_39_ckpt109,7,m_sp_arch_longer_heads_bt_32_r201_m335,5_vs_5
1336,-2,1,less_then_partially_randomized_entropy_checkpoints_bots_4_heads_39_ckpt109,3,m_sp_arch_longer_heads_bt_32_r201_m335,5_vs_5
1337,-7,1,less_then_partially_randomized_entropy_checkpoints_bots_4_heads_39_ckpt109,8,m_sp_arch_longer_heads_bt_32_r201_m335,5_vs_5
1338,-3,1,less_then_partially_randomized_entropy_checkpoints_bots_4_heads_39_ckpt109,4,m_sp_arch_longer_heads_bt_32_r201_m335,5_vs_5
1339,-4,0,less_then_partially_randomized_entropy_checkpoints_bots_4_heads_39_ckpt109,4,m_sp_arch_longer_heads_bt_32_r201_m335,5_vs_5
1340,-3,3,less_then_partially_randomized_entropy_checkpoints_bots_4_heads_39_ckpt109,6,m_sp_arch_medium_heads_bt_32_r201_m335,5_vs_5
1341,-9,1,less_then_partially_randomized_entropy_checkpoints_bots_4_heads_39_ckpt109,10,m_sp_arch_medium_heads_bt_32_r201_m335,5_vs_5
1342,-2,1,less_then_partially_randomized_entropy_checkpoints_bots_4_heads_39_ckpt109,3,m_sp_arch_medium_heads_bt_32_r201_m335,5_vs_5
1343,-8,2,less_then_partially_randomized_entropy_checkpoints_bots_4_heads_39_ckpt109,10,m_sp_arch_medium_heads_bt_32_r201_m335,5_vs_5
1344,-6,0,less_then_partially_randomized_entropy_checkpoints_bots_4_heads_39_ckpt109,6,m_sp_arch_medium_heads_bt_32_r201_m335,5_vs_5
1345,-8,2,less_then_partially_randomized_entropy_checkpoints_bots_4_heads_39_ckpt109,10,m_sp_arch_medium_heads_bt_32_r201_m335,5_vs_5
1346,-2,1,less_then_partially_randomized_entropy_checkpoints_bots_4_heads_39_ckpt109,3,m_sp_arch_medium_heads_bt_32_r201_m335,5_vs_5
1347,-4,3,less_then_partially_randomized_entropy_checkpoints_bots_4_heads_39_ckpt109,7,m_sp_arch_medium_heads_bt_32_r201_m335,5_vs_5
1348,-6,1,less_then_partially_randomized_entropy_checkpoints_bots_4_heads_39_ckpt109,7,m_sp_arch_medium_heads_bt_32_r201_m335,5_vs_5
1349,-3,2,less_then_partially_randomized_entropy_checkpoints_bots_4_heads_39_ckpt109,5,m_sp_arch_medium_heads_bt_32_r201_m335,5_vs_5
1350,-11,0,less_then_partially_randomized_entropy_checkpoints_bots_4_heads_39_ckpt109,11,m_sp_arch_4x1_bt_32_r201_m335,5_vs_5
1351,-11,0,less_then_partially_randomized_entropy_checkpoints_bots_4_heads_39_ckpt109,11,m_sp_arch_4x1_bt_32_r201_m335,5_vs_5
1352,-14,0,less_then_partially_randomized_entropy_checkpoints_bots_4_heads_39_ckpt109,14,m_sp_arch_4x1_bt_32_r201_m335,5_vs_5
1353,-11,0,less_then_partially_randomized_entropy_checkpoints_bots_4_heads_39_ckpt109,11,m_sp_arch_4x1_bt_32_r201_m335,5_vs_5
1354,-13,1,less_then_partially_randomized_entropy_checkpoints_bots_4_heads_39_ckpt109,14,m_sp_arch_4x1_bt_32_r201_m335,5_vs_5
1355,-12,0,less_then_partially_randomized_entropy_checkpoints_bots_4_heads_39_ckpt109,12,m_sp_arch_4x1_bt_32_r201_m335,5_vs_5
1356,-7,0,less_then_partially_randomized_entropy_checkpoints_bots_4_heads_39_ckpt109,7,m_sp_arch_4x1_bt_32_r201_m335,5_vs_5
1357,-13,0,less_then_partially_randomized_entropy_checkpoints_bots_4_heads_39_ckpt109,13,m_sp_arch_4x1_bt_32_r201_m335,5_vs_5
1358,-10,0,less_then_partially_randomized_entropy_checkpoints_bots_4_heads_39_ckpt109,10,m_sp_arch_4x1_bt_32_r201_m335,5_vs_5
1359,-6,0,less_then_partially_randomized_entropy_checkpoints_bots_4_heads_39_ckpt109,6,m_sp_arch_4x1_bt_32_r201_m335,5_vs_5
1360,-10,0,less_then_partially_randomized_entropy_checkpoints_bots_4_heads_39_ckpt109,10,m_sp_arch_4x1_bt_32_r201_cont3_m650,5_vs_5
1361,-9,0,less_then_partially_randomized_entropy_checkpoints_bots_4_heads_39_ckpt109,9,m_sp_arch_4x1_bt_32_r201_cont3_m650,5_vs_5
1362,-11,0,less_then_partially_randomized_entropy_checkpoints_bots_4_heads_39_ckpt109,11,m_sp_arch_4x1_bt_32_r201_cont3_m650,5_vs_5
1363,-14,0,less_then_partially_randomized_entropy_checkpoints_bots_4_heads_39_ckpt109,14,m_sp_arch_4x1_bt_32_r201_cont3_m650,5_vs_5
1364,-11,0,less_then_partially_randomized_entropy_checkpoints_bots_4_heads_39_ckpt109,11,m_sp_arch_4x1_bt_32_r201_cont3_m650,5_vs_5
1365,-11,0,less_then_partially_randomized_entropy_checkpoints_bots_4_heads_39_ckpt109,11,m_sp_arch_4x1_bt_32_r201_cont3_m650,5_vs_5
1366,-12,0,less_then_partially_randomized_entropy_checkpoints_bots_4_heads_39_ckpt109,12,m_sp_arch_4x1_bt_32_r201_cont3_m650,5_vs_5
1367,-10,0,less_then_partially_randomized_entropy_checkpoints_bots_4_heads_39_ckpt109,10,m_sp_arch_4x1_bt_32_r201_cont3_m650,5_vs_5
1368,-11,0,less_then_partially_randomized_entropy_checkpoints_bots_4_heads_39_ckpt109,11,m_sp_arch_4x1_bt_32_r201_cont3_m650,5_vs_5
1369,-8,0,less_then_partially_randomized_entropy_checkpoints_bots_4_heads_39_ckpt109,8,m_sp_arch_4x1_bt_32_r201_cont3_m650,5_vs_5
1370,-1,1,less_then_partially_randomized_entropy_checkpoints_bots_4_heads_39_ckpt109,2,explt_v0_7_2_m54,5_vs_5
1371,-8,0,less_then_partially_randomized_entropy_checkpoints_bots_4_heads_39_ckpt109,8,explt_v0_7_2_m54,5_vs_5
1372,-1,1,less_then_partially_randomized_entropy_checkpoints_bots_4_heads_39_ckpt109,2,explt_v0_7_2_m54,5_vs_5
1373,-3,0,less_then_partially_randomized_entropy_checkpoints_bots_4_heads_39_ckpt109,3,explt_v0_7_2_m54,5_vs_5
1374,-4,1,less_then_partially_randomized_entropy_checkpoints_bots_4_heads_39_ckpt109,5,explt_v0_7_2_m54,5_vs_5
1375,-4,0,less_then_partially_randomized_entropy_checkpoints_bots_4_heads_39_ckpt109,4,explt_v0_7_2_m54,5_vs_5
1376,0,0,less_then_partially_randomized_entropy_checkpoints_bots_4_heads_39_ckpt109,0,explt_v0_7_2_m54,5_vs_5
1377,-2,1,less_then_partially_randomized_entropy_checkpoints_bots_4_heads_39_ckpt109,3,explt_v0_7_2_m54,5_vs_5
1378,-4,0,less_then_partially_randomized_entropy_checkpoints_bots_4_heads_39_ckpt109,4,explt_v0_7_2_m54,5_vs_5
1379,-3,0,less_then_partially_randomized_entropy_checkpoints_bots_4_heads_39_ckpt109,3,explt_v0_7_2_m54,5_vs_5
1380,-12,0,less_then_partially_randomized_entropy_checkpoints_bots_4_heads_39_ckpt109,12,m_sp_sc3v3_arch_2x1_32_r500_cont4x1_m224,5_vs_5
1381,-17,0,less_then_partially_randomized_entropy_checkpoints_bots_4_heads_39_ckpt109,17,m_sp_sc3v3_arch_2x1_32_r500_cont4x1_m224,5_vs_5
1382,-12,0,less_then_partially_randomized_entropy_checkpoints_bots_4_heads_39_ckpt109,12,m_sp_sc3v3_arch_2x1_32_r500_cont4x1_m224,5_vs_5
1383,-18,0,less_then_partially_randomized_entropy_checkpoints_bots_4_heads_39_ckpt109,18,m_sp_sc3v3_arch_2x1_32_r500_cont4x1_m224,5_vs_5
1384,-12,0,less_then_partially_randomized_entropy_checkpoints_bots_4_heads_39_ckpt109,12,m_sp_sc3v3_arch_2x1_32_r500_cont4x1_m224,5_vs_5
1385,-13,1,less_then_partially_randomized_entropy_checkpoints_bots_4_heads_39_ckpt109,14,m_sp_sc3v3_arch_2x1_32_r500_cont4x1_m224,5_vs_5
1386,-12,0,less_then_partially_randomized_entropy_checkpoints_bots_4_heads_39_ckpt109,12,m_sp_sc3v3_arch_2x1_32_r500_cont4x1_m224,5_vs_5
1387,-10,0,less_then_partially_randomized_entropy_checkpoints_bots_4_heads_39_ckpt109,10,m_sp_sc3v3_arch_2x1_32_r500_cont4x1_m224,5_vs_5
1388,-7,0,less_then_partially_randomized_entropy_checkpoints_bots_4_heads_39_ckpt109,7,m_sp_sc3v3_arch_2x1_32_r500_cont4x1_m224,5_vs_5
1389,-9,0,less_then_partially_randomized_entropy_checkpoints_bots_4_heads_39_ckpt109,9,m_sp_sc3v3_arch_2x1_32_r500_cont4x1_m224,5_vs_5
1390,-13,0,less_then_partially_randomized_entropy_checkpoints_bots_4_heads_39_ckpt109,13,m_sp_arch_4x1_bt_32_roles_r500_m335,5_vs_5
1391,-14,0,less_then_partially_randomized_entropy_checkpoints_bots_4_heads_39_ckpt109,14,m_sp_arch_4x1_bt_32_roles_r500_m335,5_vs_5
1392,-9,1,less_then_partially_randomized_entropy_checkpoints_bots_4_heads_39_ckpt109,10,m_sp_arch_4x1_bt_32_roles_r500_m335,5_vs_5
1393,-16,0,less_then_partially_randomized_entropy_checkpoints_bots_4_heads_39_ckpt109,16,m_sp_arch_4x1_bt_32_roles_r500_m335,5_vs_5
1394,-12,1,less_then_partially_randomized_entropy_checkpoints_bots_4_heads_39_ckpt109,13,m_sp_arch_4x1_bt_32_roles_r500_m335,5_vs_5
1395,-18,0,less_then_partially_randomized_entropy_checkpoints_bots_4_heads_39_ckpt109,18,m_sp_arch_4x1_bt_32_roles_r500_m335,5_vs_5
1396,-8,0,less_then_partially_randomized_entropy_checkpoints_bots_4_heads_39_ckpt109,8,m_sp_arch_4x1_bt_32_roles_r500_m335,5_vs_5
1397,-11,0,less_then_partially_randomized_entropy_checkpoints_bots_4_heads_39_ckpt109,11,m_sp_arch_4x1_bt_32_roles_r500_m335,5_vs_5
1398,-12,0,less_then_partially_randomized_entropy_checkpoints_bots_4_heads_39_ckpt109,12,m_sp_arch_4x1_bt_32_roles_r500_m335,5_vs_5
1399,-10,1,less_then_partially_randomized_entropy_checkpoints_bots_4_heads_39_ckpt109,11,m_sp_arch_4x1_bt_32_roles_r500_m335,5_vs_5
1400,1,3,m_sp_arch_longer_heads_bt_32_r310_m277_1370M,2,easy_bots,5_vs_5
1401,3,3,m_sp_arch_longer_heads_bt_32_r310_m277_1370M,0,easy_bots,5_vs_5
1402,1,3,m_sp_arch_longer_heads_bt_32_r310_m277_1370M,2,easy_bots,5_vs_5
1403,0,1,m_sp_arch_longer_heads_bt_32_r310_m277_1370M,1,easy_bots,5_vs_5
1404,1,2,m_sp_arch_longer_heads_bt_32_r310_m277_1370M,1,easy_bots,5_vs_5
1405,2,2,m_sp_arch_longer_heads_bt_32_r310_m277_1370M,0,easy_bots,5_vs_5
1406,3,3,m_sp_arch_longer_heads_bt_32_r310_m277_1370M,0,easy_bots,5_vs_5
1407,-1,0,m_sp_arch_longer_heads_bt_32_r310_m277_1370M,1,easy_bots,5_vs_5
1408,-1,1,m_sp_arch_longer_heads_bt_32_r310_m277_1370M,2,easy_bots,5_vs_5
1409,1,2,m_sp_arch_longer_heads_bt_32_r310_m277_1370M,1,easy_bots,5_vs_5
1410,4,4,m_sp_arch_longer_heads_bt_32_r310_m277_1370M,0,easy_bots,5_vs_5
1411,2,2,m_sp_arch_longer_heads_bt_32_r310_m277_1370M,0,easy_bots,5_vs_5
1412,0,1,m_sp_arch_longer_heads_bt_32_r310_m277_1370M,1,easy_bots,5_vs_5
1413,1,3,m_sp_arch_longer_heads_bt_32_r310_m277_1370M,2,easy_bots,5_vs_5
1414,2,3,m_sp_arch_longer_heads_bt_32_r310_m277_1370M,1,easy_bots,5_vs_5
1415,0,1,m_sp_arch_longer_heads_bt_32_r310_m277_1370M,1,easy_bots,5_vs_5
1416,0,3,m_sp_arch_longer_heads_bt_32_r310_m277_1370M,3,easy_bots,5_vs_5
1417,0,1,m_sp_arch_longer_heads_bt_32_r310_m277_1370M,1,easy_bots,5_vs_5
1418,1,2,m_sp_arch_longer_heads_bt_32_r310_m277_1370M,1,easy_bots,5_vs_5
1419,2,2,m_sp_arch_longer_heads_bt_32_r310_m277_1370M,0,easy_bots,5_vs_5
1420,-2,2,m_sp_arch_longer_heads_bt_32_r310_m277_1370M,4,medium_bots,5_vs_5_medium
1421,-1,0,m_sp_arch_longer_heads_bt_32_r310_m277_1370M,1,medium_bots,5_vs_5_medium
1422,-1,1,m_sp_arch_longer_heads_bt_32_r310_m277_1370M,2,medium_bots,5_vs_5_medium
1423,0,0,m_sp_arch_longer_heads_bt_32_r310_m277_1370M,0,medium_bots,5_vs_5_medium
1424,0,2,m_sp_arch_longer_heads_bt_32_r310_m277_1370M,2,medium_bots,5_vs_5_medium
1425,-1,1,m_sp_arch_longer_heads_bt_32_r310_m277_1370M,2,medium_bots,5_vs_5_medium
1426,2,3,m_sp_arch_longer_heads_bt_32_r310_m277_1370M,1,medium_bots,5_vs_5_medium
1427,-2,1,m_sp_arch_longer_heads_bt_32_r310_m277_1370M,3,medium_bots,5_vs_5_medium
1428,1,1,m_sp_arch_longer_heads_bt_32_r310_m277_1370M,0,medium_bots,5_vs_5_medium
1429,-3,0,m_sp_arch_longer_heads_bt_32_r310_m277_1370M,3,medium_bots,5_vs_5_medium
1430,2,3,m_sp_arch_longer_heads_bt_32_r310_m277_1370M,1,medium_bots,5_vs_5_medium
1431,0,1,m_sp_arch_longer_heads_bt_32_r310_m277_1370M,1,medium_bots,5_vs_5_medium
1432,-1,0,m_sp_arch_longer_heads_bt_32_r310_m277_1370M,1,medium_bots,5_vs_5_medium
1433,-1,1,m_sp_arch_longer_heads_bt_32_r310_m277_1370M,2,medium_bots,5_vs_5_medium
1434,-2,1,m_sp_arch_longer_heads_bt_32_r310_m277_1370M,3,medium_bots,5_vs_5_medium
1435,-1,0,m_sp_arch_longer_heads_bt_32_r310_m277_1370M,1,medium_bots,5_vs_5_medium
1436,1,2,m_sp_arch_longer_heads_bt_32_r310_m277_1370M,1,medium_bots,5_vs_5_medium
1437,1,3,m_sp_arch_longer_heads_bt_32_r310_m277_1370M,2,medium_bots,5_vs_5_medium
1438,0,2,m_sp_arch_longer_heads_bt_32_r310_m277_1370M,2,medium_bots,5_vs_5_medium
1439,0,2,m_sp_arch_longer_heads_bt_32_r310_m277_1370M,2,medium_bots,5_vs_5_medium
1440,-2,1,m_sp_arch_longer_heads_bt_32_r310_m277_1370M,3,hard_bots,5_vs_5_hard
1441,-2,0,m_sp_arch_longer_heads_bt_32_r310_m277_1370M,2,hard_bots,5_vs_5_hard
1442,-1,1,m_sp_arch_longer_heads_bt_32_r310_m277_1370M,2,hard_bots,5_vs_5_hard
1443,-1,1,m_sp_arch_longer_heads_bt_32_r310_m277_1370M,2,hard_bots,5_vs_5_hard
1444,-1,1,m_sp_arch_longer_heads_bt_32_r310_m277_1370M,2,hard_bots,5_vs_5_hard
1445,-1,0,m_sp_arch_longer_heads_bt_32_r310_m277_1370M,1,hard_bots,5_vs_5_hard
1446,0,1,m_sp_arch_longer_heads_bt_32_r310_m277_1370M,1,hard_bots,5_vs_5_hard
1447,-2,0,m_sp_arch_longer_heads_bt_32_r310_m277_1370M,2,hard_bots,5_vs_5_hard
1448,-1,1,m_sp_arch_longer_heads_bt_32_r310_m277_1370M,2,hard_bots,5_vs_5_hard
1449,-2,1,m_sp_arch_longer_heads_bt_32_r310_m277_1370M,3,hard_bots,5_vs_5_hard
1450,-4,1,m_sp_arch_longer_heads_bt_32_r310_m277_1370M,5,hard_bots,5_vs_5_hard
1451,-1,1,m_sp_arch_longer_heads_bt_32_r310_m277_1370M,2,hard_bots,5_vs_5_hard
1452,-2,1,m_sp_arch_longer_heads_bt_32_r310_m277_1370M,3,hard_bots,5_vs_5_hard
1453,-2,0,m_sp_arch_longer_heads_bt_32_r310_m277_1370M,2,hard_bots,5_vs_5_hard
1454,-2,0,m_sp_arch_longer_heads_bt_32_r310_m277_1370M,2,hard_bots,5_vs_5_hard
1455,-1,0,m_sp_arch_longer_heads_bt_32_r310_m277_1370M,1,hard_bots,5_vs_5_hard
1456,-3,0,m_sp_arch_longer_heads_bt_32_r310_m277_1370M,3,hard_bots,5_vs_5_hard
1457,-4,1,m_sp_arch_longer_heads_bt_32_r310_m277_1370M,5,hard_bots,5_vs_5_hard
1458,-2,2,m_sp_arch_longer_heads_bt_32_r310_m277_1370M,4,hard_bots,5_vs_5_hard
1459,-1,2,m_sp_arch_longer_heads_bt_32_r310_m277_1370M,3,hard_bots,5_vs_5_hard
1460,3,5,m_sp_arch_longer_heads_bt_32_r310_m277_1370M,2,f5v0to1to2t05_e2_ckpt291,5_vs_5
1461,4,4,m_sp_arch_longer_heads_bt_32_r310_m277_1370M,0,f5v0to1to2t05_e2_ckpt291,5_vs_5
1462,4,6,m_sp_arch_longer_heads_bt_32_r310_m277_1370M,2,f5v0to1to2t05_e2_ckpt291,5_vs_5
1463,3,4,m_sp_arch_longer_heads_bt_32_r310_m277_1370M,1,f5v0to1to2t05_e2_ckpt291,5_vs_5
1464,8,11,m_sp_arch_longer_heads_bt_32_r310_m277_1370M,3,f5v0to1to2t05_e2_ckpt291,5_vs_5
1465,3,5,m_sp_arch_longer_heads_bt_32_r310_m277_1370M,2,f5v0to1to2t05_e2_ckpt291,5_vs_5
1466,3,5,m_sp_arch_longer_heads_bt_32_r310_m277_1370M,2,f5v0to1to2t05_e2_ckpt291,5_vs_5
1467,3,3,m_sp_arch_longer_heads_bt_32_r310_m277_1370M,0,f5v0to1to2t05_e2_ckpt291,5_vs_5
1468,6,8,m_sp_arch_longer_heads_bt_32_r310_m277_1370M,2,f5v0to1to2t05_e2_ckpt291,5_vs_5
1469,3,5,m_sp_arch_longer_heads_bt_32_r310_m277_1370M,2,f5v0to1to2t05_e2_ckpt291,5_vs_5
1470,5,6,m_sp_arch_longer_heads_bt_32_r310_m277_1370M,1,f5v0to1to2t05_e2_ckpt291,5_vs_5
1471,2,3,m_sp_arch_longer_heads_bt_32_r310_m277_1370M,1,f5v0to1to2t05_e2_ckpt291,5_vs_5
1472,6,6,m_sp_arch_longer_heads_bt_32_r310_m277_1370M,0,f5v0to1to2t05_e2_ckpt291,5_vs_5
1473,6,6,m_sp_arch_longer_heads_bt_32_r310_m277_1370M,0,f5v0to1to2t05_e2_ckpt291,5_vs_5
1474,5,6,m_sp_arch_longer_heads_bt_32_r310_m277_1370M,1,f5v0to1to2t05_e2_ckpt291,5_vs_5
1475,4,4,m_sp_arch_longer_heads_bt_32_r310_m277_1370M,0,f5v0to1to2t05_e2_ckpt291,5_vs_5
1476,3,5,m_sp_arch_longer_heads_bt_32_r310_m277_1370M,2,f5v0to1to2t05_e2_ckpt291,5_vs_5
1477,6,6,m_sp_arch_longer_heads_bt_32_r310_m277_1370M,0,f5v0to1to2t05_e2_ckpt291,5_vs_5
1478,1,4,m_sp_arch_longer_heads_bt_32_r310_m277_1370M,3,f5v0to1to2t05_e2_ckpt291,5_vs_5
1479,7,8,m_sp_arch_longer_heads_bt_32_r310_m277_1370M,1,f5v0to1to2t05_e2_ckpt291,5_vs_5
1480,2,5,m_sp_arch_longer_heads_bt_32_r310_m277_1370M,3,f5v0to1to5_e2_ckpt252,5_vs_5
1481,2,5,m_sp_arch_longer_heads_bt_32_r310_m277_1370M,3,f5v0to1to5_e2_ckpt252,5_vs_5
1482,4,4,m_sp_arch_longer_heads_bt_32_r310_m277_1370M,0,f5v0to1to5_e2_ckpt252,5_vs_5
1483,8,8,m_sp_arch_longer_heads_bt_32_r310_m277_1370M,0,f5v0to1to5_e2_ckpt252,5_vs_5
1484,4,4,m_sp_arch_longer_heads_bt_32_r310_m277_1370M,0,f5v0to1to5_e2_ckpt252,5_vs_5
1485,5,7,m_sp_arch_longer_heads_bt_32_r310_m277_1370M,2,f5v0to1to5_e2_ckpt252,5_vs_5
1486,2,5,m_sp_arch_longer_heads_bt_32_r310_m277_1370M,3,f5v0to1to5_e2_ckpt252,5_vs_5
1487,5,7,m_sp_arch_longer_heads_bt_32_r310_m277_1370M,2,f5v0to1to5_e2_ckpt252,5_vs_5
1488,2,4,m_sp_arch_longer_heads_bt_32_r310_m277_1370M,2,f5v0to1to5_e2_ckpt252,5_vs_5
1489,7,7,m_sp_arch_longer_heads_bt_32_r310_m277_1370M,0,f5v0to1to5_e2_ckpt252,5_vs_5
1490,0,0,m_sp_arch_longer_heads_bt_32_r310_m277_1370M,0,f5v0to1to5_e2_ckpt252,5_vs_5
1491,6,7,m_sp_arch_longer_heads_bt_32_r310_m277_1370M,1,f5v0to1to5_e2_ckpt252,5_vs_5
1492,3,6,m_sp_arch_longer_heads_bt_32_r310_m277_1370M,3,f5v0to1to5_e2_ckpt252,5_vs_5
1493,3,4,m_sp_arch_longer_heads_bt_32_r310_m277_1370M,1,f5v0to1to5_e2_ckpt252,5_vs_5
1494,3,5,m_sp_arch_longer_heads_bt_32_r310_m277_1370M,2,f5v0to1to5_e2_ckpt252,5_vs_5
1495,5,6,m_sp_arch_longer_heads_bt_32_r310_m277_1370M,1,f5v0to1to5_e2_ckpt252,5_vs_5
1496,4,5,m_sp_arch_longer_heads_bt_32_r310_m277_1370M,1,f5v0to1to5_e2_ckpt252,5_vs_5
1497,2,5,m_sp_arch_longer_heads_bt_32_r310_m277_1370M,3,f5v0to1to5_e2_ckpt252,5_vs_5
1498,-1,3,m_sp_arch_longer_heads_bt_32_r310_m277_1370M,4,f5v0to1to5_e2_ckpt252,5_vs_5
1499,1,4,m_sp_arch_longer_heads_bt_32_r310_m277_1370M,3,f5v0to1to5_e2_ckpt252,5_vs_5
1500,8,8,m_sp_arch_longer_heads_bt_32_r310_m277_1370M,0,scon_e3_p2_hard_ckpt840,5_vs_5
1501,6,7,m_sp_arch_longer_heads_bt_32_r310_m277_1370M,1,scon_e3_p2_hard_ckpt840,5_vs_5
1502,5,6,m_sp_arch_longer_heads_bt_32_r310_m277_1370M,1,scon_e3_p2_hard_ckpt840,5_vs_5
1503,5,5,m_sp_arch_longer_heads_bt_32_r310_m277_1370M,0,scon_e3_p2_hard_ckpt840,5_vs_5
1504,7,8,m_sp_arch_longer_heads_bt_32_r310_m277_1370M,1,scon_e3_p2_hard_ckpt840,5_vs_5
1505,1,1,m_sp_arch_longer_heads_bt_32_r310_m277_1370M,0,scon_e3_p2_hard_ckpt840,5_vs_5
1506,11,11,m_sp_arch_longer_heads_bt_32_r310_m277_1370M,0,scon_e3_p2_hard_ckpt840,5_vs_5
1507,2,4,m_sp_arch_longer_heads_bt_32_r310_m277_1370M,2,scon_e3_p2_hard_ckpt840,5_vs_5
1508,7,7,m_sp_arch_longer_heads_bt_32_r310_m277_1370M,0,scon_e3_p2_hard_ckpt840,5_vs_5
1509,7,8,m_sp_arch_longer_heads_bt_32_r310_m277_1370M,1,scon_e3_p2_hard_ckpt840,5_vs_5
1510,6,7,m_sp_arch_longer_heads_bt_32_r310_m277_1370M,1,scon_e3_p2_hard_ckpt840,5_vs_5
1511,3,3,m_sp_arch_longer_heads_bt_32_r310_m277_1370M,0,scon_e3_p2_hard_ckpt840,5_vs_5
1512,4,7,m_sp_arch_longer_heads_bt_32_r310_m277_1370M,3,scon_e3_p2_hard_ckpt840,5_vs_5
1513,6,8,m_sp_arch_longer_heads_bt_32_r310_m277_1370M,2,scon_e3_p2_hard_ckpt840,5_vs_5
1514,5,5,m_sp_arch_longer_heads_bt_32_r310_m277_1370M,0,scon_e3_p2_hard_ckpt840,5_vs_5
1515,4,4,m_sp_arch_longer_heads_bt_32_r310_m277_1370M,0,scon_e3_p2_hard_ckpt840,5_vs_5
1516,8,9,m_sp_arch_longer_heads_bt_32_r310_m277_1370M,1,scon_e3_p2_hard_ckpt840,5_vs_5
1517,9,9,m_sp_arch_longer_heads_bt_32_r310_m277_1370M,0,scon_e3_p2_hard_ckpt840,5_vs_5
1518,5,6,m_sp_arch_longer_heads_bt_32_r310_m277_1370M,1,scon_e3_p2_hard_ckpt840,5_vs_5
1519,5,8,m_sp_arch_longer_heads_bt_32_r310_m277_1370M,3,scon_e3_p2_hard_ckpt840,5_vs_5
1520,6,7,m_sp_arch_longer_heads_bt_32_r310_m277_1370M,1,less_then_partially_randomized_checkpoints_bots_4_heads_38_ckpt108,5_vs_5
1521,5,6,m_sp_arch_longer_heads_bt_32_r310_m277_1370M,1,less_then_partially_randomized_checkpoints_bots_4_heads_38_ckpt108,5_vs_5
1522,11,11,m_sp_arch_longer_heads_bt_32_r310_m277_1370M,0,less_then_partially_randomized_checkpoints_bots_4_heads_38_ckpt108,5_vs_5
1523,5,7,m_sp_arch_longer_heads_bt_32_r310_m277_1370M,2,less_then_partially_randomized_checkpoints_bots_4_heads_38_ckpt108,5_vs_5
1524,4,5,m_sp_arch_longer_heads_bt_32_r310_m277_1370M,1,less_then_partially_randomized_checkpoints_bots_4_heads_38_ckpt108,5_vs_5
1525,7,10,m_sp_arch_longer_heads_bt_32_r310_m277_1370M,3,less_then_partially_randomized_checkpoints_bots_4_heads_38_ckpt108,5_vs_5
1526,9,9,m_sp_arch_longer_heads_bt_32_r310_m277_1370M,0,less_then_partially_randomized_checkpoints_bots_4_heads_38_ckpt108,5_vs_5
1527,8,9,m_sp_arch_longer_heads_bt_32_r310_m277_1370M,1,less_then_partially_randomized_checkpoints_bots_4_heads_38_ckpt108,5_vs_5
1528,4,6,m_sp_arch_longer_heads_bt_32_r310_m277_1370M,2,less_then_partially_randomized_checkpoints_bots_4_heads_38_ckpt108,5_vs_5
1529,2,2,m_sp_arch_longer_heads_bt_32_r310_m277_1370M,0,less_then_partially_randomized_checkpoints_bots_4_heads_38_ckpt108,5_vs_5
1530,4,6,m_sp_arch_longer_heads_bt_32_r310_m277_1370M,2,less_then_partially_randomized_checkpoints_bots_4_heads_38_ckpt108,5_vs_5
1531,6,7,m_sp_arch_longer_heads_bt_32_r310_m277_1370M,1,less_then_partially_randomized_checkpoints_bots_4_heads_38_ckpt108,5_vs_5
1532,8,9,m_sp_arch_longer_heads_bt_32_r310_m277_1370M,1,less_then_partially_randomized_checkpoints_bots_4_heads_38_ckpt108,5_vs_5
1533,10,10,m_sp_arch_longer_heads_bt_32_r310_m277_1370M,0,less_then_partially_randomized_checkpoints_bots_4_heads_38_ckpt108,5_vs_5
1534,4,4,m_sp_arch_longer_heads_bt_32_r310_m277_1370M,0,less_then_partially_randomized_checkpoints_bots_4_heads_38_ckpt108,5_vs_5
1535,1,4,m_sp_arch_longer_heads_bt_32_r310_m277_1370M,3,less_then_partially_randomized_checkpoints_bots_4_heads_38_ckpt108,5_vs_5
1536,4,4,m_sp_arch_longer_heads_bt_32_r310_m277_1370M,0,less_then_partially_randomized_checkpoints_bots_4_heads_38_ckpt108,5_vs_5
1537,4,4,m_sp_arch_longer_heads_bt_32_r310_m277_1370M,0,less_then_partially_randomized_checkpoints_bots_4_heads_38_ckpt108,5_vs_5
1538,5,8,m_sp_arch_longer_heads_bt_32_r310_m277_1370M,3,less_then_partially_randomized_checkpoints_bots_4_heads_38_ckpt108,5_vs_5
1539,6,8,m_sp_arch_longer_heads_bt_32_r310_m277_1370M,2,less_then_partially_randomized_checkpoints_bots_4_heads_38_ckpt108,5_vs_5
1540,10,10,m_sp_arch_longer_heads_bt_32_r310_m277_1370M,0,less_then_partially_randomized_entropy_checkpoints_bots_4_heads_39_ckpt109,5_vs_5
1541,6,7,m_sp_arch_longer_heads_bt_32_r310_m277_1370M,1,less_then_partially_randomized_entropy_checkpoints_bots_4_heads_39_ckpt109,5_vs_5
1542,6,7,m_sp_arch_longer_heads_bt_32_r310_m277_1370M,1,less_then_partially_randomized_entropy_checkpoints_bots_4_heads_39_ckpt109,5_vs_5
1543,4,5,m_sp_arch_longer_heads_bt_32_r310_m277_1370M,1,less_then_partially_randomized_entropy_checkpoints_bots_4_heads_39_ckpt109,5_vs_5
1544,5,8,m_sp_arch_longer_heads_bt_32_r310_m277_1370M,3,less_then_partially_randomized_entropy_checkpoints_bots_4_heads_39_ckpt109,5_vs_5
1545,6,6,m_sp_arch_longer_heads_bt_32_r310_m277_1370M,0,less_then_partially_randomized_entropy_checkpoints_bots_4_heads_39_ckpt109,5_vs_5
1546,6,7,m_sp_arch_longer_heads_bt_32_r310_m277_1370M,1,less_then_partially_randomized_entropy_checkpoints_bots_4_heads_39_ckpt109,5_vs_5
1547,6,6,m_sp_arch_longer_heads_bt_32_r310_m277_1370M,0,less_then_partially_randomized_entropy_checkpoints_bots_4_heads_39_ckpt109,5_vs_5
1548,0,1,m_sp_arch_longer_heads_bt_32_r310_m277_1370M,1,less_then_partially_randomized_entropy_checkpoints_bots_4_heads_39_ckpt109,5_vs_5
1549,5,6,m_sp_arch_longer_heads_bt_32_r310_m277_1370M,1,less_then_partially_randomized_entropy_checkpoints_bots_4_heads_39_ckpt109,5_vs_5
1550,8,9,m_sp_arch_longer_heads_bt_32_r310_m277_1370M,1,less_then_partially_randomized_entropy_checkpoints_bots_4_heads_39_ckpt109,5_vs_5
1551,7,7,m_sp_arch_longer_heads_bt_32_r310_m277_1370M,0,less_then_partially_randomized_entropy_checkpoints_bots_4_heads_39_ckpt109,5_vs_5
1552,5,5,m_sp_arch_longer_heads_bt_32_r310_m277_1370M,0,less_then_partially_randomized_entropy_checkpoints_bots_4_heads_39_ckpt109,5_vs_5
1553,10,11,m_sp_arch_longer_heads_bt_32_r310_m277_1370M,1,less_then_partially_randomized_entropy_checkpoints_bots_4_heads_39_ckpt109,5_vs_5
1554,6,6,m_sp_arch_longer_heads_bt_32_r310_m277_1370M,0,less_then_partially_randomized_entropy_checkpoints_bots_4_heads_39_ckpt109,5_vs_5
1555,5,5,m_sp_arch_longer_heads_bt_32_r310_m277_1370M,0,less_then_partially_randomized_entropy_checkpoints_bots_4_heads_39_ckpt109,5_vs_5
1556,2,2,m_sp_arch_longer_heads_bt_32_r310_m277_1370M,0,less_then_partially_randomized_entropy_checkpoints_bots_4_heads_39_ckpt109,5_vs_5
1557,4,4,m_sp_arch_longer_heads_bt_32_r310_m277_1370M,0,less_then_partially_randomized_entropy_checkpoints_bots_4_heads_39_ckpt109,5_vs_5
1558,4,5,m_sp_arch_longer_heads_bt_32_r310_m277_1370M,1,less_then_partially_randomized_entropy_checkpoints_bots_4_heads_39_ckpt109,5_vs_5
1559,5,6,m_sp_arch_longer_heads_bt_32_r310_m277_1370M,1,less_then_partially_randomized_entropy_checkpoints_bots_4_heads_39_ckpt109,5_vs_5
1560,9,9,m_sp_arch_longer_heads_bt_32_r310_m277_1370M,0,reward_shaping_checkpoints_bots_4_heads_1_ckpt360,5_vs_5
1561,3,5,m_sp_arch_longer_heads_bt_32_r310_m277_1370M,2,reward_shaping_checkpoints_bots_4_heads_1_ckpt360,5_vs_5
1562,6,7,m_sp_arch_longer_heads_bt_32_r310_m277_1370M,1,reward_shaping_checkpoints_bots_4_heads_1_ckpt360,5_vs_5
1563,9,10,m_sp_arch_longer_heads_bt_32_r310_m277_1370M,1,reward_shaping_checkpoints_bots_4_heads_1_ckpt360,5_vs_5
1564,6,7,m_sp_arch_longer_heads_bt_32_r310_m277_1370M,1,reward_shaping_checkpoints_bots_4_heads_1_ckpt360,5_vs_5
1565,8,8,m_sp_arch_longer_heads_bt_32_r310_m277_1370M,0,reward_shaping_checkpoints_bots_4_heads_1_ckpt360,5_vs_5
1566,4,4,m_sp_arch_longer_heads_bt_32_r310_m277_1370M,0,reward_shaping_checkpoints_bots_4_heads_1_ckpt360,5_vs_5
1567,6,6,m_sp_arch_longer_heads_bt_32_r310_m277_1370M,0,reward_shaping_checkpoints_bots_4_heads_1_ckpt360,5_vs_5
1568,4,4,m_sp_arch_longer_heads_bt_32_r310_m277_1370M,0,reward_shaping_checkpoints_bots_4_heads_1_ckpt360,5_vs_5
1569,7,7,m_sp_arch_longer_heads_bt_32_r310_m277_1370M,0,reward_shaping_checkpoints_bots_4_heads_1_ckpt360,5_vs_5
1570,6,9,m_sp_arch_longer_heads_bt_32_r310_m277_1370M,3,reward_shaping_checkpoints_bots_4_heads_1_ckpt360,5_vs_5
1571,0,0,m_sp_arch_longer_heads_bt_32_r310_m277_1370M,0,reward_shaping_checkpoints_bots_4_heads_1_ckpt360,5_vs_5
1572,10,11,m_sp_arch_longer_heads_bt_32_r310_m277_1370M,1,reward_shaping_checkpoints_bots_4_heads_1_ckpt360,5_vs_5
1573,3,3,m_sp_arch_longer_heads_bt_32_r310_m277_1370M,0,reward_shaping_checkpoints_bots_4_heads_1_ckpt360,5_vs_5
1574,9,9,m_sp_arch_longer_heads_bt_32_r310_m277_1370M,0,reward_shaping_checkpoints_bots_4_heads_1_ckpt360,5_vs_5
1575,5,8,m_sp_arch_longer_heads_bt_32_r310_m277_1370M,3,reward_shaping_checkpoints_bots_4_heads_1_ckpt360,5_vs_5
1576,6,6,m_sp_arch_longer_heads_bt_32_r310_m277_1370M,0,reward_shaping_checkpoints_bots_4_heads_1_ckpt360,5_vs_5
1577,7,7,m_sp_arch_longer_heads_bt_32_r310_m277_1370M,0,reward_shaping_checkpoints_bots_4_heads_1_ckpt360,5_vs_5
1578,4,7,m_sp_arch_longer_heads_bt_32_r310_m277_1370M,3,reward_shaping_checkpoints_bots_4_heads_1_ckpt360,5_vs_5
1579,6,6,m_sp_arch_longer_heads_bt_32_r310_m277_1370M,0,reward_shaping_checkpoints_bots_4_heads_1_ckpt360,5_vs_5
1580,1,4,m_sp_arch_longer_heads_bt_32_r310_m277_1370M,3,checkpoints_selfplay_e9_sp_ckpt274,5_vs_5
1581,-2,2,m_sp_arch_longer_heads_bt_32_r310_m277_1370M,4,checkpoints_selfplay_e9_sp_ckpt274,5_vs_5
1582,0,4,m_sp_arch_longer_heads_bt_32_r310_m277_1370M,4,checkpoints_selfplay_e9_sp_ckpt274,5_vs_5
1583,-1,1,m_sp_arch_longer_heads_bt_32_r310_m277_1370M,2,checkpoints_selfplay_e9_sp_ckpt274,5_vs_5
1584,1,5,m_sp_arch_longer_heads_bt_32_r310_m277_1370M,4,checkpoints_selfplay_e9_sp_ckpt274,5_vs_5
1585,-1,3,m_sp_arch_longer_heads_bt_32_r310_m277_1370M,4,checkpoints_selfplay_e9_sp_ckpt274,5_vs_5
1586,0,3,m_sp_arch_longer_heads_bt_32_r310_m277_1370M,3,checkpoints_selfplay_e9_sp_ckpt274,5_vs_5
1587,1,2,m_sp_arch_longer_heads_bt_32_r310_m277_1370M,1,checkpoints_selfplay_e9_sp_ckpt274,5_vs_5
1588,3,3,m_sp_arch_longer_heads_bt_32_r310_m277_1370M,0,checkpoints_selfplay_e9_sp_ckpt274,5_vs_5
1589,-2,4,m_sp_arch_longer_heads_bt_32_r310_m277_1370M,6,checkpoints_selfplay_e9_sp_ckpt274,5_vs_5
1590,-3,3,m_sp_arch_longer_heads_bt_32_r310_m277_1370M,6,checkpoints_selfplay_e9_sp_ckpt274,5_vs_5
1591,-2,5,m_sp_arch_longer_heads_bt_32_r310_m277_1370M,7,checkpoints_selfplay_e9_sp_ckpt274,5_vs_5
1592,-3,1,m_sp_arch_longer_heads_bt_32_r310_m277_1370M,4,checkpoints_selfplay_e9_sp_ckpt274,5_vs_5
1593,1,4,m_sp_arch_longer_heads_bt_32_r310_m277_1370M,3,checkpoints_selfplay_e9_sp_ckpt274,5_vs_5
1594,-6,1,m_sp_arch_longer_heads_bt_32_r310_m277_1370M,7,checkpoints_selfplay_e9_sp_ckpt274,5_vs_5
1595,-1,2,m_sp_arch_longer_heads_bt_32_r310_m277_1370M,3,checkpoints_selfplay_e9_sp_ckpt274,5_vs_5
1596,2,3,m_sp_arch_longer_heads_bt_32_r310_m277_1370M,1,checkpoints_selfplay_e9_sp_ckpt274,5_vs_5
1597,-3,3,m_sp_arch_longer_heads_bt_32_r310_m277_1370M,6,checkpoints_selfplay_e9_sp_ckpt274,5_vs_5
1598,0,0,m_sp_arch_longer_heads_bt_32_r310_m277_1370M,0,checkpoints_selfplay_e9_sp_ckpt274,5_vs_5
1599,-4,3,m_sp_arch_longer_heads_bt_32_r310_m277_1370M,7,checkpoints_selfplay_e9_sp_ckpt274,5_vs_5
1600,-1,1,m_sp_arch_longer_heads_bt_32_r310_m277_1370M,2,checkpoints_selfplay_e9_sp_ckpt335_1370M,5_vs_5
1601,1,3,m_sp_arch_longer_heads_bt_32_r310_m277_1370M,2,checkpoints_selfplay_e9_sp_ckpt335_1370M,5_vs_5
1602,-1,3,m_sp_arch_longer_heads_bt_32_r310_m277_1370M,4,checkpoints_selfplay_e9_sp_ckpt335_1370M,5_vs_5
1603,-1,3,m_sp_arch_longer_heads_bt_32_r310_m277_1370M,4,checkpoints_selfplay_e9_sp_ckpt335_1370M,5_vs_5
1604,-1,2,m_sp_arch_longer_heads_bt_32_r310_m277_1370M,3,checkpoints_selfplay_e9_sp_ckpt335_1370M,5_vs_5
1605,-2,2,m_sp_arch_longer_heads_bt_32_r310_m277_1370M,4,checkpoints_selfplay_e9_sp_ckpt335_1370M,5_vs_5
1606,-1,3,m_sp_arch_longer_heads_bt_32_r310_m277_1370M,4,checkpoints_selfplay_e9_sp_ckpt335_1370M,5_vs_5
1607,-2,4,m_sp_arch_longer_heads_bt_32_r310_m277_1370M,6,checkpoints_selfplay_e9_sp_ckpt335_1370M,5_vs_5
1608,-5,0,m_sp_arch_longer_heads_bt_32_r310_m277_1370M,5,checkpoints_selfplay_e9_sp_ckpt335_1370M,5_vs_5
1609,-2,1,m_sp_arch_longer_heads_bt_32_r310_m277_1370M,3,checkpoints_selfplay_e9_sp_ckpt335_1370M,5_vs_5
1610,0,1,m_sp_arch_longer_heads_bt_32_r310_m277_1370M,1,checkpoints_selfplay_e9_sp_ckpt335_1370M,5_vs_5
1611,-2,3,m_sp_arch_longer_heads_bt_32_r310_m277_1370M,5,checkpoints_selfplay_e9_sp_ckpt335_1370M,5_vs_5
1612,1,6,m_sp_arch_longer_heads_bt_32_r310_m277_1370M,5,checkpoints_selfplay_e9_sp_ckpt335_1370M,5_vs_5
1613,-4,3,m_sp_arch_longer_heads_bt_32_r310_m277_1370M,7,checkpoints_selfplay_e9_sp_ckpt335_1370M,5_vs_5
1614,-2,2,m_sp_arch_longer_heads_bt_32_r310_m277_1370M,4,checkpoints_selfplay_e9_sp_ckpt335_1370M,5_vs_5
1615,-1,4,m_sp_arch_longer_heads_bt_32_r310_m277_1370M,5,checkpoints_selfplay_e9_sp_ckpt335_1370M,5_vs_5
1616,1,3,m_sp_arch_longer_heads_bt_32_r310_m277_1370M,2,checkpoints_selfplay_e9_sp_ckpt335_1370M,5_vs_5
1617,-2,3,m_sp_arch_longer_heads_bt_32_r310_m277_1370M,5,checkpoints_selfplay_e9_sp_ckpt335_1370M,5_vs_5
1618,-6,1,m_sp_arch_longer_heads_bt_32_r310_m277_1370M,7,checkpoints_selfplay_e9_sp_ckpt335_1370M,5_vs_5
1619,-2,1,m_sp_arch_longer_heads_bt_32_r310_m277_1370M,3,checkpoints_selfplay_e9_sp_ckpt335_1370M,5_vs_5
1620,-3,2,m_sp_arch_longer_heads_bt_32_r310_m277_1370M,5,checkpoints_sp_c_nb_e2_ckpt667,5_vs_5
1621,-5,1,m_sp_arch_longer_heads_bt_32_r310_m277_1370M,6,checkpoints_sp_c_nb_e2_ckpt667,5_vs_5
1622,-4,1,m_sp_arch_longer_heads_bt_32_r310_m277_1370M,5,checkpoints_sp_c_nb_e2_ckpt667,5_vs_5
1623,-1,1,m_sp_arch_longer_heads_bt_32_r310_m277_1370M,2,checkpoints_sp_c_nb_e2_ckpt667,5_vs_5
1624,-3,1,m_sp_arch_longer_heads_bt_32_r310_m277_1370M,4,checkpoints_sp_c_nb_e2_ckpt667,5_vs_5
1625,-3,0,m_sp_arch_longer_heads_bt_32_r310_m277_1370M,3,checkpoints_sp_c_nb_e2_ckpt667,5_vs_5
1626,-3,1,m_sp_arch_longer_heads_bt_32_r310_m277_1370M,4,checkpoints_sp_c_nb_e2_ckpt667,5_vs_5
1627,-4,1,m_sp_arch_longer_heads_bt_32_r310_m277_1370M,5,checkpoints_sp_c_nb_e2_ckpt667,5_vs_5
1628,-2,0,m_sp_arch_longer_heads_bt_32_r310_m277_1370M,2,checkpoints_sp_c_nb_e2_ckpt667,5_vs_5
1629,-1,2,m_sp_arch_longer_heads_bt_32_r310_m277_1370M,3,checkpoints_sp_c_nb_e2_ckpt667,5_vs_5
1630,-2,2,m_sp_arch_longer_heads_bt_32_r310_m277_1370M,4,checkpoints_sp_c_nb_e2_ckpt667,5_vs_5
1631,1,3,m_sp_arch_longer_heads_bt_32_r310_m277_1370M,2,checkpoints_sp_c_nb_e2_ckpt667,5_vs_5
1632,-3,2,m_sp_arch_longer_heads_bt_32_r310_m277_1370M,5,checkpoints_sp_c_nb_e2_ckpt667,5_vs_5
1633,-6,0,m_sp_arch_longer_heads_bt_32_r310_m277_1370M,6,checkpoints_sp_c_nb_e2_ckpt667,5_vs_5
1634,-1,1,m_sp_arch_longer_heads_bt_32_r310_m277_1370M,2,checkpoints_sp_c_nb_e2_ckpt667,5_vs_5
1635,-1,2,m_sp_arch_longer_heads_bt_32_r310_m277_1370M,3,checkpoints_sp_c_nb_e2_ckpt667,5_vs_5
1636,0,3,m_sp_arch_longer_heads_bt_32_r310_m277_1370M,3,checkpoints_sp_c_nb_e2_ckpt667,5_vs_5
1637,1,2,m_sp_arch_longer_heads_bt_32_r310_m277_1370M,1,checkpoints_sp_c_nb_e2_ckpt667,5_vs_5
1638,-3,2,m_sp_arch_longer_heads_bt_32_r310_m277_1370M,5,checkpoints_sp_c_nb_e2_ckpt667,5_vs_5
1639,0,1,m_sp_arch_longer_heads_bt_32_r310_m277_1370M,1,checkpoints_sp_c_nb_e2_ckpt667,5_vs_5
1640,8,8,m_sp_arch_longer_heads_bt_32_r310_m277_1370M,0,scenario_curriculum_ckpt830,5_vs_5
1641,0,0,m_sp_arch_longer_heads_bt_32_r310_m277_1370M,0,scenario_curriculum_ckpt830,5_vs_5
1642,4,4,m_sp_arch_longer_heads_bt_32_r310_m277_1370M,0,scenario_curriculum_ckpt830,5_vs_5
1643,0,0,m_sp_arch_longer_heads_bt_32_r310_m277_1370M,0,scenario_curriculum_ckpt830,5_vs_5
1644,1,1,m_sp_arch_longer_heads_bt_32_r310_m277_1370M,0,scenario_curriculum_ckpt830,5_vs_5
1645,0,0,m_sp_arch_longer_heads_bt_32_r310_m277_1370M,0,scenario_curriculum_ckpt830,5_vs_5
1646,1,1,m_sp_arch_longer_heads_bt_32_r310_m277_1370M,0,scenario_curriculum_ckpt830,5_vs_5
1647,9,9,m_sp_arch_longer_heads_bt_32_r310_m277_1370M,0,scenario_curriculum_ckpt830,5_vs_5
1648,3,3,m_sp_arch_longer_heads_bt_32_r310_m277_1370M,0,scenario_curriculum_ckpt830,5_vs_5
1649,3,3,m_sp_arch_longer_heads_bt_32_r310_m277_1370M,0,scenario_curriculum_ckpt830,5_vs_5
1650,1,1,m_sp_arch_longer_heads_bt_32_r310_m277_1370M,0,scenario_curriculum_ckpt830,5_vs_5
1651,2,2,m_sp_arch_longer_heads_bt_32_r310_m277_1370M,0,scenario_curriculum_ckpt830,5_vs_5
1652,1,1,m_sp_arch_longer_heads_bt_32_r310_m277_1370M,0,scenario_curriculum_ckpt830,5_vs_5
1653,7,7,m_sp_arch_longer_heads_bt_32_r310_m277_1370M,0,scenario_curriculum_ckpt830,5_vs_5
1654,3,3,m_sp_arch_longer_heads_bt_32_r310_m277_1370M,0,scenario_curriculum_ckpt830,5_vs_5
1655,1,1,m_sp_arch_longer_heads_bt_32_r310_m277_1370M,0,scenario_curriculum_ckpt830,5_vs_5
1656,2,2,m_sp_arch_longer_heads_bt_32_r310_m277_1370M,0,scenario_curriculum_ckpt830,5_vs_5
1657,7,7,m_sp_arch_longer_heads_bt_32_r310_m277_1370M,0,scenario_curriculum_ckpt830,5_vs_5
1658,2,2,m_sp_arch_longer_heads_bt_32_r310_m277_1370M,0,scenario_curriculum_ckpt830,5_vs_5
1659,4,4,m_sp_arch_longer_heads_bt_32_r310_m277_1370M,0,scenario_curriculum_ckpt830,5_vs_5
1660,-1,2,m_sp_arch_longer_heads_bt_32_r310_m277_1370M,3,m_sp_arch_medium_heads_conv16_0_bt_32_r313_m335,5_vs_5
1661,-1,1,m_sp_arch_longer_heads_bt_32_r310_m277_1370M,2,m_sp_arch_medium_heads_conv16_0_bt_32_r313_m335,5_vs_5
1662,2,3,m_sp_arch_longer_heads_bt_32_r310_m277_1370M,1,m_sp_arch_medium_heads_conv16_0_bt_32_r313_m335,5_vs_5
1663,1,2,m_sp_arch_longer_heads_bt_32_r310_m277_1370M,1,m_sp_arch_medium_heads_conv16_0_bt_32_r313_m335,5_vs_5
1664,-1,2,m_sp_arch_longer_heads_bt_32_r310_m277_1370M,3,m_sp_arch_medium_heads_conv16_0_bt_32_r313_m335,5_vs_5
1665,0,1,m_sp_arch_longer_heads_bt_32_r310_m277_1370M,1,m_sp_arch_medium_heads_conv16_0_bt_32_r313_m335,5_vs_5
1666,0,2,m_sp_arch_longer_heads_bt_32_r310_m277_1370M,2,m_sp_arch_medium_heads_conv16_0_bt_32_r313_m335,5_vs_5
1667,-1,0,m_sp_arch_longer_heads_bt_32_r310_m277_1370M,1,m_sp_arch_medium_heads_conv16_0_bt_32_r313_m335,5_vs_5
1668,-2,0,m_sp_arch_longer_heads_bt_32_r310_m277_1370M,2,m_sp_arch_medium_heads_conv16_0_bt_32_r313_m335,5_vs_5
1669,-6,0,m_sp_arch_longer_heads_bt_32_r310_m277_1370M,6,m_sp_arch_medium_heads_conv16_0_bt_32_r313_m335,5_vs_5
1670,1,3,m_sp_arch_longer_heads_bt_32_r310_m277_1370M,2,m_sp_arch_medium_heads_conv16_0_bt_32_r313_m335,5_vs_5
1671,2,5,m_sp_arch_longer_heads_bt_32_r310_m277_1370M,3,m_sp_arch_medium_heads_conv16_0_bt_32_r313_m335,5_vs_5
1672,1,2,m_sp_arch_longer_heads_bt_32_r310_m277_1370M,1,m_sp_arch_medium_heads_conv16_0_bt_32_r313_m335,5_vs_5
1673,-1,2,m_sp_arch_longer_heads_bt_32_r310_m277_1370M,3,m_sp_arch_medium_heads_conv16_0_bt_32_r313_m335,5_vs_5
1674,0,4,m_sp_arch_longer_heads_bt_32_r310_m277_1370M,4,m_sp_arch_medium_heads_conv16_0_bt_32_r313_m335,5_vs_5
1675,1,2,m_sp_arch_longer_heads_bt_32_r310_m277_1370M,1,m_sp_arch_medium_heads_conv16_0_bt_32_r313_m335,5_vs_5
1676,4,5,m_sp_arch_longer_heads_bt_32_r310_m277_1370M,1,m_sp_arch_medium_heads_conv16_0_bt_32_r313_m335,5_vs_5
1677,-1,1,m_sp_arch_longer_heads_bt_32_r310_m277_1370M,2,m_sp_arch_medium_heads_conv16_0_bt_32_r313_m335,5_vs_5
1678,-3,1,m_sp_arch_longer_heads_bt_32_r310_m277_1370M,4,m_sp_arch_medium_heads_conv16_0_bt_32_r313_m335,5_vs_5
1679,-3,0,m_sp_arch_longer_heads_bt_32_r310_m277_1370M,3,m_sp_arch_medium_heads_conv16_0_bt_32_r313_m335,5_vs_5
1680,-1,1,m_sp_arch_longer_heads_bt_32_r310_m277_1370M,2,m_sp_arch_medium_heads_conv16_0_bt_32_r313_m288_1370M,5_vs_5
1681,1,2,m_sp_arch_longer_heads_bt_32_r310_m277_1370M,1,m_sp_arch_medium_heads_conv16_0_bt_32_r313_m288_1370M,5_vs_5
1682,-4,1,m_sp_arch_longer_heads_bt_32_r310_m277_1370M,5,m_sp_arch_medium_heads_conv16_0_bt_32_r313_m288_1370M,5_vs_5
1683,-2,2,m_sp_arch_longer_heads_bt_32_r310_m277_1370M,4,m_sp_arch_medium_heads_conv16_0_bt_32_r313_m288_1370M,5_vs_5
1684,0,2,m_sp_arch_longer_heads_bt_32_r310_m277_1370M,2,m_sp_arch_medium_heads_conv16_0_bt_32_r313_m288_1370M,5_vs_5
1685,-1,3,m_sp_arch_longer_heads_bt_32_r310_m277_1370M,4,m_sp_arch_medium_heads_conv16_0_bt_32_r313_m288_1370M,5_vs_5
1686,-3,0,m_sp_arch_longer_heads_bt_32_r310_m277_1370M,3,m_sp_arch_medium_heads_conv16_0_bt_32_r313_m288_1370M,5_vs_5
1687,2,2,m_sp_arch_longer_heads_bt_32_r310_m277_1370M,0,m_sp_arch_medium_heads_conv16_0_bt_32_r313_m288_1370M,5_vs_5
1688,0,3,m_sp_arch_longer_heads_bt_32_r310_m277_1370M,3,m_sp_arch_medium_heads_conv16_0_bt_32_r313_m288_1370M,5_vs_5
1689,-2,1,m_sp_arch_longer_heads_bt_32_r310_m277_1370M,3,m_sp_arch_medium_heads_conv16_0_bt_32_r313_m288_1370M,5_vs_5
1690,-1,0,m_sp_arch_longer_heads_bt_32_r310_m277_1370M,1,m_sp_arch_medium_heads_conv16_0_bt_32_r313_m288_1370M,5_vs_5
1691,1,3,m_sp_arch_longer_heads_bt_32_r310_m277_1370M,2,m_sp_arch_medium_heads_conv16_0_bt_32_r313_m288_1370M,5_vs_5
1692,2,3,m_sp_arch_longer_heads_bt_32_r310_m277_1370M,1,m_sp_arch_medium_heads_conv16_0_bt_32_r313_m288_1370M,5_vs_5
1693,0,3,m_sp_arch_longer_heads_bt_32_r310_m277_1370M,3,m_sp_arch_medium_heads_conv16_0_bt_32_r313_m288_1370M,5_vs_5
1694,1,1,m_sp_arch_longer_heads_bt_32_r310_m277_1370M,0,m_sp_arch_medium_heads_conv16_0_bt_32_r313_m288_1370M,5_vs_5
1695,-3,1,m_sp_arch_longer_heads_bt_32_r310_m277_1370M,4,m_sp_arch_medium_heads_conv16_0_bt_32_r313_m288_1370M,5_vs_5
1696,2,4,m_sp_arch_longer_heads_bt_32_r310_m277_1370M,2,m_sp_arch_medium_heads_conv16_0_bt_32_r313_m288_1370M,5_vs_5
1697,1,3,m_sp_arch_longer_heads_bt_32_r310_m277_1370M,2,m_sp_arch_medium_heads_conv16_0_bt_32_r313_m288_1370M,5_vs_5
1698,0,3,m_sp_arch_longer_heads_bt_32_r310_m277_1370M,3,m_sp_arch_medium_heads_conv16_0_bt_32_r313_m288_1370M,5_vs_5
1699,-3,0,m_sp_arch_longer_heads_bt_32_r310_m277_1370M,3,m_sp_arch_medium_heads_conv16_0_bt_32_r313_m288_1370M,5_vs_5
1700,-2,1,m_sp_arch_longer_heads_bt_32_r310_m277_1370M,3,m_sp_arch_longer_heads_bt_32_r201_m335,5_vs_5
1701,0,1,m_sp_arch_longer_heads_bt_32_r310_m277_1370M,1,m_sp_arch_longer_heads_bt_32_r201_m335,5_vs_5
1702,-1,4,m_sp_arch_longer_heads_bt_32_r310_m277_1370M,5,m_sp_arch_longer_heads_bt_32_r201_m335,5_vs_5
1703,-4,1,m_sp_arch_longer_heads_bt_32_r310_m277_1370M,5,m_sp_arch_longer_heads_bt_32_r201_m335,5_vs_5
1704,-1,3,m_sp_arch_longer_heads_bt_32_r310_m277_1370M,4,m_sp_arch_longer_heads_bt_32_r201_m335,5_vs_5
1705,0,1,m_sp_arch_longer_heads_bt_32_r310_m277_1370M,1,m_sp_arch_longer_heads_bt_32_r201_m335,5_vs_5
1706,0,2,m_sp_arch_longer_heads_bt_32_r310_m277_1370M,2,m_sp_arch_longer_heads_bt_32_r201_m335,5_vs_5
1707,-3,1,m_sp_arch_longer_heads_bt_32_r310_m277_1370M,4,m_sp_arch_longer_heads_bt_32_r201_m335,5_vs_5
1708,0,1,m_sp_arch_longer_heads_bt_32_r310_m277_1370M,1,m_sp_arch_longer_heads_bt_32_r201_m335,5_vs_5
1709,0,1,m_sp_arch_longer_heads_bt_32_r310_m277_1370M,1,m_sp_arch_longer_heads_bt_32_r201_m335,5_vs_5
1710,-2,2,m_sp_arch_longer_heads_bt_32_r310_m277_1370M,4,m_sp_arch_longer_heads_bt_32_r201_m335,5_vs_5
1711,1,1,m_sp_arch_longer_heads_bt_32_r310_m277_1370M,0,m_sp_arch_longer_heads_bt_32_r201_m335,5_vs_5
1712,-2,0,m_sp_arch_longer_heads_bt_32_r310_m277_1370M,2,m_sp_arch_longer_heads_bt_32_r201_m335,5_vs_5
1713,-2,2,m_sp_arch_longer_heads_bt_32_r310_m277_1370M,4,m_sp_arch_longer_heads_bt_32_r201_m335,5_vs_5
1714,-2,2,m_sp_arch_longer_heads_bt_32_r310_m277_1370M,4,m_sp_arch_longer_heads_bt_32_r201_m335,5_vs_5
1715,-4,1,m_sp_arch_longer_heads_bt_32_r310_m277_1370M,5,m_sp_arch_longer_heads_bt_32_r201_m335,5_vs_5
1716,4,4,m_sp_arch_longer_heads_bt_32_r310_m277_1370M,0,m_sp_arch_longer_heads_bt_32_r201_m335,5_vs_5
1717,-1,1,m_sp_arch_longer_heads_bt_32_r310_m277_1370M,2,m_sp_arch_longer_heads_bt_32_r201_m335,5_vs_5
1718,-2,0,m_sp_arch_longer_heads_bt_32_r310_m277_1370M,2,m_sp_arch_longer_heads_bt_32_r201_m335,5_vs_5
1719,-1,3,m_sp_arch_longer_heads_bt_32_r310_m277_1370M,4,m_sp_arch_longer_heads_bt_32_r201_m335,5_vs_5
1720,-1,0,m_sp_arch_longer_heads_bt_32_r310_m277_1370M,1,m_sp_arch_longer_heads_bt_32_r310_m277_1370M,5_vs_5
1721,4,5,m_sp_arch_longer_heads_bt_32_r310_m277_1370M,1,m_sp_arch_longer_heads_bt_32_r310_m277_1370M,5_vs_5
1722,-1,0,m_sp_arch_longer_heads_bt_32_r310_m277_1370M,1,m_sp_arch_longer_heads_bt_32_r310_m277_1370M,5_vs_5
1723,-1,1,m_sp_arch_longer_heads_bt_32_r310_m277_1370M,2,m_sp_arch_longer_heads_bt_32_r310_m277_1370M,5_vs_5
1724,3,4,m_sp_arch_longer_heads_bt_32_r310_m277_1370M,1,m_sp_arch_longer_heads_bt_32_r310_m277_1370M,5_vs_5
1725,1,2,m_sp_arch_longer_heads_bt_32_r310_m277_1370M,1,m_sp_arch_longer_heads_bt_32_r310_m277_1370M,5_vs_5
1726,1,1,m_sp_arch_longer_heads_bt_32_r310_m277_1370M,0,m_sp_arch_longer_heads_bt_32_r310_m277_1370M,5_vs_5
1727,-1,3,m_sp_arch_longer_heads_bt_32_r310_m277_1370M,4,m_sp_arch_longer_heads_bt_32_r310_m277_1370M,5_vs_5
1728,-1,1,m_sp_arch_longer_heads_bt_32_r310_m277_1370M,2,m_sp_arch_longer_heads_bt_32_r310_m277_1370M,5_vs_5
1729,1,2,m_sp_arch_longer_heads_bt_32_r310_m277_1370M,1,m_sp_arch_longer_heads_bt_32_r310_m277_1370M,5_vs_5
1730,3,5,m_sp_arch_longer_heads_bt_32_r310_m277_1370M,2,m_sp_arch_longer_heads_bt_32_r310_m277_1370M,5_vs_5
1731,1,3,m_sp_arch_longer_heads_bt_32_r310_m277_1370M,2,m_sp_arch_longer_heads_bt_32_r310_m277_1370M,5_vs_5
1732,-1,1,m_sp_arch_longer_heads_bt_32_r310_m277_1370M,2,m_sp_arch_longer_heads_bt_32_r310_m277_1370M,5_vs_5
1733,0,3,m_sp_arch_longer_heads_bt_32_r310_m277_1370M,3,m_sp_arch_longer_heads_bt_32_r310_m277_1370M,5_vs_5
1734,0,0,m_sp_arch_longer_heads_bt_32_r310_m277_1370M,0,m_sp_arch_longer_heads_bt_32_r310_m277_1370M,5_vs_5
1735,-2,1,m_sp_arch_longer_heads_bt_32_r310_m277_1370M,3,m_sp_arch_longer_heads_bt_32_r310_m277_1370M,5_vs_5
1736,0,3,m_sp_arch_longer_heads_bt_32_r310_m277_1370M,3,m_sp_arch_longer_heads_bt_32_r310_m277_1370M,5_vs_5
1737,-1,1,m_sp_arch_longer_heads_bt_32_r310_m277_1370M,2,m_sp_arch_longer_heads_bt_32_r310_m277_1370M,5_vs_5
1738,2,3,m_sp_arch_longer_heads_bt_32_r310_m277_1370M,1,m_sp_arch_longer_heads_bt_32_r310_m277_1370M,5_vs_5
1739,0,2,m_sp_arch_longer_heads_bt_32_r310_m277_1370M,2,m_sp_arch_longer_heads_bt_32_r310_m277_1370M,5_vs_5
1740,-2,0,m_sp_arch_longer_heads_bt_32_r310_m277_1370M,2,m_sp_arch_medium_heads_bt_32_r201_m335,5_vs_5
1741,0,4,m_sp_arch_longer_heads_bt_32_r310_m277_1370M,4,m_sp_arch_medium_heads_bt_32_r201_m335,5_vs_5
1742,-2,1,m_sp_arch_longer_heads_bt_32_r310_m277_1370M,3,m_sp_arch_medium_heads_bt_32_r201_m335,5_vs_5
1743,2,3,m_sp_arch_longer_heads_bt_32_r310_m277_1370M,1,m_sp_arch_medium_heads_bt_32_r201_m335,5_vs_5
1744,-2,1,m_sp_arch_longer_heads_bt_32_r310_m277_1370M,3,m_sp_arch_medium_heads_bt_32_r201_m335,5_vs_5
1745,-1,2,m_sp_arch_longer_heads_bt_32_r310_m277_1370M,3,m_sp_arch_medium_heads_bt_32_r201_m335,5_vs_5
1746,1,3,m_sp_arch_longer_heads_bt_32_r310_m277_1370M,2,m_sp_arch_medium_heads_bt_32_r201_m335,5_vs_5
1747,0,1,m_sp_arch_longer_heads_bt_32_r310_m277_1370M,1,m_sp_arch_medium_heads_bt_32_r201_m335,5_vs_5
1748,-1,0,m_sp_arch_longer_heads_bt_32_r310_m277_1370M,1,m_sp_arch_medium_heads_bt_32_r201_m335,5_vs_5
1749,1,2,m_sp_arch_longer_heads_bt_32_r310_m277_1370M,1,m_sp_arch_medium_heads_bt_32_r201_m335,5_vs_5
1750,1,3,m_sp_arch_longer_heads_bt_32_r310_m277_1370M,2,m_sp_arch_medium_heads_bt_32_r201_m335,5_vs_5
1751,-1,1,m_sp_arch_longer_heads_bt_32_r310_m277_1370M,2,m_sp_arch_medium_heads_bt_32_r201_m335,5_vs_5
1752,0,2,m_sp_arch_longer_heads_bt_32_r310_m277_1370M,2,m_sp_arch_medium_heads_bt_32_r201_m335,5_vs_5
1753,-4,0,m_sp_arch_longer_heads_bt_32_r310_m277_1370M,4,m_sp_arch_medium_heads_bt_32_r201_m335,5_vs_5
1754,0,2,m_sp_arch_longer_heads_bt_32_r310_m277_1370M,2,m_sp_arch_medium_heads_bt_32_r201_m335,5_vs_5
1755,2,4,m_sp_arch_longer_heads_bt_32_r310_m277_1370M,2,m_sp_arch_medium_heads_bt_32_r201_m335,5_vs_5
1756,0,3,m_sp_arch_longer_heads_bt_32_r310_m277_1370M,3,m_sp_arch_medium_heads_bt_32_r201_m335,5_vs_5
1757,0,3,m_sp_arch_longer_heads_bt_32_r310_m277_1370M,3,m_sp_arch_medium_heads_bt_32_r201_m335,5_vs_5
1758,-4,2,m_sp_arch_longer_heads_bt_32_r310_m277_1370M,6,m_sp_arch_medium_heads_bt_32_r201_m335,5_vs_5
1759,-3,2,m_sp_arch_longer_heads_bt_32_r310_m277_1370M,5,m_sp_arch_medium_heads_bt_32_r201_m335,5_vs_5
1760,7,7,m_sp_arch_longer_heads_bt_32_r310_m277_1370M,0,m_sp_arch_medium_heads_bt_32_r201_m273_1370M,5_vs_5
1761,4,6,m_sp_arch_longer_heads_bt_32_r310_m277_1370M,2,m_sp_arch_medium_heads_bt_32_r201_m273_1370M,5_vs_5
1762,-1,3,m_sp_arch_longer_heads_bt_32_r310_m277_1370M,4,m_sp_arch_medium_heads_bt_32_r201_m273_1370M,5_vs_5
1763,5,8,m_sp_arch_longer_heads_bt_32_r310_m277_1370M,3,m_sp_arch_medium_heads_bt_32_r201_m273_1370M,5_vs_5
1764,7,7,m_sp_arch_longer_heads_bt_32_r310_m277_1370M,0,m_sp_arch_medium_heads_bt_32_r201_m273_1370M,5_vs_5
1765,0,0,m_sp_arch_longer_heads_bt_32_r310_m277_1370M,0,m_sp_arch_medium_heads_bt_32_r201_m273_1370M,5_vs_5
1766,0,1,m_sp_arch_longer_heads_bt_32_r310_m277_1370M,1,m_sp_arch_medium_heads_bt_32_r201_m273_1370M,5_vs_5
1767,4,6,m_sp_arch_longer_heads_bt_32_r310_m277_1370M,2,m_sp_arch_medium_heads_bt_32_r201_m273_1370M,5_vs_5
1768,4,6,m_sp_arch_longer_heads_bt_32_r310_m277_1370M,2,m_sp_arch_medium_heads_bt_32_r201_m273_1370M,5_vs_5
1769,3,7,m_sp_arch_longer_heads_bt_32_r310_m277_1370M,4,m_sp_arch_medium_heads_bt_32_r201_m273_1370M,5_vs_5
1770,4,5,m_sp_arch_longer_heads_bt_32_r310_m277_1370M,1,m_sp_arch_medium_heads_bt_32_r201_m273_1370M,5_vs_5
1771,1,3,m_sp_arch_longer_heads_bt_32_r310_m277_1370M,2,m_sp_arch_medium_heads_bt_32_r201_m273_1370M,5_vs_5
1772,2,4,m_sp_arch_longer_heads_bt_32_r310_m277_1370M,2,m_sp_arch_medium_heads_bt_32_r201_m273_1370M,5_vs_5
1773,2,5,m_sp_arch_longer_heads_bt_32_r310_m277_1370M,3,m_sp_arch_medium_heads_bt_32_r201_m273_1370M,5_vs_5
1774,1,4,m_sp_arch_longer_heads_bt_32_r310_m277_1370M,3,m_sp_arch_medium_heads_bt_32_r201_m273_1370M,5_vs_5
1775,0,2,m_sp_arch_longer_heads_bt_32_r310_m277_1370M,2,m_sp_arch_medium_heads_bt_32_r201_m273_1370M,5_vs_5
1776,1,1,m_sp_arch_longer_heads_bt_32_r310_m277_1370M,0,m_sp_arch_medium_heads_bt_32_r201_m273_1370M,5_vs_5
1777,3,5,m_sp_arch_longer_heads_bt_32_r310_m277_1370M,2,m_sp_arch_medium_heads_bt_32_r201_m273_1370M,5_vs_5
1778,9,9,m_sp_arch_longer_heads_bt_32_r310_m277_1370M,0,m_sp_arch_medium_heads_bt_32_r201_m273_1370M,5_vs_5
1779,2,3,m_sp_arch_longer_heads_bt_32_r310_m277_1370M,1,m_sp_arch_medium_heads_bt_32_r201_m273_1370M,5_vs_5
1780,-1,0,m_sp_arch_longer_heads_bt_32_r310_m277_1370M,1,m_sp_arch_4x1_bt_32_r201_m335,5_vs_5
1781,-3,1,m_sp_arch_longer_heads_bt_32_r310_m277_1370M,4,m_sp_arch_4x1_bt_32_r201_m335,5_vs_5
1782,-2,1,m_sp_arch_longer_heads_bt_32_r310_m277_1370M,3,m_sp_arch_4x1_bt_32_r201_m335,5_vs_5
1783,-4,0,m_sp_arch_longer_heads_bt_32_r310_m277_1370M,4,m_sp_arch_4x1_bt_32_r201_m335,5_vs_5
1784,-6,0,m_sp_arch_longer_heads_bt_32_r310_m277_1370M,6,m_sp_arch_4x1_bt_32_r201_m335,5_vs_5
1785,-6,0,m_sp_arch_longer_heads_bt_32_r310_m277_1370M,6,m_sp_arch_4x1_bt_32_r201_m335,5_vs_5
1786,-3,0,m_sp_arch_longer_heads_bt_32_r310_m277_1370M,3,m_sp_arch_4x1_bt_32_r201_m335,5_vs_5
1787,-3,0,m_sp_arch_longer_heads_bt_32_r310_m277_1370M,3,m_sp_arch_4x1_bt_32_r201_m335,5_vs_5
1788,-4,0,m_sp_arch_longer_heads_bt_32_r310_m277_1370M,4,m_sp_arch_4x1_bt_32_r201_m335,5_vs_5
1789,-7,1,m_sp_arch_longer_heads_bt_32_r310_m277_1370M,8,m_sp_arch_4x1_bt_32_r201_m335,5_vs_5
1790,-1,1,m_sp_arch_longer_heads_bt_32_r310_m277_1370M,2,m_sp_arch_4x1_bt_32_r201_m335,5_vs_5
1791,-6,0,m_sp_arch_longer_heads_bt_32_r310_m277_1370M,6,m_sp_arch_4x1_bt_32_r201_m335,5_vs_5
1792,-5,1,m_sp_arch_longer_heads_bt_32_r310_m277_1370M,6,m_sp_arch_4x1_bt_32_r201_m335,5_vs_5
1793,-5,0,m_sp_arch_longer_heads_bt_32_r310_m277_1370M,5,m_sp_arch_4x1_bt_32_r201_m335,5_vs_5
1794,-4,2,m_sp_arch_longer_heads_bt_32_r310_m277_1370M,6,m_sp_arch_4x1_bt_32_r201_m335,5_vs_5
1795,-6,0,m_sp_arch_longer_heads_bt_32_r310_m277_1370M,6,m_sp_arch_4x1_bt_32_r201_m335,5_vs_5
1796,-2,0,m_sp_arch_longer_heads_bt_32_r310_m277_1370M,2,m_sp_arch_4x1_bt_32_r201_m335,5_vs_5
1797,-3,1,m_sp_arch_longer_heads_bt_32_r310_m277_1370M,4,m_sp_arch_4x1_bt_32_r201_m335,5_vs_5
1798,-3,0,m_sp_arch_longer_heads_bt_32_r310_m277_1370M,3,m_sp_arch_4x1_bt_32_r201_m335,5_vs_5
1799,-2,1,m_sp_arch_longer_heads_bt_32_r310_m277_1370M,3,m_sp_arch_4x1_bt_32_r201_m335,5_vs_5
1800,-6,0,m_sp_arch_longer_heads_bt_32_r310_m277_1370M,6,m_sp_arch_4x1_bt_32_r201_cont3_m650,5_vs_5
1801,-5,1,m_sp_arch_longer_heads_bt_32_r310_m277_1370M,6,m_sp_arch_4x1_bt_32_r201_cont3_m650,5_vs_5
1802,-4,1,m_sp_arch_longer_heads_bt_32_r310_m277_1370M,5,m_sp_arch_4x1_bt_32_r201_cont3_m650,5_vs_5
1803,-5,0,m_sp_arch_longer_heads_bt_32_r310_m277_1370M,5,m_sp_arch_4x1_bt_32_r201_cont3_m650,5_vs_5
1804,-4,2,m_sp_arch_longer_heads_bt_32_r310_m277_1370M,6,m_sp_arch_4x1_bt_32_r201_cont3_m650,5_vs_5
1805,-8,0,m_sp_arch_longer_heads_bt_32_r310_m277_1370M,8,m_sp_arch_4x1_bt_32_r201_cont3_m650,5_vs_5
1806,-2,0,m_sp_arch_longer_heads_bt_32_r310_m277_1370M,2,m_sp_arch_4x1_bt_32_r201_cont3_m650,5_vs_5
1807,-6,0,m_sp_arch_longer_heads_bt_32_r310_m277_1370M,6,m_sp_arch_4x1_bt_32_r201_cont3_m650,5_vs_5
1808,-4,1,m_sp_arch_longer_heads_bt_32_r310_m277_1370M,5,m_sp_arch_4x1_bt_32_r201_cont3_m650,5_vs_5
1809,-5,1,m_sp_arch_longer_heads_bt_32_r310_m277_1370M,6,m_sp_arch_4x1_bt_32_r201_cont3_m650,5_vs_5
1810,-6,0,m_sp_arch_longer_heads_bt_32_r310_m277_1370M,6,m_sp_arch_4x1_bt_32_r201_cont3_m650,5_vs_5
1811,-8,0,m_sp_arch_longer_heads_bt_32_r310_m277_1370M,8,m_sp_arch_4x1_bt_32_r201_cont3_m650,5_vs_5
1812,-6,0,m_sp_arch_longer_heads_bt_32_r310_m277_1370M,6,m_sp_arch_4x1_bt_32_r201_cont3_m650,5_vs_5
1813,-6,0,m_sp_arch_longer_heads_bt_32_r310_m277_1370M,6,m_sp_arch_4x1_bt_32_r201_cont3_m650,5_vs_5
1814,-3,0,m_sp_arch_longer_heads_bt_32_r310_m277_1370M,3,m_sp_arch_4x1_bt_32_r201_cont3_m650,5_vs_5
1815,-4,1,m_sp_arch_longer_heads_bt_32_r310_m277_1370M,5,m_sp_arch_4x1_bt_32_r201_cont3_m650,5_vs_5
1816,-3,0,m_sp_arch_longer_heads_bt_32_r310_m277_1370M,3,m_sp_arch_4x1_bt_32_r201_cont3_m650,5_vs_5
1817,-6,0,m_sp_arch_longer_heads_bt_32_r310_m277_1370M,6,m_sp_arch_4x1_bt_32_r201_cont3_m650,5_vs_5
1818,-2,1,m_sp_arch_longer_heads_bt_32_r310_m277_1370M,3,m_sp_arch_4x1_bt_32_r201_cont3_m650,5_vs_5
1819,-4,0,m_sp_arch_longer_heads_bt_32_r310_m277_1370M,4,m_sp_arch_4x1_bt_32_r201_cont3_m650,5_vs_5
1820,-3,0,m_sp_arch_longer_heads_bt_32_r310_m277_1370M,3,explt_v0_7_2_m54,5_vs_5
1821,-2,1,m_sp_arch_longer_heads_bt_32_r310_m277_1370M,3,explt_v0_7_2_m54,5_vs_5
1822,-3,2,m_sp_arch_longer_heads_bt_32_r310_m277_1370M,5,explt_v0_7_2_m54,5_vs_5
1823,-1,0,m_sp_arch_longer_heads_bt_32_r310_m277_1370M,1,explt_v0_7_2_m54,5_vs_5
1824,-3,0,m_sp_arch_longer_heads_bt_32_r310_m277_1370M,3,explt_v0_7_2_m54,5_vs_5
1825,-4,1,m_sp_arch_longer_heads_bt_32_r310_m277_1370M,5,explt_v0_7_2_m54,5_vs_5
1826,-3,0,m_sp_arch_longer_heads_bt_32_r310_m277_1370M,3,explt_v0_7_2_m54,5_vs_5
1827,-3,2,m_sp_arch_longer_heads_bt_32_r310_m277_1370M,5,explt_v0_7_2_m54,5_vs_5
1828,0,2,m_sp_arch_longer_heads_bt_32_r310_m277_1370M,2,explt_v0_7_2_m54,5_vs_5
1829,-2,1,m_sp_arch_longer_heads_bt_32_r310_m277_1370M,3,explt_v0_7_2_m54,5_vs_5
1830,-1,0,m_sp_arch_longer_heads_bt_32_r310_m277_1370M,1,explt_v0_7_2_m54,5_vs_5
1831,-3,1,m_sp_arch_longer_heads_bt_32_r310_m277_1370M,4,explt_v0_7_2_m54,5_vs_5
1832,-1,1,m_sp_arch_longer_heads_bt_32_r310_m277_1370M,2,explt_v0_7_2_m54,5_vs_5
1833,-4,1,m_sp_arch_longer_heads_bt_32_r310_m277_1370M,5,explt_v0_7_2_m54,5_vs_5
1834,-2,0,m_sp_arch_longer_heads_bt_32_r310_m277_1370M,2,explt_v0_7_2_m54,5_vs_5
1835,-3,1,m_sp_arch_longer_heads_bt_32_r310_m277_1370M,4,explt_v0_7_2_m54,5_vs_5
1836,1,2,m_sp_arch_longer_heads_bt_32_r310_m277_1370M,1,explt_v0_7_2_m54,5_vs_5
1837,-6,0,m_sp_arch_longer_heads_bt_32_r310_m277_1370M,6,explt_v0_7_2_m54,5_vs_5
1838,-2,1,m_sp_arch_longer_heads_bt_32_r310_m277_1370M,3,explt_v0_7_2_m54,5_vs_5
1839,0,1,m_sp_arch_longer_heads_bt_32_r310_m277_1370M,1,explt_v0_7_2_m54,5_vs_5
1840,-5,1,m_sp_arch_longer_heads_bt_32_r310_m277_1370M,6,m_sp_sc3v3_arch_2x1_32_r500_cont4x1_m224,5_vs_5
1841,-1,1,m_sp_arch_longer_heads_bt_32_r310_m277_1370M,2,m_sp_sc3v3_arch_2x1_32_r500_cont4x1_m224,5_vs_5
1842,-3,2,m_sp_arch_longer_heads_bt_32_r310_m277_1370M,5,m_sp_sc3v3_arch_2x1_32_r500_cont4x1_m224,5_vs_5
1843,-4,0,m_sp_arch_longer_heads_bt_32_r310_m277_1370M,4,m_sp_sc3v3_arch_2x1_32_r500_cont4x1_m224,5_vs_5
1844,-4,0,m_sp_arch_longer_heads_bt_32_r310_m277_1370M,4,m_sp_sc3v3_arch_2x1_32_r500_cont4x1_m224,5_vs_5
1845,-7,0,m_sp_arch_longer_heads_bt_32_r310_m277_1370M,7,m_sp_sc3v3_arch_2x1_32_r500_cont4x1_m224,5_vs_5
1846,-3,3,m_sp_arch_longer_heads_bt_32_r310_m277_1370M,6,m_sp_sc3v3_arch_2x1_32_r500_cont4x1_m224,5_vs_5
1847,0,2,m_sp_arch_longer_heads_bt_32_r310_m277_1370M,2,m_sp_sc3v3_arch_2x1_32_r500_cont4x1_m224,5_vs_5
1848,1,2,m_sp_arch_longer_heads_bt_32_r310_m277_1370M,1,m_sp_sc3v3_arch_2x1_32_r500_cont4x1_m224,5_vs_5
1849,-4,0,m_sp_arch_longer_heads_bt_32_r310_m277_1370M,4,m_sp_sc3v3_arch_2x1_32_r500_cont4x1_m224,5_vs_5
1850,-4,1,m_sp_arch_longer_heads_bt_32_r310_m277_1370M,5,m_sp_sc3v3_arch_2x1_32_r500_cont4x1_m224,5_vs_5
1851,-3,1,m_sp_arch_longer_heads_bt_32_r310_m277_1370M,4,m_sp_sc3v3_arch_2x1_32_r500_cont4x1_m224,5_vs_5
1852,-1,1,m_sp_arch_longer_heads_bt_32_r310_m277_1370M,2,m_sp_sc3v3_arch_2x1_32_r500_cont4x1_m224,5_vs_5
1853,-4,0,m_sp_arch_longer_heads_bt_32_r310_m277_1370M,4,m_sp_sc3v3_arch_2x1_32_r500_cont4x1_m224,5_vs_5
1854,-5,0,m_sp_arch_longer_heads_bt_32_r310_m277_1370M,5,m_sp_sc3v3_arch_2x1_32_r500_cont4x1_m224,5_vs_5
1855,-5,0,m_sp_arch_longer_heads_bt_32_r310_m277_1370M,5,m_sp_sc3v3_arch_2x1_32_r500_cont4x1_m224,5_vs_5
1856,-5,3,m_sp_arch_longer_heads_bt_32_r310_m277_1370M,8,m_sp_sc3v3_arch_2x1_32_r500_cont4x1_m224,5_vs_5
1857,-5,0,m_sp_arch_longer_heads_bt_32_r310_m277_1370M,5,m_sp_sc3v3_arch_2x1_32_r500_cont4x1_m224,5_vs_5
1858,-7,0,m_sp_arch_longer_heads_bt_32_r310_m277_1370M,7,m_sp_sc3v3_arch_2x1_32_r500_cont4x1_m224,5_vs_5
1859,-2,1,m_sp_arch_longer_heads_bt_32_r310_m277_1370M,3,m_sp_sc3v3_arch_2x1_32_r500_cont4x1_m224,5_vs_5
1860,-3,1,m_sp_arch_longer_heads_bt_32_r310_m277_1370M,4,m_sp_arch_4x1_bt_32_roles_r500_m335,5_vs_5
1861,-9,0,m_sp_arch_longer_heads_bt_32_r310_m277_1370M,9,m_sp_arch_4x1_bt_32_roles_r500_m335,5_vs_5
1862,-6,0,m_sp_arch_longer_heads_bt_32_r310_m277_1370M,6,m_sp_arch_4x1_bt_32_roles_r500_m335,5_vs_5
1863,-5,0,m_sp_arch_longer_heads_bt_32_r310_m277_1370M,5,m_sp_arch_4x1_bt_32_roles_r500_m335,5_vs_5
1864,-7,0,m_sp_arch_longer_heads_bt_32_r310_m277_1370M,7,m_sp_arch_4x1_bt_32_roles_r500_m335,5_vs_5
1865,-8,0,m_sp_arch_longer_heads_bt_32_r310_m277_1370M,8,m_sp_arch_4x1_bt_32_roles_r500_m335,5_vs_5
1866,-7,0,m_sp_arch_longer_heads_bt_32_r310_m277_1370M,7,m_sp_arch_4x1_bt_32_roles_r500_m335,5_vs_5
1867,-9,1,m_sp_arch_longer_heads_bt_32_r310_m277_1370M,10,m_sp_arch_4x1_bt_32_roles_r500_m335,5_vs_5
1868,-10,0,m_sp_arch_longer_heads_bt_32_r310_m277_1370M,10,m_sp_arch_4x1_bt_32_roles_r500_m335,5_vs_5
1869,-8,0,m_sp_arch_longer_heads_bt_32_r310_m277_1370M,8,m_sp_arch_4x1_bt_32_roles_r500_m335,5_vs_5
1870,-5,0,m_sp_arch_longer_heads_bt_32_r310_m277_1370M,5,m_sp_arch_4x1_bt_32_roles_r500_m335,5_vs_5
1871,-4,0,m_sp_arch_longer_heads_bt_32_r310_m277_1370M,4,m_sp_arch_4x1_bt_32_roles_r500_m335,5_vs_5
1872,-4,2,m_sp_arch_longer_heads_bt_32_r310_m277_1370M,6,m_sp_arch_4x1_bt_32_roles_r500_m335,5_vs_5
1873,-7,1,m_sp_arch_longer_heads_bt_32_r310_m277_1370M,8,m_sp_arch_4x1_bt_32_roles_r500_m335,5_vs_5
1874,-4,1,m_sp_arch_longer_heads_bt_32_r310_m277_1370M,5,m_sp_arch_4x1_bt_32_roles_r500_m335,5_vs_5
1875,-3,0,m_sp_arch_longer_heads_bt_32_r310_m277_1370M,3,m_sp_arch_4x1_bt_32_roles_r500_m335,5_vs_5
1876,-6,0,m_sp_arch_longer_heads_bt_32_r310_m277_1370M,6,m_sp_arch_4x1_bt_32_roles_r500_m335,5_vs_5
1877,-5,1,m_sp_arch_longer_heads_bt_32_r310_m277_1370M,6,m_sp_arch_4x1_bt_32_roles_r500_m335,5_vs_5
1878,-1,1,m_sp_arch_longer_heads_bt_32_r310_m277_1370M,2,m_sp_arch_4x1_bt_32_roles_r500_m335,5_vs_5
1879,-10,0,m_sp_arch_longer_heads_bt_32_r310_m277_1370M,10,m_sp_arch_4x1_bt_32_roles_r500_m335,5_vs_5
1880,10,10,f5v0to1to5_e2_ckpt252,0,easy_bots,5_vs_5
1881,5,7,f5v0to1to5_e2_ckpt252,2,easy_bots,5_vs_5
1882,11,12,f5v0to1to5_e2_ckpt252,1,easy_bots,5_vs_5
1883,9,10,f5v0to1to5_e2_ckpt252,1,easy_bots,5_vs_5
1884,15,15,f5v0to1to5_e2_ckpt252,0,easy_bots,5_vs_5
1885,8,9,f5v0to1to5_e2_ckpt252,1,easy_bots,5_vs_5
1886,4,5,f5v0to1to5_e2_ckpt252,1,easy_bots,5_vs_5
1887,9,10,f5v0to1to5_e2_ckpt252,1,easy_bots,5_vs_5
1888,11,11,f5v0to1to5_e2_ckpt252,0,easy_bots,5_vs_5
1889,5,7,f5v0to1to5_e2_ckpt252,2,easy_bots,5_vs_5
1890,10,10,f5v0to1to5_e2_ckpt252,0,easy_bots,5_vs_5
1891,5,6,f5v0to1to5_e2_ckpt252,1,easy_bots,5_vs_5
1892,10,11,f5v0to1to5_e2_ckpt252,1,easy_bots,5_vs_5
1893,13,13,f5v0to1to5_e2_ckpt252,0,easy_bots,5_vs_5
1894,5,7,f5v0to1to5_e2_ckpt252,2,easy_bots,5_vs_5
1895,9,9,f5v0to1to5_e2_ckpt252,0,easy_bots,5_vs_5
1896,7,8,f5v0to1to5_e2_ckpt252,1,easy_bots,5_vs_5
1897,5,6,f5v0to1to5_e2_ckpt252,1,easy_bots,5_vs_5
1898,3,6,f5v0to1to5_e2_ckpt252,3,easy_bots,5_vs_5
1899,6,6,f5v0to1to5_e2_ckpt252,0,easy_bots,5_vs_5
1900,9,9,f5v0to1to5_e2_ckpt252,0,medium_bots,5_vs_5_medium
1901,7,7,f5v0to1to5_e2_ckpt252,0,medium_bots,5_vs_5_medium
1902,9,10,f5v0to1to5_e2_ckpt252,1,medium_bots,5_vs_5_medium
1903,3,7,f5v0to1to5_e2_ckpt252,4,medium_bots,5_vs_5_medium
1904,5,6,f5v0to1to5_e2_ckpt252,1,medium_bots,5_vs_5_medium
1905,9,9,f5v0to1to5_e2_ckpt252,0,medium_bots,5_vs_5_medium
1906,7,9,f5v0to1to5_e2_ckpt252,2,medium_bots,5_vs_5_medium
1907,6,7,f5v0to1to5_e2_ckpt252,1,medium_bots,5_vs_5_medium
1908,7,7,f5v0to1to5_e2_ckpt252,0,medium_bots,5_vs_5_medium
1909,6,7,f5v0to1to5_e2_ckpt252,1,medium_bots,5_vs_5_medium
1910,7,8,f5v0to1to5_e2_ckpt252,1,medium_bots,5_vs_5_medium
1911,8,9,f5v0to1to5_e2_ckpt252,1,medium_bots,5_vs_5_medium
1912,8,10,f5v0to1to5_e2_ckpt252,2,medium_bots,5_vs_5_medium
1913,4,5,f5v0to1to5_e2_ckpt252,1,medium_bots,5_vs_5_medium
1914,13,14,f5v0to1to5_e2_ckpt252,1,medium_bots,5_vs_5_medium
1915,12,13,f5v0to1to5_e2_ckpt252,1,medium_bots,5_vs_5_medium
1916,4,6,f5v0to1to5_e2_ckpt252,2,medium_bots,5_vs_5_medium
1917,5,6,f5v0to1to5_e2_ckpt252,1,medium_bots,5_vs_5_medium
1918,7,8,f5v0to1to5_e2_ckpt252,1,medium_bots,5_vs_5_medium
1919,7,7,f5v0to1to5_e2_ckpt252,0,medium_bots,5_vs_5_medium
1920,4,6,f5v0to1to5_e2_ckpt252,2,hard_bots,5_vs_5_hard
1921,8,9,f5v0to1to5_e2_ckpt252,1,hard_bots,5_vs_5_hard
1922,0,1,f5v0to1to5_e2_ckpt252,1,hard_bots,5_vs_5_hard
1923,4,5,f5v0to1to5_e2_ckpt252,1,hard_bots,5_vs_5_hard
1924,4,5,f5v0to1to5_e2_ckpt252,1,hard_bots,5_vs_5_hard
1925,4,5,f5v0to1to5_e2_ckpt252,1,hard_bots,5_vs_5_hard
1926,10,11,f5v0to1to5_e2_ckpt252,1,hard_bots,5_vs_5_hard
1927,1,4,f5v0to1to5_e2_ckpt252,3,hard_bots,5_vs_5_hard
1928,9,12,f5v0to1to5_e2_ckpt252,3,hard_bots,5_vs_5_hard
1929,0,1,f5v0to1to5_e2_ckpt252,1,hard_bots,5_vs_5_hard
1930,-1,2,f5v0to1to5_e2_ckpt252,3,hard_bots,5_vs_5_hard
1931,0,2,f5v0to1to5_e2_ckpt252,2,hard_bots,5_vs_5_hard
1932,10,10,f5v0to1to5_e2_ckpt252,0,hard_bots,5_vs_5_hard
1933,6,8,f5v0to1to5_e2_ckpt252,2,hard_bots,5_vs_5_hard
1934,7,8,f5v0to1to5_e2_ckpt252,1,hard_bots,5_vs_5_hard
1935,3,6,f5v0to1to5_e2_ckpt252,3,hard_bots,5_vs_5_hard
1936,1,2,f5v0to1to5_e2_ckpt252,1,hard_bots,5_vs_5_hard
1937,5,6,f5v0to1to5_e2_ckpt252,1,hard_bots,5_vs_5_hard
1938,4,7,f5v0to1to5_e2_ckpt252,3,hard_bots,5_vs_5_hard
1939,4,4,f5v0to1to5_e2_ckpt252,0,hard_bots,5_vs_5_hard
1940,-1,3,f5v0to1to5_e2_ckpt252,4,f5v0to1to2t05_e2_ckpt291,5_vs_5
1941,-2,2,f5v0to1to5_e2_ckpt252,4,f5v0to1to2t05_e2_ckpt291,5_vs_5
1942,2,5,f5v0to1to5_e2_ckpt252,3,f5v0to1to2t05_e2_ckpt291,5_vs_5
1943,-3,3,f5v0to1to5_e2_ckpt252,6,f5v0to1to2t05_e2_ckpt291,5_vs_5
1944,1,8,f5v0to1to5_e2_ckpt252,7,f5v0to1to2t05_e2_ckpt291,5_vs_5
1945,-3,1,f5v0to1to5_e2_ckpt252,4,f5v0to1to2t05_e2_ckpt291,5_vs_5
1946,2,6,f5v0to1to5_e2_ckpt252,4,f5v0to1to2t05_e2_ckpt291,5_vs_5
1947,-2,3,f5v0to1to5_e2_ckpt252,5,f5v0to1to2t05_e2_ckpt291,5_vs_5
1948,-4,2,f5v0to1to5_e2_ckpt252,6,f5v0to1to2t05_e2_ckpt291,5_vs_5
1949,3,6,f5v0to1to5_e2_ckpt252,3,f5v0to1to2t05_e2_ckpt291,5_vs_5
1950,2,6,f5v0to1to5_e2_ckpt252,4,f5v0to1to5_e2_ckpt252,5_vs_5
1951,-1,4,f5v0to1to5_e2_ckpt252,5,f5v0to1to5_e2_ckpt252,5_vs_5
1952,-2,1,f5v0to1to5_e2_ckpt252,3,f5v0to1to5_e2_ckpt252,5_vs_5
1953,-1,4,f5v0to1to5_e2_ckpt252,5,f5v0to1to5_e2_ckpt252,5_vs_5
1954,-1,3,f5v0to1to5_e2_ckpt252,4,f5v0to1to5_e2_ckpt252,5_vs_5
1955,2,5,f5v0to1to5_e2_ckpt252,3,f5v0to1to5_e2_ckpt252,5_vs_5
1956,5,8,f5v0to1to5_e2_ckpt252,3,f5v0to1to5_e2_ckpt252,5_vs_5
1957,-3,1,f5v0to1to5_e2_ckpt252,4,f5v0to1to5_e2_ckpt252,5_vs_5
1958,0,3,f5v0to1to5_e2_ckpt252,3,f5v0to1to5_e2_ckpt252,5_vs_5
1959,1,5,f5v0to1to5_e2_ckpt252,4,f5v0to1to5_e2_ckpt252,5_vs_5
1960,0,3,f5v0to1to5_e2_ckpt252,3,scon_e3_p2_hard_ckpt840,5_vs_5
1961,0,3,f5v0to1to5_e2_ckpt252,3,scon_e3_p2_hard_ckpt840,5_vs_5
1962,3,6,f5v0to1to5_e2_ckpt252,3,scon_e3_p2_hard_ckpt840,5_vs_5
1963,3,4,f5v0to1to5_e2_ckpt252,1,scon_e3_p2_hard_ckpt840,5_vs_5
1964,4,5,f5v0to1to5_e2_ckpt252,1,scon_e3_p2_hard_ckpt840,5_vs_5
1965,3,4,f5v0to1to5_e2_ckpt252,1,scon_e3_p2_hard_ckpt840,5_vs_5
1966,2,5,f5v0to1to5_e2_ckpt252,3,scon_e3_p2_hard_ckpt840,5_vs_5
1967,4,5,f5v0to1to5_e2_ckpt252,1,scon_e3_p2_hard_ckpt840,5_vs_5
1968,-1,2,f5v0to1to5_e2_ckpt252,3,scon_e3_p2_hard_ckpt840,5_vs_5
1969,1,3,f5v0to1to5_e2_ckpt252,2,scon_e3_p2_hard_ckpt840,5_vs_5
1970,2,2,f5v0to1to5_e2_ckpt252,0,less_then_partially_randomized_checkpoints_bots_4_heads_38_ckpt108,5_vs_5
1971,-3,3,f5v0to1to5_e2_ckpt252,6,less_then_partially_randomized_checkpoints_bots_4_heads_38_ckpt108,5_vs_5
1972,1,6,f5v0to1to5_e2_ckpt252,5,less_then_partially_randomized_checkpoints_bots_4_heads_38_ckpt108,5_vs_5
1973,-4,3,f5v0to1to5_e2_ckpt252,7,less_then_partially_randomized_checkpoints_bots_4_heads_38_ckpt108,5_vs_5
1974,-1,4,f5v0to1to5_e2_ckpt252,5,less_then_partially_randomized_checkpoints_bots_4_heads_38_ckpt108,5_vs_5
1975,2,5,f5v0to1to5_e2_ckpt252,3,less_then_partially_randomized_checkpoints_bots_4_heads_38_ckpt108,5_vs_5
1976,1,5,f5v0to1to5_e2_ckpt252,4,less_then_partially_randomized_checkpoints_bots_4_heads_38_ckpt108,5_vs_5
1977,3,6,f5v0to1to5_e2_ckpt252,3,less_then_partially_randomized_checkpoints_bots_4_heads_38_ckpt108,5_vs_5
1978,-1,3,f5v0to1to5_e2_ckpt252,4,less_then_partially_randomized_checkpoints_bots_4_heads_38_ckpt108,5_vs_5
1979,-1,1,f5v0to1to5_e2_ckpt252,2,less_then_partially_randomized_checkpoints_bots_4_heads_38_ckpt108,5_vs_5
1980,-1,3,f5v0to1to5_e2_ckpt252,4,less_then_partially_randomized_entropy_checkpoints_bots_4_heads_39_ckpt109,5_vs_5
1981,5,6,f5v0to1to5_e2_ckpt252,1,less_then_partially_randomized_entropy_checkpoints_bots_4_heads_39_ckpt109,5_vs_5
1982,0,3,f5v0to1to5_e2_ckpt252,3,less_then_partially_randomized_entropy_checkpoints_bots_4_heads_39_ckpt109,5_vs_5
1983,2,4,f5v0to1to5_e2_ckpt252,2,less_then_partially_randomized_entropy_checkpoints_bots_4_heads_39_ckpt109,5_vs_5
1984,6,7,f5v0to1to5_e2_ckpt252,1,less_then_partially_randomized_entropy_checkpoints_bots_4_heads_39_ckpt109,5_vs_5
1985,-1,4,f5v0to1to5_e2_ckpt252,5,less_then_partially_randomized_entropy_checkpoints_bots_4_heads_39_ckpt109,5_vs_5
1986,1,3,f5v0to1to5_e2_ckpt252,2,less_then_partially_randomized_entropy_checkpoints_bots_4_heads_39_ckpt109,5_vs_5
1987,0,5,f5v0to1to5_e2_ckpt252,5,less_then_partially_randomized_entropy_checkpoints_bots_4_heads_39_ckpt109,5_vs_5
1988,0,2,f5v0to1to5_e2_ckpt252,2,less_then_partially_randomized_entropy_checkpoints_bots_4_heads_39_ckpt109,5_vs_5
1989,-3,2,f5v0to1to5_e2_ckpt252,5,less_then_partially_randomized_entropy_checkpoints_bots_4_heads_39_ckpt109,5_vs_5
1990,0,4,f5v0to1to5_e2_ckpt252,4,reward_shaping_checkpoints_bots_4_heads_1_ckpt360,5_vs_5
1991,-3,3,f5v0to1to5_e2_ckpt252,6,reward_shaping_checkpoints_bots_4_heads_1_ckpt360,5_vs_5
1992,2,3,f5v0to1to5_e2_ckpt252,1,reward_shaping_checkpoints_bots_4_heads_1_ckpt360,5_vs_5
1993,4,4,f5v0to1to5_e2_ckpt252,0,reward_shaping_checkpoints_bots_4_heads_1_ckpt360,5_vs_5
1994,4,4,f5v0to1to5_e2_ckpt252,0,reward_shaping_checkpoints_bots_4_heads_1_ckpt360,5_vs_5
1995,-2,3,f5v0to1to5_e2_ckpt252,5,reward_shaping_checkpoints_bots_4_heads_1_ckpt360,5_vs_5
1996,-3,0,f5v0to1to5_e2_ckpt252,3,reward_shaping_checkpoints_bots_4_heads_1_ckpt360,5_vs_5
1997,5,6,f5v0to1to5_e2_ckpt252,1,reward_shaping_checkpoints_bots_4_heads_1_ckpt360,5_vs_5
1998,6,8,f5v0to1to5_e2_ckpt252,2,reward_shaping_checkpoints_bots_4_heads_1_ckpt360,5_vs_5
1999,-1,2,f5v0to1to5_e2_ckpt252,3,reward_shaping_checkpoints_bots_4_heads_1_ckpt360,5_vs_5
2000,-8,2,f5v0to1to5_e2_ckpt252,10,checkpoints_selfplay_e9_sp_ckpt274,5_vs_5
2001,-2,4,f5v0to1to5_e2_ckpt252,6,checkpoints_selfplay_e9_sp_ckpt274,5_vs_5
2002,-2,2,f5v0to1to5_e2_ckpt252,4,checkpoints_selfplay_e9_sp_ckpt274,5_vs_5
2003,-5,2,f5v0to1to5_e2_ckpt252,7,checkpoints_selfplay_e9_sp_ckpt274,5_vs_5
2004,-8,2,f5v0to1to5_e2_ckpt252,10,checkpoints_selfplay_e9_sp_ckpt274,5_vs_5
2005,0,2,f5v0to1to5_e2_ckpt252,2,checkpoints_selfplay_e9_sp_ckpt274,5_vs_5
2006,-1,5,f5v0to1to5_e2_ckpt252,6,checkpoints_selfplay_e9_sp_ckpt274,5_vs_5
2007,0,0,f5v0to1to5_e2_ckpt252,0,checkpoints_selfplay_e9_sp_ckpt274,5_vs_5
2008,-3,3,f5v0to1to5_e2_ckpt252,6,checkpoints_selfplay_e9_sp_ckpt274,5_vs_5
2009,-5,4,f5v0to1to5_e2_ckpt252,9,checkpoints_selfplay_e9_sp_ckpt274,5_vs_5
2010,-2,0,f5v0to1to5_e2_ckpt252,2,checkpoints_sp_c_nb_e2_ckpt667,5_vs_5
2011,-4,4,f5v0to1to5_e2_ckpt252,8,checkpoints_sp_c_nb_e2_ckpt667,5_vs_5
2012,-3,0,f5v0to1to5_e2_ckpt252,3,checkpoints_sp_c_nb_e2_ckpt667,5_vs_5
2013,-8,2,f5v0to1to5_e2_ckpt252,10,checkpoints_sp_c_nb_e2_ckpt667,5_vs_5
2014,-5,2,f5v0to1to5_e2_ckpt252,7,checkpoints_sp_c_nb_e2_ckpt667,5_vs_5
2015,-4,2,f5v0to1to5_e2_ckpt252,6,checkpoints_sp_c_nb_e2_ckpt667,5_vs_5
2016,-4,0,f5v0to1to5_e2_ckpt252,4,checkpoints_sp_c_nb_e2_ckpt667,5_vs_5
2017,-1,3,f5v0to1to5_e2_ckpt252,4,checkpoints_sp_c_nb_e2_ckpt667,5_vs_5
2018,-4,0,f5v0to1to5_e2_ckpt252,4,checkpoints_sp_c_nb_e2_ckpt667,5_vs_5
2019,-4,1,f5v0to1to5_e2_ckpt252,5,checkpoints_sp_c_nb_e2_ckpt667,5_vs_5
2020,0,0,f5v0to1to5_e2_ckpt252,0,scenario_curriculum_ckpt830,5_vs_5
2021,1,1,f5v0to1to5_e2_ckpt252,0,scenario_curriculum_ckpt830,5_vs_5
2022,1,1,f5v0to1to5_e2_ckpt252,0,scenario_curriculum_ckpt830,5_vs_5
2023,2,2,f5v0to1to5_e2_ckpt252,0,scenario_curriculum_ckpt830,5_vs_5
2024,1,1,f5v0to1to5_e2_ckpt252,0,scenario_curriculum_ckpt830,5_vs_5
2025,0,0,f5v0to1to5_e2_ckpt252,0,scenario_curriculum_ckpt830,5_vs_5
2026,1,1,f5v0to1to5_e2_ckpt252,0,scenario_curriculum_ckpt830,5_vs_5
2027,0,0,f5v0to1to5_e2_ckpt252,0,scenario_curriculum_ckpt830,5_vs_5
2028,1,1,f5v0to1to5_e2_ckpt252,0,scenario_curriculum_ckpt830,5_vs_5
2029,0,0,f5v0to1to5_e2_ckpt252,0,scenario_curriculum_ckpt830,5_vs_5
2030,0,5,f5v0to1to5_e2_ckpt252,5,m_sp_arch_medium_heads_conv16_0_bt_32_r313_m335,5_vs_5
2031,-1,1,f5v0to1to5_e2_ckpt252,2,m_sp_arch_medium_heads_conv16_0_bt_32_r313_m335,5_vs_5
2032,0,2,f5v0to1to5_e2_ckpt252,2,m_sp_arch_medium_heads_conv16_0_bt_32_r313_m335,5_vs_5
2033,-1,1,f5v0to1to5_e2_ckpt252,2,m_sp_arch_medium_heads_conv16_0_bt_32_r313_m335,5_vs_5
2034,-1,1,f5v0to1to5_e2_ckpt252,2,m_sp_arch_medium_heads_conv16_0_bt_32_r313_m335,5_vs_5
2035,-2,1,f5v0to1to5_e2_ckpt252,3,m_sp_arch_medium_heads_conv16_0_bt_32_r313_m335,5_vs_5
2036,-1,2,f5v0to1to5_e2_ckpt252,3,m_sp_arch_medium_heads_conv16_0_bt_32_r313_m335,5_vs_5
2037,-3,0,f5v0to1to5_e2_ckpt252,3,m_sp_arch_medium_heads_conv16_0_bt_32_r313_m335,5_vs_5
2038,2,4,f5v0to1to5_e2_ckpt252,2,m_sp_arch_medium_heads_conv16_0_bt_32_r313_m335,5_vs_5
2039,-3,2,f5v0to1to5_e2_ckpt252,5,m_sp_arch_medium_heads_conv16_0_bt_32_r313_m335,5_vs_5
2040,0,2,f5v0to1to5_e2_ckpt252,2,m_sp_arch_longer_heads_bt_32_r201_m335,5_vs_5
2041,-2,2,f5v0to1to5_e2_ckpt252,4,m_sp_arch_longer_heads_bt_32_r201_m335,5_vs_5
2042,-4,2,f5v0to1to5_e2_ckpt252,6,m_sp_arch_longer_heads_bt_32_r201_m335,5_vs_5
2043,-4,0,f5v0to1to5_e2_ckpt252,4,m_sp_arch_longer_heads_bt_32_r201_m335,5_vs_5
2044,-3,1,f5v0to1to5_e2_ckpt252,4,m_sp_arch_longer_heads_bt_32_r201_m335,5_vs_5
2045,-2,2,f5v0to1to5_e2_ckpt252,4,m_sp_arch_longer_heads_bt_32_r201_m335,5_vs_5
2046,-4,0,f5v0to1to5_e2_ckpt252,4,m_sp_arch_longer_heads_bt_32_r201_m335,5_vs_5
2047,-5,1,f5v0to1to5_e2_ckpt252,6,m_sp_arch_longer_heads_bt_32_r201_m335,5_vs_5
2048,-4,1,f5v0to1to5_e2_ckpt252,5,m_sp_arch_longer_heads_bt_32_r201_m335,5_vs_5
2049,-2,1,f5v0to1to5_e2_ckpt252,3,m_sp_arch_longer_heads_bt_32_r201_m335,5_vs_5
2050,-7,1,f5v0to1to5_e2_ckpt252,8,m_sp_arch_medium_heads_bt_32_r201_m335,5_vs_5
2051,1,4,f5v0to1to5_e2_ckpt252,3,m_sp_arch_medium_heads_bt_32_r201_m335,5_vs_5
2052,-2,5,f5v0to1to5_e2_ckpt252,7,m_sp_arch_medium_heads_bt_32_r201_m335,5_vs_5
2053,-6,0,f5v0to1to5_e2_ckpt252,6,m_sp_arch_medium_heads_bt_32_r201_m335,5_vs_5
2054,-5,0,f5v0to1to5_e2_ckpt252,5,m_sp_arch_medium_heads_bt_32_r201_m335,5_vs_5
2055,-1,2,f5v0to1to5_e2_ckpt252,3,m_sp_arch_medium_heads_bt_32_r201_m335,5_vs_5
2056,-3,3,f5v0to1to5_e2_ckpt252,6,m_sp_arch_medium_heads_bt_32_r201_m335,5_vs_5
2057,-3,2,f5v0to1to5_e2_ckpt252,5,m_sp_arch_medium_heads_bt_32_r201_m335,5_vs_5
2058,-3,3,f5v0to1to5_e2_ckpt252,6,m_sp_arch_medium_heads_bt_32_r201_m335,5_vs_5
2059,-2,3,f5v0to1to5_e2_ckpt252,5,m_sp_arch_medium_heads_bt_32_r201_m335,5_vs_5
2060,-5,1,f5v0to1to5_e2_ckpt252,6,m_sp_arch_4x1_bt_32_r201_m335,5_vs_5
2061,-8,1,f5v0to1to5_e2_ckpt252,9,m_sp_arch_4x1_bt_32_r201_m335,5_vs_5
2062,-8,1,f5v0to1to5_e2_ckpt252,9,m_sp_arch_4x1_bt_32_r201_m335,5_vs_5
2063,-4,0,f5v0to1to5_e2_ckpt252,4,m_sp_arch_4x1_bt_32_r201_m335,5_vs_5
2064,-10,0,f5v0to1to5_e2_ckpt252,10,m_sp_arch_4x1_bt_32_r201_m335,5_vs_5
2065,-7,0,f5v0to1to5_e2_ckpt252,7,m_sp_arch_4x1_bt_32_r201_m335,5_vs_5
2066,-8,0,f5v0to1to5_e2_ckpt252,8,m_sp_arch_4x1_bt_32_r201_m335,5_vs_5
2067,-10,1,f5v0to1to5_e2_ckpt252,11,m_sp_arch_4x1_bt_32_r201_m335,5_vs_5
2068,-7,1,f5v0to1to5_e2_ckpt252,8,m_sp_arch_4x1_bt_32_r201_m335,5_vs_5
2069,-8,0,f5v0to1to5_e2_ckpt252,8,m_sp_arch_4x1_bt_32_r201_m335,5_vs_5
2070,-6,0,f5v0to1to5_e2_ckpt252,6,m_sp_arch_4x1_bt_32_r201_cont3_m650,5_vs_5
2071,-7,0,f5v0to1to5_e2_ckpt252,7,m_sp_arch_4x1_bt_32_r201_cont3_m650,5_vs_5
2072,-7,0,f5v0to1to5_e2_ckpt252,7,m_sp_arch_4x1_bt_32_r201_cont3_m650,5_vs_5
2073,-6,0,f5v0to1to5_e2_ckpt252,6,m_sp_arch_4x1_bt_32_r201_cont3_m650,5_vs_5
2074,-6,4,f5v0to1to5_e2_ckpt252,10,m_sp_arch_4x1_bt_32_r201_cont3_m650,5_vs_5
2075,-7,1,f5v0to1to5_e2_ckpt252,8,m_sp_arch_4x1_bt_32_r201_cont3_m650,5_vs_5
2076,-6,4,f5v0to1to5_e2_ckpt252,10,m_sp_arch_4x1_bt_32_r201_cont3_m650,5_vs_5
2077,-5,0,f5v0to1to5_e2_ckpt252,5,m_sp_arch_4x1_bt_32_r201_cont3_m650,5_vs_5
2078,-13,1,f5v0to1to5_e2_ckpt252,14,m_sp_arch_4x1_bt_32_r201_cont3_m650,5_vs_5
2079,-9,0,f5v0to1to5_e2_ckpt252,9,m_sp_arch_4x1_bt_32_r201_cont3_m650,5_vs_5
2080,0,2,f5v0to1to5_e2_ckpt252,2,explt_v0_7_2_m54,5_vs_5
2081,-1,0,f5v0to1to5_e2_ckpt252,1,explt_v0_7_2_m54,5_vs_5
2082,-2,1,f5v0to1to5_e2_ckpt252,3,explt_v0_7_2_m54,5_vs_5
2083,-1,1,f5v0to1to5_e2_ckpt252,2,explt_v0_7_2_m54,5_vs_5
2084,-2,0,f5v0to1to5_e2_ckpt252,2,explt_v0_7_2_m54,5_vs_5
2085,-6,0,f5v0to1to5_e2_ckpt252,6,explt_v0_7_2_m54,5_vs_5
2086,-1,0,f5v0to1to5_e2_ckpt252,1,explt_v0_7_2_m54,5_vs_5
2087,-5,0,f5v0to1to5_e2_ckpt252,5,explt_v0_7_2_m54,5_vs_5
2088,-2,1,f5v0to1to5_e2_ckpt252,3,explt_v0_7_2_m54,5_vs_5
2089,-1,2,f5v0to1to5_e2_ckpt252,3,explt_v0_7_2_m54,5_vs_5
2090,-10,0,f5v0to1to5_e2_ckpt252,10,m_sp_sc3v3_arch_2x1_32_r500_cont4x1_m224,5_vs_5
2091,-7,0,f5v0to1to5_e2_ckpt252,7,m_sp_sc3v3_arch_2x1_32_r500_cont4x1_m224,5_vs_5
2092,-8,0,f5v0to1to5_e2_ckpt252,8,m_sp_sc3v3_arch_2x1_32_r500_cont4x1_m224,5_vs_5
2093,-11,0,f5v0to1to5_e2_ckpt252,11,m_sp_sc3v3_arch_2x1_32_r500_cont4x1_m224,5_vs_5
2094,-5,0,f5v0to1to5_e2_ckpt252,5,m_sp_sc3v3_arch_2x1_32_r500_cont4x1_m224,5_vs_5
2095,-12,3,f5v0to1to5_e2_ckpt252,15,m_sp_sc3v3_arch_2x1_32_r500_cont4x1_m224,5_vs_5
2096,-10,0,f5v0to1to5_e2_ckpt252,10,m_sp_sc3v3_arch_2x1_32_r500_cont4x1_m224,5_vs_5
2097,-8,0,f5v0to1to5_e2_ckpt252,8,m_sp_sc3v3_arch_2x1_32_r500_cont4x1_m224,5_vs_5
2098,-10,0,f5v0to1to5_e2_ckpt252,10,m_sp_sc3v3_arch_2x1_32_r500_cont4x1_m224,5_vs_5
2099,-10,0,f5v0to1to5_e2_ckpt252,10,m_sp_sc3v3_arch_2x1_32_r500_cont4x1_m224,5_vs_5
2100,-9,0,f5v0to1to5_e2_ckpt252,9,m_sp_arch_4x1_bt_32_roles_r500_m335,5_vs_5
2101,-8,0,f5v0to1to5_e2_ckpt252,8,m_sp_arch_4x1_bt_32_roles_r500_m335,5_vs_5
2102,-12,1,f5v0to1to5_e2_ckpt252,13,m_sp_arch_4x1_bt_32_roles_r500_m335,5_vs_5
2103,-13,0,f5v0to1to5_e2_ckpt252,13,m_sp_arch_4x1_bt_32_roles_r500_m335,5_vs_5
2104,-11,0,f5v0to1to5_e2_ckpt252,11,m_sp_arch_4x1_bt_32_roles_r500_m335,5_vs_5
2105,-6,1,f5v0to1to5_e2_ckpt252,7,m_sp_arch_4x1_bt_32_roles_r500_m335,5_vs_5
2106,-10,1,f5v0to1to5_e2_ckpt252,11,m_sp_arch_4x1_bt_32_roles_r500_m335,5_vs_5
2107,-11,0,f5v0to1to5_e2_ckpt252,11,m_sp_arch_4x1_bt_32_roles_r500_m335,5_vs_5
2108,-9,0,f5v0to1to5_e2_ckpt252,9,m_sp_arch_4x1_bt_32_roles_r500_m335,5_vs_5
2109,-9,1,f5v0to1to5_e2_ckpt252,10,m_sp_arch_4x1_bt_32_roles_r500_m335,5_vs_5
2110,3,4,checkpoints_sp_c_nb_e2_ckpt667,1,easy_bots,5_vs_5
2111,-1,0,checkpoints_sp_c_nb_e2_ckpt667,1,easy_bots,5_vs_5
2112,-2,1,checkpoints_sp_c_nb_e2_ckpt667,3,easy_bots,5_vs_5
2113,0,4,checkpoints_sp_c_nb_e2_ckpt667,4,easy_bots,5_vs_5
2114,1,2,checkpoints_sp_c_nb_e2_ckpt667,1,easy_bots,5_vs_5
2115,0,1,checkpoints_sp_c_nb_e2_ckpt667,1,easy_bots,5_vs_5
2116,3,4,checkpoints_sp_c_nb_e2_ckpt667,1,easy_bots,5_vs_5
2117,0,1,checkpoints_sp_c_nb_e2_ckpt667,1,easy_bots,5_vs_5
2118,2,3,checkpoints_sp_c_nb_e2_ckpt667,1,easy_bots,5_vs_5
2119,1,3,checkpoints_sp_c_nb_e2_ckpt667,2,easy_bots,5_vs_5
2120,0,1,checkpoints_sp_c_nb_e2_ckpt667,1,easy_bots,5_vs_5
2121,2,2,checkpoints_sp_c_nb_e2_ckpt667,0,easy_bots,5_vs_5
2122,-1,2,checkpoints_sp_c_nb_e2_ckpt667,3,easy_bots,5_vs_5
2123,1,1,checkpoints_sp_c_nb_e2_ckpt667,0,easy_bots,5_vs_5
2124,3,4,checkpoints_sp_c_nb_e2_ckpt667,1,easy_bots,5_vs_5
2125,1,2,checkpoints_sp_c_nb_e2_ckpt667,1,easy_bots,5_vs_5
2126,0,2,checkpoints_sp_c_nb_e2_ckpt667,2,easy_bots,5_vs_5
2127,0,1,checkpoints_sp_c_nb_e2_ckpt667,1,easy_bots,5_vs_5
2128,1,1,checkpoints_sp_c_nb_e2_ckpt667,0,easy_bots,5_vs_5
2129,4,4,checkpoints_sp_c_nb_e2_ckpt667,0,easy_bots,5_vs_5
2130,0,1,checkpoints_sp_c_nb_e2_ckpt667,1,medium_bots,5_vs_5_medium
2131,0,2,checkpoints_sp_c_nb_e2_ckpt667,2,medium_bots,5_vs_5_medium
2132,-2,1,checkpoints_sp_c_nb_e2_ckpt667,3,medium_bots,5_vs_5_medium
2133,0,0,checkpoints_sp_c_nb_e2_ckpt667,0,medium_bots,5_vs_5_medium
2134,-3,0,checkpoints_sp_c_nb_e2_ckpt667,3,medium_bots,5_vs_5_medium
2135,0,1,checkpoints_sp_c_nb_e2_ckpt667,1,medium_bots,5_vs_5_medium
2136,0,3,checkpoints_sp_c_nb_e2_ckpt667,3,medium_bots,5_vs_5_medium
2137,-4,0,checkpoints_sp_c_nb_e2_ckpt667,4,medium_bots,5_vs_5_medium
2138,2,2,checkpoints_sp_c_nb_e2_ckpt667,0,medium_bots,5_vs_5_medium
2139,-1,1,checkpoints_sp_c_nb_e2_ckpt667,2,medium_bots,5_vs_5_medium
2140,-3,1,checkpoints_sp_c_nb_e2_ckpt667,4,medium_bots,5_vs_5_medium
2141,0,3,checkpoints_sp_c_nb_e2_ckpt667,3,medium_bots,5_vs_5_medium
2142,-1,3,checkpoints_sp_c_nb_e2_ckpt667,4,medium_bots,5_vs_5_medium
2143,-2,1,checkpoints_sp_c_nb_e2_ckpt667,3,medium_bots,5_vs_5_medium
2144,0,3,checkpoints_sp_c_nb_e2_ckpt667,3,medium_bots,5_vs_5_medium
2145,-2,2,checkpoints_sp_c_nb_e2_ckpt667,4,medium_bots,5_vs_5_medium
2146,0,1,checkpoints_sp_c_nb_e2_ckpt667,1,medium_bots,5_vs_5_medium
2147,-3,0,checkpoints_sp_c_nb_e2_ckpt667,3,medium_bots,5_vs_5_medium
2148,-1,1,checkpoints_sp_c_nb_e2_ckpt667,2,medium_bots,5_vs_5_medium
2149,-2,2,checkpoints_sp_c_nb_e2_ckpt667,4,medium_bots,5_vs_5_medium
2150,-1,0,checkpoints_sp_c_nb_e2_ckpt667,1,hard_bots,5_vs_5_hard
2151,0,0,checkpoints_sp_c_nb_e2_ckpt667,0,hard_bots,5_vs_5_hard
2152,3,4,checkpoints_sp_c_nb_e2_ckpt667,1,hard_bots,5_vs_5_hard
2153,1,1,checkpoints_sp_c_nb_e2_ckpt667,0,hard_bots,5_vs_5_hard
2154,-1,1,checkpoints_sp_c_nb_e2_ckpt667,2,hard_bots,5_vs_5_hard
2155,0,1,checkpoints_sp_c_nb_e2_ckpt667,1,hard_bots,5_vs_5_hard
2156,0,1,checkpoints_sp_c_nb_e2_ckpt667,1,hard_bots,5_vs_5_hard
2157,-1,0,checkpoints_sp_c_nb_e2_ckpt667,1,hard_bots,5_vs_5_hard
2158,-2,1,checkpoints_sp_c_nb_e2_ckpt667,3,hard_bots,5_vs_5_hard
2159,-3,0,checkpoints_sp_c_nb_e2_ckpt667,3,hard_bots,5_vs_5_hard
2160,-1,0,checkpoints_sp_c_nb_e2_ckpt667,1,hard_bots,5_vs_5_hard
2161,0,1,checkpoints_sp_c_nb_e2_ckpt667,1,hard_bots,5_vs_5_hard
2162,1,3,checkpoints_sp_c_nb_e2_ckpt667,2,hard_bots,5_vs_5_hard
2163,0,1,checkpoints_sp_c_nb_e2_ckpt667,1,hard_bots,5_vs_5_hard
2164,-3,2,checkpoints_sp_c_nb_e2_ckpt667,5,hard_bots,5_vs_5_hard
2165,-3,0,checkpoints_sp_c_nb_e2_ckpt667,3,hard_bots,5_vs_5_hard
2166,-2,0,checkpoints_sp_c_nb_e2_ckpt667,2,hard_bots,5_vs_5_hard
2167,0,1,checkpoints_sp_c_nb_e2_ckpt667,1,hard_bots,5_vs_5_hard
2168,-4,0,checkpoints_sp_c_nb_e2_ckpt667,4,hard_bots,5_vs_5_hard
2169,-1,2,checkpoints_sp_c_nb_e2_ckpt667,3,hard_bots,5_vs_5_hard
2170,4,8,checkpoints_sp_c_nb_e2_ckpt667,4,f5v0to1to2t05_e2_ckpt291,5_vs_5
2171,2,4,checkpoints_sp_c_nb_e2_ckpt667,2,f5v0to1to2t05_e2_ckpt291,5_vs_5
2172,3,4,checkpoints_sp_c_nb_e2_ckpt667,1,f5v0to1to2t05_e2_ckpt291,5_vs_5
2173,11,13,checkpoints_sp_c_nb_e2_ckpt667,2,f5v0to1to2t05_e2_ckpt291,5_vs_5
2174,4,7,checkpoints_sp_c_nb_e2_ckpt667,3,f5v0to1to2t05_e2_ckpt291,5_vs_5
2175,1,5,checkpoints_sp_c_nb_e2_ckpt667,4,f5v0to1to2t05_e2_ckpt291,5_vs_5
2176,6,7,checkpoints_sp_c_nb_e2_ckpt667,1,f5v0to1to2t05_e2_ckpt291,5_vs_5
2177,4,7,checkpoints_sp_c_nb_e2_ckpt667,3,f5v0to1to2t05_e2_ckpt291,5_vs_5
2178,2,2,checkpoints_sp_c_nb_e2_ckpt667,0,f5v0to1to2t05_e2_ckpt291,5_vs_5
2179,6,8,checkpoints_sp_c_nb_e2_ckpt667,2,f5v0to1to2t05_e2_ckpt291,5_vs_5
2180,5,7,checkpoints_sp_c_nb_e2_ckpt667,2,f5v0to1to5_e2_ckpt252,5_vs_5
2181,5,7,checkpoints_sp_c_nb_e2_ckpt667,2,f5v0to1to5_e2_ckpt252,5_vs_5
2182,5,8,checkpoints_sp_c_nb_e2_ckpt667,3,f5v0to1to5_e2_ckpt252,5_vs_5
2183,4,5,checkpoints_sp_c_nb_e2_ckpt667,1,f5v0to1to5_e2_ckpt252,5_vs_5
2184,2,3,checkpoints_sp_c_nb_e2_ckpt667,1,f5v0to1to5_e2_ckpt252,5_vs_5
2185,0,2,checkpoints_sp_c_nb_e2_ckpt667,2,f5v0to1to5_e2_ckpt252,5_vs_5
2186,4,4,checkpoints_sp_c_nb_e2_ckpt667,0,f5v0to1to5_e2_ckpt252,5_vs_5
2187,4,5,checkpoints_sp_c_nb_e2_ckpt667,1,f5v0to1to5_e2_ckpt252,5_vs_5
2188,2,4,checkpoints_sp_c_nb_e2_ckpt667,2,f5v0to1to5_e2_ckpt252,5_vs_5
2189,5,6,checkpoints_sp_c_nb_e2_ckpt667,1,f5v0to1to5_e2_ckpt252,5_vs_5
2190,3,5,checkpoints_sp_c_nb_e2_ckpt667,2,scon_e3_p2_hard_ckpt840,5_vs_5
2191,5,5,checkpoints_sp_c_nb_e2_ckpt667,0,scon_e3_p2_hard_ckpt840,5_vs_5
2192,6,6,checkpoints_sp_c_nb_e2_ckpt667,0,scon_e3_p2_hard_ckpt840,5_vs_5
2193,9,10,checkpoints_sp_c_nb_e2_ckpt667,1,scon_e3_p2_hard_ckpt840,5_vs_5
2194,4,4,checkpoints_sp_c_nb_e2_ckpt667,0,scon_e3_p2_hard_ckpt840,5_vs_5
2195,5,6,checkpoints_sp_c_nb_e2_ckpt667,1,scon_e3_p2_hard_ckpt840,5_vs_5
2196,9,9,checkpoints_sp_c_nb_e2_ckpt667,0,scon_e3_p2_hard_ckpt840,5_vs_5
2197,7,7,checkpoints_sp_c_nb_e2_ckpt667,0,scon_e3_p2_hard_ckpt840,5_vs_5
2198,6,8,checkpoints_sp_c_nb_e2_ckpt667,2,scon_e3_p2_hard_ckpt840,5_vs_5
2199,3,5,checkpoints_sp_c_nb_e2_ckpt667,2,scon_e3_p2_hard_ckpt840,5_vs_5
2200,6,7,checkpoints_sp_c_nb_e2_ckpt667,1,less_then_partially_randomized_checkpoints_bots_4_heads_38_ckpt108,5_vs_5
2201,13,14,checkpoints_sp_c_nb_e2_ckpt667,1,less_then_partially_randomized_checkpoints_bots_4_heads_38_ckpt108,5_vs_5
2202,8,8,checkpoints_sp_c_nb_e2_ckpt667,0,less_then_partially_randomized_checkpoints_bots_4_heads_38_ckpt108,5_vs_5
2203,10,10,checkpoints_sp_c_nb_e2_ckpt667,0,less_then_partially_randomized_checkpoints_bots_4_heads_38_ckpt108,5_vs_5
2204,9,9,checkpoints_sp_c_nb_e2_ckpt667,0,less_then_partially_randomized_checkpoints_bots_4_heads_38_ckpt108,5_vs_5
2205,4,4,checkpoints_sp_c_nb_e2_ckpt667,0,less_then_partially_randomized_checkpoints_bots_4_heads_38_ckpt108,5_vs_5
2206,2,4,checkpoints_sp_c_nb_e2_ckpt667,2,less_then_partially_randomized_checkpoints_bots_4_heads_38_ckpt108,5_vs_5
2207,1,3,checkpoints_sp_c_nb_e2_ckpt667,2,less_then_partially_randomized_checkpoints_bots_4_heads_38_ckpt108,5_vs_5
2208,5,7,checkpoints_sp_c_nb_e2_ckpt667,2,less_then_partially_randomized_checkpoints_bots_4_heads_38_ckpt108,5_vs_5
2209,8,11,checkpoints_sp_c_nb_e2_ckpt667,3,less_then_partially_randomized_checkpoints_bots_4_heads_38_ckpt108,5_vs_5
2210,5,7,checkpoints_sp_c_nb_e2_ckpt667,2,less_then_partially_randomized_entropy_checkpoints_bots_4_heads_39_ckpt109,5_vs_5
2211,6,6,checkpoints_sp_c_nb_e2_ckpt667,0,less_then_partially_randomized_entropy_checkpoints_bots_4_heads_39_ckpt109,5_vs_5
2212,5,7,checkpoints_sp_c_nb_e2_ckpt667,2,less_then_partially_randomized_entropy_checkpoints_bots_4_heads_39_ckpt109,5_vs_5
2213,1,3,checkpoints_sp_c_nb_e2_ckpt667,2,less_then_partially_randomized_entropy_checkpoints_bots_4_heads_39_ckpt109,5_vs_5
2214,3,4,checkpoints_sp_c_nb_e2_ckpt667,1,less_then_partially_randomized_entropy_checkpoints_bots_4_heads_39_ckpt109,5_vs_5
2215,6,6,checkpoints_sp_c_nb_e2_ckpt667,0,less_then_partially_randomized_entropy_checkpoints_bots_4_heads_39_ckpt109,5_vs_5
2216,4,5,checkpoints_sp_c_nb_e2_ckpt667,1,less_then_partially_randomized_entropy_checkpoints_bots_4_heads_39_ckpt109,5_vs_5
2217,8,10,checkpoints_sp_c_nb_e2_ckpt667,2,less_then_partially_randomized_entropy_checkpoints_bots_4_heads_39_ckpt109,5_vs_5
2218,3,5,checkpoints_sp_c_nb_e2_ckpt667,2,less_then_partially_randomized_entropy_checkpoints_bots_4_heads_39_ckpt109,5_vs_5
2219,7,7,checkpoints_sp_c_nb_e2_ckpt667,0,less_then_partially_randomized_entropy_checkpoints_bots_4_heads_39_ckpt109,5_vs_5
2220,8,8,checkpoints_sp_c_nb_e2_ckpt667,0,reward_shaping_checkpoints_bots_4_heads_1_ckpt360,5_vs_5
2221,7,7,checkpoints_sp_c_nb_e2_ckpt667,0,reward_shaping_checkpoints_bots_4_heads_1_ckpt360,5_vs_5
2222,11,11,checkpoints_sp_c_nb_e2_ckpt667,0,reward_shaping_checkpoints_bots_4_heads_1_ckpt360,5_vs_5
2223,8,8,checkpoints_sp_c_nb_e2_ckpt667,0,reward_shaping_checkpoints_bots_4_heads_1_ckpt360,5_vs_5
2224,7,7,checkpoints_sp_c_nb_e2_ckpt667,0,reward_shaping_checkpoints_bots_4_heads_1_ckpt360,5_vs_5
2225,12,12,checkpoints_sp_c_nb_e2_ckpt667,0,reward_shaping_checkpoints_bots_4_heads_1_ckpt360,5_vs_5
2226,8,9,checkpoints_sp_c_nb_e2_ckpt667,1,reward_shaping_checkpoints_bots_4_heads_1_ckpt360,5_vs_5
2227,5,7,checkpoints_sp_c_nb_e2_ckpt667,2,reward_shaping_checkpoints_bots_4_heads_1_ckpt360,5_vs_5
2228,1,1,checkpoints_sp_c_nb_e2_ckpt667,0,reward_shaping_checkpoints_bots_4_heads_1_ckpt360,5_vs_5
2229,6,7,checkpoints_sp_c_nb_e2_ckpt667,1,reward_shaping_checkpoints_bots_4_heads_1_ckpt360,5_vs_5
2230,3,6,checkpoints_sp_c_nb_e2_ckpt667,3,checkpoints_selfplay_e9_sp_ckpt274,5_vs_5
2231,6,7,checkpoints_sp_c_nb_e2_ckpt667,1,checkpoints_selfplay_e9_sp_ckpt274,5_vs_5
2232,4,5,checkpoints_sp_c_nb_e2_ckpt667,1,checkpoints_selfplay_e9_sp_ckpt274,5_vs_5
2233,1,4,checkpoints_sp_c_nb_e2_ckpt667,3,checkpoints_selfplay_e9_sp_ckpt274,5_vs_5
2234,1,4,checkpoints_sp_c_nb_e2_ckpt667,3,checkpoints_selfplay_e9_sp_ckpt274,5_vs_5
2235,1,3,checkpoints_sp_c_nb_e2_ckpt667,2,checkpoints_selfplay_e9_sp_ckpt274,5_vs_5
2236,4,7,checkpoints_sp_c_nb_e2_ckpt667,3,checkpoints_selfplay_e9_sp_ckpt274,5_vs_5
2237,4,6,checkpoints_sp_c_nb_e2_ckpt667,2,checkpoints_selfplay_e9_sp_ckpt274,5_vs_5
2238,2,6,checkpoints_sp_c_nb_e2_ckpt667,4,checkpoints_selfplay_e9_sp_ckpt274,5_vs_5
2239,-2,2,checkpoints_sp_c_nb_e2_ckpt667,4,checkpoints_selfplay_e9_sp_ckpt274,5_vs_5
2240,4,6,checkpoints_sp_c_nb_e2_ckpt667,2,checkpoints_sp_c_nb_e2_ckpt667,5_vs_5
2241,-2,0,checkpoints_sp_c_nb_e2_ckpt667,2,checkpoints_sp_c_nb_e2_ckpt667,5_vs_5
2242,-2,2,checkpoints_sp_c_nb_e2_ckpt667,4,checkpoints_sp_c_nb_e2_ckpt667,5_vs_5
2243,-1,2,checkpoints_sp_c_nb_e2_ckpt667,3,checkpoints_sp_c_nb_e2_ckpt667,5_vs_5
2244,-1,2,checkpoints_sp_c_nb_e2_ckpt667,3,checkpoints_sp_c_nb_e2_ckpt667,5_vs_5
2245,0,3,checkpoints_sp_c_nb_e2_ckpt667,3,checkpoints_sp_c_nb_e2_ckpt667,5_vs_5
2246,-1,2,checkpoints_sp_c_nb_e2_ckpt667,3,checkpoints_sp_c_nb_e2_ckpt667,5_vs_5
2247,-3,1,checkpoints_sp_c_nb_e2_ckpt667,4,checkpoints_sp_c_nb_e2_ckpt667,5_vs_5
2248,-3,5,checkpoints_sp_c_nb_e2_ckpt667,8,checkpoints_sp_c_nb_e2_ckpt667,5_vs_5
2249,2,4,checkpoints_sp_c_nb_e2_ckpt667,2,checkpoints_sp_c_nb_e2_ckpt667,5_vs_5
2250,10,10,checkpoints_sp_c_nb_e2_ckpt667,0,scenario_curriculum_ckpt830,5_vs_5
2251,7,7,checkpoints_sp_c_nb_e2_ckpt667,0,scenario_curriculum_ckpt830,5_vs_5
2252,4,4,checkpoints_sp_c_nb_e2_ckpt667,0,scenario_curriculum_ckpt830,5_vs_5
2253,2,2,checkpoints_sp_c_nb_e2_ckpt667,0,scenario_curriculum_ckpt830,5_vs_5
2254,6,6,checkpoints_sp_c_nb_e2_ckpt667,0,scenario_curriculum_ckpt830,5_vs_5
2255,5,5,checkpoints_sp_c_nb_e2_ckpt667,0,scenario_curriculum_ckpt830,5_vs_5
2256,8,8,checkpoints_sp_c_nb_e2_ckpt667,0,scenario_curriculum_ckpt830,5_vs_5
2257,6,6,checkpoints_sp_c_nb_e2_ckpt667,0,scenario_curriculum_ckpt830,5_vs_5
2258,7,7,checkpoints_sp_c_nb_e2_ckpt667,0,scenario_curriculum_ckpt830,5_vs_5
2259,6,6,checkpoints_sp_c_nb_e2_ckpt667,0,scenario_curriculum_ckpt830,5_vs_5
2260,2,3,checkpoints_sp_c_nb_e2_ckpt667,1,m_sp_arch_medium_heads_conv16_0_bt_32_r313_m335,5_vs_5
2261,2,3,checkpoints_sp_c_nb_e2_ckpt667,1,m_sp_arch_medium_heads_conv16_0_bt_32_r313_m335,5_vs_5
2262,6,9,checkpoints_sp_c_nb_e2_ckpt667,3,m_sp_arch_medium_heads_conv16_0_bt_32_r313_m335,5_vs_5
2263,4,6,checkpoints_sp_c_nb_e2_ckpt667,2,m_sp_arch_medium_heads_conv16_0_bt_32_r313_m335,5_vs_5
2264,5,6,checkpoints_sp_c_nb_e2_ckpt667,1,m_sp_arch_medium_heads_conv16_0_bt_32_r313_m335,5_vs_5
2265,5,6,checkpoints_sp_c_nb_e2_ckpt667,1,m_sp_arch_medium_heads_conv16_0_bt_32_r313_m335,5_vs_5
2266,2,4,checkpoints_sp_c_nb_e2_ckpt667,2,m_sp_arch_medium_heads_conv16_0_bt_32_r313_m335,5_vs_5
2267,6,8,checkpoints_sp_c_nb_e2_ckpt667,2,m_sp_arch_medium_heads_conv16_0_bt_32_r313_m335,5_vs_5
2268,4,6,checkpoints_sp_c_nb_e2_ckpt667,2,m_sp_arch_medium_heads_conv16_0_bt_32_r313_m335,5_vs_5
2269,4,6,checkpoints_sp_c_nb_e2_ckpt667,2,m_sp_arch_medium_heads_conv16_0_bt_32_r313_m335,5_vs_5
2270,3,4,checkpoints_sp_c_nb_e2_ckpt667,1,m_sp_arch_longer_heads_bt_32_r201_m335,5_vs_5
2271,0,1,checkpoints_sp_c_nb_e2_ckpt667,1,m_sp_arch_longer_heads_bt_32_r201_m335,5_vs_5
2272,4,7,checkpoints_sp_c_nb_e2_ckpt667,3,m_sp_arch_longer_heads_bt_32_r201_m335,5_vs_5
2273,0,1,checkpoints_sp_c_nb_e2_ckpt667,1,m_sp_arch_longer_heads_bt_32_r201_m335,5_vs_5
2274,1,3,checkpoints_sp_c_nb_e2_ckpt667,2,m_sp_arch_longer_heads_bt_32_r201_m335,5_vs_5
2275,0,5,checkpoints_sp_c_nb_e2_ckpt667,5,m_sp_arch_longer_heads_bt_32_r201_m335,5_vs_5
2276,3,4,checkpoints_sp_c_nb_e2_ckpt667,1,m_sp_arch_longer_heads_bt_32_r201_m335,5_vs_5
2277,6,7,checkpoints_sp_c_nb_e2_ckpt667,1,m_sp_arch_longer_heads_bt_32_r201_m335,5_vs_5
2278,4,5,checkpoints_sp_c_nb_e2_ckpt667,1,m_sp_arch_longer_heads_bt_32_r201_m335,5_vs_5
2279,0,2,checkpoints_sp_c_nb_e2_ckpt667,2,m_sp_arch_longer_heads_bt_32_r201_m335,5_vs_5
2280,4,6,checkpoints_sp_c_nb_e2_ckpt667,2,m_sp_arch_medium_heads_bt_32_r201_m335,5_vs_5
2281,8,8,checkpoints_sp_c_nb_e2_ckpt667,0,m_sp_arch_medium_heads_bt_32_r201_m335,5_vs_5
2282,6,7,checkpoints_sp_c_nb_e2_ckpt667,1,m_sp_arch_medium_heads_bt_32_r201_m335,5_vs_5
2283,6,6,checkpoints_sp_c_nb_e2_ckpt667,0,m_sp_arch_medium_heads_bt_32_r201_m335,5_vs_5
2284,0,2,checkpoints_sp_c_nb_e2_ckpt667,2,m_sp_arch_medium_heads_bt_32_r201_m335,5_vs_5
2285,5,5,checkpoints_sp_c_nb_e2_ckpt667,0,m_sp_arch_medium_heads_bt_32_r201_m335,5_vs_5
2286,5,6,checkpoints_sp_c_nb_e2_ckpt667,1,m_sp_arch_medium_heads_bt_32_r201_m335,5_vs_5
2287,6,7,checkpoints_sp_c_nb_e2_ckpt667,1,m_sp_arch_medium_heads_bt_32_r201_m335,5_vs_5
2288,3,5,checkpoints_sp_c_nb_e2_ckpt667,2,m_sp_arch_medium_heads_bt_32_r201_m335,5_vs_5
2289,2,6,checkpoints_sp_c_nb_e2_ckpt667,4,m_sp_arch_medium_heads_bt_32_r201_m335,5_vs_5
2290,-4,2,checkpoints_sp_c_nb_e2_ckpt667,6,m_sp_arch_4x1_bt_32_r201_m335,5_vs_5
2291,0,3,checkpoints_sp_c_nb_e2_ckpt667,3,m_sp_arch_4x1_bt_32_r201_m335,5_vs_5
2292,-3,1,checkpoints_sp_c_nb_e2_ckpt667,4,m_sp_arch_4x1_bt_32_r201_m335,5_vs_5
2293,-1,1,checkpoints_sp_c_nb_e2_ckpt667,2,m_sp_arch_4x1_bt_32_r201_m335,5_vs_5
2294,-3,2,checkpoints_sp_c_nb_e2_ckpt667,5,m_sp_arch_4x1_bt_32_r201_m335,5_vs_5
2295,-3,1,checkpoints_sp_c_nb_e2_ckpt667,4,m_sp_arch_4x1_bt_32_r201_m335,5_vs_5
2296,-2,1,checkpoints_sp_c_nb_e2_ckpt667,3,m_sp_arch_4x1_bt_32_r201_m335,5_vs_5
2297,-3,1,checkpoints_sp_c_nb_e2_ckpt667,4,m_sp_arch_4x1_bt_32_r201_m335,5_vs_5
2298,-1,2,checkpoints_sp_c_nb_e2_ckpt667,3,m_sp_arch_4x1_bt_32_r201_m335,5_vs_5
2299,-2,3,checkpoints_sp_c_nb_e2_ckpt667,5,m_sp_arch_4x1_bt_32_r201_m335,5_vs_5
2300,-4,2,checkpoints_sp_c_nb_e2_ckpt667,6,m_sp_arch_4x1_bt_32_r201_cont3_m650,5_vs_5
2301,-5,0,checkpoints_sp_c_nb_e2_ckpt667,5,m_sp_arch_4x1_bt_32_r201_cont3_m650,5_vs_5
2302,0,1,checkpoints_sp_c_nb_e2_ckpt667,1,m_sp_arch_4x1_bt_32_r201_cont3_m650,5_vs_5
2303,-3,1,checkpoints_sp_c_nb_e2_ckpt667,4,m_sp_arch_4x1_bt_32_r201_cont3_m650,5_vs_5
2304,-4,0,checkpoints_sp_c_nb_e2_ckpt667,4,m_sp_arch_4x1_bt_32_r201_cont3_m650,5_vs_5
2305,-4,0,checkpoints_sp_c_nb_e2_ckpt667,4,m_sp_arch_4x1_bt_32_r201_cont3_m650,5_vs_5
2306,-4,1,checkpoints_sp_c_nb_e2_ckpt667,5,m_sp_arch_4x1_bt_32_r201_cont3_m650,5_vs_5
2307,0,2,checkpoints_sp_c_nb_e2_ckpt667,2,m_sp_arch_4x1_bt_32_r201_cont3_m650,5_vs_5
2308,-1,1,checkpoints_sp_c_nb_e2_ckpt667,2,m_sp_arch_4x1_bt_32_r201_cont3_m650,5_vs_5
2309,-3,0,checkpoints_sp_c_nb_e2_ckpt667,3,m_sp_arch_4x1_bt_32_r201_cont3_m650,5_vs_5
2310,-3,0,checkpoints_sp_c_nb_e2_ckpt667,3,explt_v0_7_2_m54,5_vs_5
2311,-2,1,checkpoints_sp_c_nb_e2_ckpt667,3,explt_v0_7_2_m54,5_vs_5
2312,0,2,checkpoints_sp_c_nb_e2_ckpt667,2,explt_v0_7_2_m54,5_vs_5
2313,1,1,checkpoints_sp_c_nb_e2_ckpt667,0,explt_v0_7_2_m54,5_vs_5
2314,-2,0,checkpoints_sp_c_nb_e2_ckpt667,2,explt_v0_7_2_m54,5_vs_5
2315,-1,0,checkpoints_sp_c_nb_e2_ckpt667,1,explt_v0_7_2_m54,5_vs_5
2316,-3,0,checkpoints_sp_c_nb_e2_ckpt667,3,explt_v0_7_2_m54,5_vs_5
2317,-1,1,checkpoints_sp_c_nb_e2_ckpt667,2,explt_v0_7_2_m54,5_vs_5
2318,-3,0,checkpoints_sp_c_nb_e2_ckpt667,3,explt_v0_7_2_m54,5_vs_5
2319,0,2,checkpoints_sp_c_nb_e2_ckpt667,2,explt_v0_7_2_m54,5_vs_5
2320,-2,1,checkpoints_sp_c_nb_e2_ckpt667,3,m_sp_sc3v3_arch_2x1_32_r500_cont4x1_m224,5_vs_5
2321,1,1,checkpoints_sp_c_nb_e2_ckpt667,0,m_sp_sc3v3_arch_2x1_32_r500_cont4x1_m224,5_vs_5
2322,0,5,checkpoints_sp_c_nb_e2_ckpt667,5,m_sp_sc3v3_arch_2x1_32_r500_cont4x1_m224,5_vs_5
2323,-1,2,checkpoints_sp_c_nb_e2_ckpt667,3,m_sp_sc3v3_arch_2x1_32_r500_cont4x1_m224,5_vs_5
2324,-2,3,checkpoints_sp_c_nb_e2_ckpt667,5,m_sp_sc3v3_arch_2x1_32_r500_cont4x1_m224,5_vs_5
2325,-8,2,checkpoints_sp_c_nb_e2_ckpt667,10,m_sp_sc3v3_arch_2x1_32_r500_cont4x1_m224,5_vs_5
2326,-4,1,checkpoints_sp_c_nb_e2_ckpt667,5,m_sp_sc3v3_arch_2x1_32_r500_cont4x1_m224,5_vs_5
2327,-2,2,checkpoints_sp_c_nb_e2_ckpt667,4,m_sp_sc3v3_arch_2x1_32_r500_cont4x1_m224,5_vs_5
2328,-1,4,checkpoints_sp_c_nb_e2_ckpt667,5,m_sp_sc3v3_arch_2x1_32_r500_cont4x1_m224,5_vs_5
2329,-4,1,checkpoints_sp_c_nb_e2_ckpt667,5,m_sp_sc3v3_arch_2x1_32_r500_cont4x1_m224,5_vs_5
2330,1,1,checkpoints_sp_c_nb_e2_ckpt667,0,m_sp_arch_4x1_bt_32_roles_r500_m335,5_vs_5
2331,-5,0,checkpoints_sp_c_nb_e2_ckpt667,5,m_sp_arch_4x1_bt_32_roles_r500_m335,5_vs_5
2332,-8,0,checkpoints_sp_c_nb_e2_ckpt667,8,m_sp_arch_4x1_bt_32_roles_r500_m335,5_vs_5
2333,-2,2,checkpoints_sp_c_nb_e2_ckpt667,4,m_sp_arch_4x1_bt_32_roles_r500_m335,5_vs_5
2334,-3,0,checkpoints_sp_c_nb_e2_ckpt667,3,m_sp_arch_4x1_bt_32_roles_r500_m335,5_vs_5
2335,-2,0,checkpoints_sp_c_nb_e2_ckpt667,2,m_sp_arch_4x1_bt_32_roles_r500_m335,5_vs_5
2336,2,4,checkpoints_sp_c_nb_e2_ckpt667,2,m_sp_arch_4x1_bt_32_roles_r500_m335,5_vs_5
2337,-2,2,checkpoints_sp_c_nb_e2_ckpt667,4,m_sp_arch_4x1_bt_32_roles_r500_m335,5_vs_5
2338,2,6,checkpoints_sp_c_nb_e2_ckpt667,4,m_sp_arch_4x1_bt_32_roles_r500_m335,5_vs_5
2339,3,4,checkpoints_sp_c_nb_e2_ckpt667,1,m_sp_arch_4x1_bt_32_roles_r500_m335,5_vs_5
2340,17,17,scenario_curriculum_ckpt639_nnm,0,easy_bots,5_vs_5
2341,11,12,scenario_curriculum_ckpt639_nnm,1,easy_bots,5_vs_5
2342,11,11,scenario_curriculum_ckpt639_nnm,0,easy_bots,5_vs_5
2343,12,13,scenario_curriculum_ckpt639_nnm,1,easy_bots,5_vs_5
2344,14,14,scenario_curriculum_ckpt639_nnm,0,easy_bots,5_vs_5
2345,17,17,scenario_curriculum_ckpt639_nnm,0,easy_bots,5_vs_5
2346,8,8,scenario_curriculum_ckpt639_nnm,0,easy_bots,5_vs_5
2347,13,14,scenario_curriculum_ckpt639_nnm,1,easy_bots,5_vs_5
2348,7,10,scenario_curriculum_ckpt639_nnm,3,easy_bots,5_vs_5
2349,14,14,scenario_curriculum_ckpt639_nnm,0,easy_bots,5_vs_5
2350,4,5,scenario_curriculum_ckpt639_nnm,1,easy_bots,5_vs_5
2351,14,15,scenario_curriculum_ckpt639_nnm,1,easy_bots,5_vs_5
2352,8,8,scenario_curriculum_ckpt639_nnm,0,easy_bots,5_vs_5
2353,13,13,scenario_curriculum_ckpt639_nnm,0,easy_bots,5_vs_5
2354,9,11,scenario_curriculum_ckpt639_nnm,2,easy_bots,5_vs_5
2355,13,14,scenario_curriculum_ckpt639_nnm,1,easy_bots,5_vs_5
2356,17,17,scenario_curriculum_ckpt639_nnm,0,easy_bots,5_vs_5
2357,12,12,scenario_curriculum_ckpt639_nnm,0,easy_bots,5_vs_5
2358,5,6,scenario_curriculum_ckpt639_nnm,1,easy_bots,5_vs_5
2359,4,7,scenario_curriculum_ckpt639_nnm,3,easy_bots,5_vs_5
2360,8,9,scenario_curriculum_ckpt639_nnm,1,medium_bots,5_vs_5_medium
2361,3,5,scenario_curriculum_ckpt639_nnm,2,medium_bots,5_vs_5_medium
2362,10,10,scenario_curriculum_ckpt639_nnm,0,medium_bots,5_vs_5_medium
2363,4,5,scenario_curriculum_ckpt639_nnm,1,medium_bots,5_vs_5_medium
2364,2,3,scenario_curriculum_ckpt639_nnm,1,medium_bots,5_vs_5_medium
2365,8,8,scenario_curriculum_ckpt639_nnm,0,medium_bots,5_vs_5_medium
2366,5,5,scenario_curriculum_ckpt639_nnm,0,medium_bots,5_vs_5_medium
2367,3,5,scenario_curriculum_ckpt639_nnm,2,medium_bots,5_vs_5_medium
2368,5,5,scenario_curriculum_ckpt639_nnm,0,medium_bots,5_vs_5_medium
2369,-1,0,scenario_curriculum_ckpt639_nnm,1,medium_bots,5_vs_5_medium
2370,4,5,scenario_curriculum_ckpt639_nnm,1,medium_bots,5_vs_5_medium
2371,5,5,scenario_curriculum_ckpt639_nnm,0,medium_bots,5_vs_5_medium
2372,0,1,scenario_curriculum_ckpt639_nnm,1,medium_bots,5_vs_5_medium
2373,0,0,scenario_curriculum_ckpt639_nnm,0,medium_bots,5_vs_5_medium
2374,6,7,scenario_curriculum_ckpt639_nnm,1,medium_bots,5_vs_5_medium
2375,1,1,scenario_curriculum_ckpt639_nnm,0,medium_bots,5_vs_5_medium
2376,2,2,scenario_curriculum_ckpt639_nnm,0,medium_bots,5_vs_5_medium
2377,1,1,scenario_curriculum_ckpt639_nnm,0,medium_bots,5_vs_5_medium
2378,4,4,scenario_curriculum_ckpt639_nnm,0,medium_bots,5_vs_5_medium
2379,8,10,scenario_curriculum_ckpt639_nnm,2,medium_bots,5_vs_5_medium
2380,2,5,scenario_curriculum_ckpt639_nnm,3,hard_bots,5_vs_5_hard
2381,1,2,scenario_curriculum_ckpt639_nnm,1,hard_bots,5_vs_5_hard
2382,4,6,scenario_curriculum_ckpt639_nnm,2,hard_bots,5_vs_5_hard
2383,4,4,scenario_curriculum_ckpt639_nnm,0,hard_bots,5_vs_5_hard
2384,2,3,scenario_curriculum_ckpt639_nnm,1,hard_bots,5_vs_5_hard
2385,3,4,scenario_curriculum_ckpt639_nnm,1,hard_bots,5_vs_5_hard
2386,2,5,scenario_curriculum_ckpt639_nnm,3,hard_bots,5_vs_5_hard
2387,2,4,scenario_curriculum_ckpt639_nnm,2,hard_bots,5_vs_5_hard
2388,8,8,scenario_curriculum_ckpt639_nnm,0,hard_bots,5_vs_5_hard
2389,0,0,scenario_curriculum_ckpt639_nnm,0,hard_bots,5_vs_5_hard
2390,4,4,scenario_curriculum_ckpt639_nnm,0,hard_bots,5_vs_5_hard
2391,-2,1,scenario_curriculum_ckpt639_nnm,3,hard_bots,5_vs_5_hard
2392,6,8,scenario_curriculum_ckpt639_nnm,2,hard_bots,5_vs_5_hard
2393,1,4,scenario_curriculum_ckpt639_nnm,3,hard_bots,5_vs_5_hard
2394,2,3,scenario_curriculum_ckpt639_nnm,1,hard_bots,5_vs_5_hard
2395,1,2,scenario_curriculum_ckpt639_nnm,1,hard_bots,5_vs_5_hard
2396,1,2,scenario_curriculum_ckpt639_nnm,1,hard_bots,5_vs_5_hard
2397,1,3,scenario_curriculum_ckpt639_nnm,2,hard_bots,5_vs_5_hard
2398,5,7,scenario_curriculum_ckpt639_nnm,2,hard_bots,5_vs_5_hard
2399,1,2,scenario_curriculum_ckpt639_nnm,1,hard_bots,5_vs_5_hard
2400,-4,1,scenario_curriculum_ckpt639_nnm,5,f5v0to1to2t05_e2_ckpt291,5_vs_5
2401,3,4,scenario_curriculum_ckpt639_nnm,1,f5v0to1to2t05_e2_ckpt291,5_vs_5
2402,4,6,scenario_curriculum_ckpt639_nnm,2,f5v0to1to2t05_e2_ckpt291,5_vs_5
2403,2,5,scenario_curriculum_ckpt639_nnm,3,f5v0to1to2t05_e2_ckpt291,5_vs_5
2404,6,8,scenario_curriculum_ckpt639_nnm,2,f5v0to1to2t05_e2_ckpt291,5_vs_5
2405,0,3,scenario_curriculum_ckpt639_nnm,3,f5v0to1to2t05_e2_ckpt291,5_vs_5
2406,1,3,scenario_curriculum_ckpt639_nnm,2,f5v0to1to2t05_e2_ckpt291,5_vs_5
2407,0,0,scenario_curriculum_ckpt639_nnm,0,f5v0to1to2t05_e2_ckpt291,5_vs_5
2408,2,4,scenario_curriculum_ckpt639_nnm,2,f5v0to1to2t05_e2_ckpt291,5_vs_5
2409,-2,1,scenario_curriculum_ckpt639_nnm,3,f5v0to1to2t05_e2_ckpt291,5_vs_5
2410,1,3,scenario_curriculum_ckpt639_nnm,2,f5v0to1to2t05_e2_ckpt291,5_vs_5
2411,2,6,scenario_curriculum_ckpt639_nnm,4,f5v0to1to2t05_e2_ckpt291,5_vs_5
2412,2,5,scenario_curriculum_ckpt639_nnm,3,f5v0to1to2t05_e2_ckpt291,5_vs_5
2413,5,7,scenario_curriculum_ckpt639_nnm,2,f5v0to1to2t05_e2_ckpt291,5_vs_5
2414,3,4,scenario_curriculum_ckpt639_nnm,1,f5v0to1to2t05_e2_ckpt291,5_vs_5
2415,4,5,scenario_curriculum_ckpt639_nnm,1,f5v0to1to2t05_e2_ckpt291,5_vs_5
2416,0,3,scenario_curriculum_ckpt639_nnm,3,f5v0to1to2t05_e2_ckpt291,5_vs_5
2417,-1,1,scenario_curriculum_ckpt639_nnm,2,f5v0to1to2t05_e2_ckpt291,5_vs_5
2418,-1,1,scenario_curriculum_ckpt639_nnm,2,f5v0to1to2t05_e2_ckpt291,5_vs_5
2419,0,4,scenario_curriculum_ckpt639_nnm,4,f5v0to1to2t05_e2_ckpt291,5_vs_5
2420,6,7,scenario_curriculum_ckpt639_nnm,1,f5v0to1to5_e2_ckpt252,5_vs_5
2421,0,3,scenario_curriculum_ckpt639_nnm,3,f5v0to1to5_e2_ckpt252,5_vs_5
2422,2,6,scenario_curriculum_ckpt639_nnm,4,f5v0to1to5_e2_ckpt252,5_vs_5
2423,-1,3,scenario_curriculum_ckpt639_nnm,4,f5v0to1to5_e2_ckpt252,5_vs_5
2424,0,1,scenario_curriculum_ckpt639_nnm,1,f5v0to1to5_e2_ckpt252,5_vs_5
2425,-2,3,scenario_curriculum_ckpt639_nnm,5,f5v0to1to5_e2_ckpt252,5_vs_5
2426,-2,2,scenario_curriculum_ckpt639_nnm,4,f5v0to1to5_e2_ckpt252,5_vs_5
2427,0,6,scenario_curriculum_ckpt639_nnm,6,f5v0to1to5_e2_ckpt252,5_vs_5
2428,-2,1,scenario_curriculum_ckpt639_nnm,3,f5v0to1to5_e2_ckpt252,5_vs_5
2429,2,4,scenario_curriculum_ckpt639_nnm,2,f5v0to1to5_e2_ckpt252,5_vs_5
2430,1,5,scenario_curriculum_ckpt639_nnm,4,f5v0to1to5_e2_ckpt252,5_vs_5
2431,0,2,scenario_curriculum_ckpt639_nnm,2,f5v0to1to5_e2_ckpt252,5_vs_5
2432,2,6,scenario_curriculum_ckpt639_nnm,4,f5v0to1to5_e2_ckpt252,5_vs_5
2433,0,3,scenario_curriculum_ckpt639_nnm,3,f5v0to1to5_e2_ckpt252,5_vs_5
2434,2,3,scenario_curriculum_ckpt639_nnm,1,f5v0to1to5_e2_ckpt252,5_vs_5
2435,0,3,scenario_curriculum_ckpt639_nnm,3,f5v0to1to5_e2_ckpt252,5_vs_5
2436,2,6,scenario_curriculum_ckpt639_nnm,4,f5v0to1to5_e2_ckpt252,5_vs_5
2437,-1,5,scenario_curriculum_ckpt639_nnm,6,f5v0to1to5_e2_ckpt252,5_vs_5
2438,0,2,scenario_curriculum_ckpt639_nnm,2,f5v0to1to5_e2_ckpt252,5_vs_5
2439,-2,3,scenario_curriculum_ckpt639_nnm,5,f5v0to1to5_e2_ckpt252,5_vs_5
2440,4,5,scenario_curriculum_ckpt639_nnm,1,scon_e3_p2_hard_ckpt840,5_vs_5
2441,1,2,scenario_curriculum_ckpt639_nnm,1,scon_e3_p2_hard_ckpt840,5_vs_5
2442,1,2,scenario_curriculum_ckpt639_nnm,1,scon_e3_p2_hard_ckpt840,5_vs_5
2443,2,3,scenario_curriculum_ckpt639_nnm,1,scon_e3_p2_hard_ckpt840,5_vs_5
2444,5,5,scenario_curriculum_ckpt639_nnm,0,scon_e3_p2_hard_ckpt840,5_vs_5
2445,2,2,scenario_curriculum_ckpt639_nnm,0,scon_e3_p2_hard_ckpt840,5_vs_5
2446,-2,1,scenario_curriculum_ckpt639_nnm,3,scon_e3_p2_hard_ckpt840,5_vs_5
2447,2,4,scenario_curriculum_ckpt639_nnm,2,scon_e3_p2_hard_ckpt840,5_vs_5
2448,0,1,scenario_curriculum_ckpt639_nnm,1,scon_e3_p2_hard_ckpt840,5_vs_5
2449,0,0,scenario_curriculum_ckpt639_nnm,0,scon_e3_p2_hard_ckpt840,5_vs_5
2450,2,5,scenario_curriculum_ckpt639_nnm,3,scon_e3_p2_hard_ckpt840,5_vs_5
2451,-3,1,scenario_curriculum_ckpt639_nnm,4,scon_e3_p2_hard_ckpt840,5_vs_5
2452,5,5,scenario_curriculum_ckpt639_nnm,0,scon_e3_p2_hard_ckpt840,5_vs_5
2453,2,3,scenario_curriculum_ckpt639_nnm,1,scon_e3_p2_hard_ckpt840,5_vs_5
2454,3,4,scenario_curriculum_ckpt639_nnm,1,scon_e3_p2_hard_ckpt840,5_vs_5
2455,1,6,scenario_curriculum_ckpt639_nnm,5,scon_e3_p2_hard_ckpt840,5_vs_5
2456,3,3,scenario_curriculum_ckpt639_nnm,0,scon_e3_p2_hard_ckpt840,5_vs_5
2457,0,2,scenario_curriculum_ckpt639_nnm,2,scon_e3_p2_hard_ckpt840,5_vs_5
2458,-1,2,scenario_curriculum_ckpt639_nnm,3,scon_e3_p2_hard_ckpt840,5_vs_5
2459,0,1,scenario_curriculum_ckpt639_nnm,1,scon_e3_p2_hard_ckpt840,5_vs_5
2460,3,4,scenario_curriculum_ckpt639_nnm,1,less_then_partially_randomized_checkpoints_bots_4_heads_38_ckpt108,5_vs_5
2461,2,6,scenario_curriculum_ckpt639_nnm,4,less_then_partially_randomized_checkpoints_bots_4_heads_38_ckpt108,5_vs_5
2462,5,6,scenario_curriculum_ckpt639_nnm,1,less_then_partially_randomized_checkpoints_bots_4_heads_38_ckpt108,5_vs_5
2463,0,1,scenario_curriculum_ckpt639_nnm,1,less_then_partially_randomized_checkpoints_bots_4_heads_38_ckpt108,5_vs_5
2464,3,5,scenario_curriculum_ckpt639_nnm,2,less_then_partially_randomized_checkpoints_bots_4_heads_38_ckpt108,5_vs_5
2465,-1,3,scenario_curriculum_ckpt639_nnm,4,less_then_partially_randomized_checkpoints_bots_4_heads_38_ckpt108,5_vs_5
2466,2,6,scenario_curriculum_ckpt639_nnm,4,less_then_partially_randomized_checkpoints_bots_4_heads_38_ckpt108,5_vs_5
2467,3,6,scenario_curriculum_ckpt639_nnm,3,less_then_partially_randomized_checkpoints_bots_4_heads_38_ckpt108,5_vs_5
2468,3,7,scenario_curriculum_ckpt639_nnm,4,less_then_partially_randomized_checkpoints_bots_4_heads_38_ckpt108,5_vs_5
2469,3,4,scenario_curriculum_ckpt639_nnm,1,less_then_partially_randomized_checkpoints_bots_4_heads_38_ckpt108,5_vs_5
2470,1,5,scenario_curriculum_ckpt639_nnm,4,less_then_partially_randomized_checkpoints_bots_4_heads_38_ckpt108,5_vs_5
2471,3,6,scenario_curriculum_ckpt639_nnm,3,less_then_partially_randomized_checkpoints_bots_4_heads_38_ckpt108,5_vs_5
2472,3,6,scenario_curriculum_ckpt639_nnm,3,less_then_partially_randomized_checkpoints_bots_4_heads_38_ckpt108,5_vs_5
2473,0,5,scenario_curriculum_ckpt639_nnm,5,less_then_partially_randomized_checkpoints_bots_4_heads_38_ckpt108,5_vs_5
2474,2,8,scenario_curriculum_ckpt639_nnm,6,less_then_partially_randomized_checkpoints_bots_4_heads_38_ckpt108,5_vs_5
2475,2,5,scenario_curriculum_ckpt639_nnm,3,less_then_partially_randomized_checkpoints_bots_4_heads_38_ckpt108,5_vs_5
2476,3,6,scenario_curriculum_ckpt639_nnm,3,less_then_partially_randomized_checkpoints_bots_4_heads_38_ckpt108,5_vs_5
2477,1,4,scenario_curriculum_ckpt639_nnm,3,less_then_partially_randomized_checkpoints_bots_4_heads_38_ckpt108,5_vs_5
2478,2,6,scenario_curriculum_ckpt639_nnm,4,less_then_partially_randomized_checkpoints_bots_4_heads_38_ckpt108,5_vs_5
2479,1,4,scenario_curriculum_ckpt639_nnm,3,less_then_partially_randomized_checkpoints_bots_4_heads_38_ckpt108,5_vs_5
2480,1,4,scenario_curriculum_ckpt639_nnm,3,less_then_partially_randomized_entropy_checkpoints_bots_4_heads_39_ckpt109,5_vs_5
2481,2,3,scenario_curriculum_ckpt639_nnm,1,less_then_partially_randomized_entropy_checkpoints_bots_4_heads_39_ckpt109,5_vs_5
2482,3,5,scenario_curriculum_ckpt639_nnm,2,less_then_partially_randomized_entropy_checkpoints_bots_4_heads_39_ckpt109,5_vs_5
2483,-2,4,scenario_curriculum_ckpt639_nnm,6,less_then_partially_randomized_entropy_checkpoints_bots_4_heads_39_ckpt109,5_vs_5
2484,3,5,scenario_curriculum_ckpt639_nnm,2,less_then_partially_randomized_entropy_checkpoints_bots_4_heads_39_ckpt109,5_vs_5
2485,3,5,scenario_curriculum_ckpt639_nnm,2,less_then_partially_randomized_entropy_checkpoints_bots_4_heads_39_ckpt109,5_vs_5
2486,4,8,scenario_curriculum_ckpt639_nnm,4,less_then_partially_randomized_entropy_checkpoints_bots_4_heads_39_ckpt109,5_vs_5
2487,-2,3,scenario_curriculum_ckpt639_nnm,5,less_then_partially_randomized_entropy_checkpoints_bots_4_heads_39_ckpt109,5_vs_5
2488,5,7,scenario_curriculum_ckpt639_nnm,2,less_then_partially_randomized_entropy_checkpoints_bots_4_heads_39_ckpt109,5_vs_5
2489,0,4,scenario_curriculum_ckpt639_nnm,4,less_then_partially_randomized_entropy_checkpoints_bots_4_heads_39_ckpt109,5_vs_5
2490,-1,3,scenario_curriculum_ckpt639_nnm,4,less_then_partially_randomized_entropy_checkpoints_bots_4_heads_39_ckpt109,5_vs_5
2491,-4,2,scenario_curriculum_ckpt639_nnm,6,less_then_partially_randomized_entropy_checkpoints_bots_4_heads_39_ckpt109,5_vs_5
2492,-1,2,scenario_curriculum_ckpt639_nnm,3,less_then_partially_randomized_entropy_checkpoints_bots_4_heads_39_ckpt109,5_vs_5
2493,1,4,scenario_curriculum_ckpt639_nnm,3,less_then_partially_randomized_entropy_checkpoints_bots_4_heads_39_ckpt109,5_vs_5
2494,0,3,scenario_curriculum_ckpt639_nnm,3,less_then_partially_randomized_entropy_checkpoints_bots_4_heads_39_ckpt109,5_vs_5
2495,3,7,scenario_curriculum_ckpt639_nnm,4,less_then_partially_randomized_entropy_checkpoints_bots_4_heads_39_ckpt109,5_vs_5
2496,-1,3,scenario_curriculum_ckpt639_nnm,4,less_then_partially_randomized_entropy_checkpoints_bots_4_heads_39_ckpt109,5_vs_5
2497,2,6,scenario_curriculum_ckpt639_nnm,4,less_then_partially_randomized_entropy_checkpoints_bots_4_heads_39_ckpt109,5_vs_5
2498,1,4,scenario_curriculum_ckpt639_nnm,3,less_then_partially_randomized_entropy_checkpoints_bots_4_heads_39_ckpt109,5_vs_5
2499,-3,2,scenario_curriculum_ckpt639_nnm,5,less_then_partially_randomized_entropy_checkpoints_bots_4_heads_39_ckpt109,5_vs_5
2500,5,6,scenario_curriculum_ckpt639_nnm,1,reward_shaping_checkpoints_bots_4_heads_1_ckpt360,5_vs_5
2501,3,4,scenario_curriculum_ckpt639_nnm,1,reward_shaping_checkpoints_bots_4_heads_1_ckpt360,5_vs_5
2502,5,7,scenario_curriculum_ckpt639_nnm,2,reward_shaping_checkpoints_bots_4_heads_1_ckpt360,5_vs_5
2503,6,7,scenario_curriculum_ckpt639_nnm,1,reward_shaping_checkpoints_bots_4_heads_1_ckpt360,5_vs_5
2504,4,5,scenario_curriculum_ckpt639_nnm,1,reward_shaping_checkpoints_bots_4_heads_1_ckpt360,5_vs_5
2505,7,7,scenario_curriculum_ckpt639_nnm,0,reward_shaping_checkpoints_bots_4_heads_1_ckpt360,5_vs_5
2506,8,9,scenario_curriculum_ckpt639_nnm,1,reward_shaping_checkpoints_bots_4_heads_1_ckpt360,5_vs_5
2507,6,7,scenario_curriculum_ckpt639_nnm,1,reward_shaping_checkpoints_bots_4_heads_1_ckpt360,5_vs_5
2508,8,8,scenario_curriculum_ckpt639_nnm,0,reward_shaping_checkpoints_bots_4_heads_1_ckpt360,5_vs_5
2509,2,3,scenario_curriculum_ckpt639_nnm,1,reward_shaping_checkpoints_bots_4_heads_1_ckpt360,5_vs_5
2510,2,4,scenario_curriculum_ckpt639_nnm,2,reward_shaping_checkpoints_bots_4_heads_1_ckpt360,5_vs_5
2511,5,7,scenario_curriculum_ckpt639_nnm,2,reward_shaping_checkpoints_bots_4_heads_1_ckpt360,5_vs_5
2512,3,5,scenario_curriculum_ckpt639_nnm,2,reward_shaping_checkpoints_bots_4_heads_1_ckpt360,5_vs_5
2513,3,5,scenario_curriculum_ckpt639_nnm,2,reward_shaping_checkpoints_bots_4_heads_1_ckpt360,5_vs_5
2514,2,5,scenario_curriculum_ckpt639_nnm,3,reward_shaping_checkpoints_bots_4_heads_1_ckpt360,5_vs_5
2515,6,7,scenario_curriculum_ckpt639_nnm,1,reward_shaping_checkpoints_bots_4_heads_1_ckpt360,5_vs_5
2516,5,6,scenario_curriculum_ckpt639_nnm,1,reward_shaping_checkpoints_bots_4_heads_1_ckpt360,5_vs_5
2517,9,9,scenario_curriculum_ckpt639_nnm,0,reward_shaping_checkpoints_bots_4_heads_1_ckpt360,5_vs_5
2518,5,6,scenario_curriculum_ckpt639_nnm,1,reward_shaping_checkpoints_bots_4_heads_1_ckpt360,5_vs_5
2519,2,6,scenario_curriculum_ckpt639_nnm,4,reward_shaping_checkpoints_bots_4_heads_1_ckpt360,5_vs_5
2520,-12,1,scenario_curriculum_ckpt639_nnm,13,checkpoints_selfplay_e9_sp_ckpt335_1370M,5_vs_5
2521,-7,0,scenario_curriculum_ckpt639_nnm,7,checkpoints_selfplay_e9_sp_ckpt335_1370M,5_vs_5
2522,-10,0,scenario_curriculum_ckpt639_nnm,10,checkpoints_selfplay_e9_sp_ckpt335_1370M,5_vs_5
2523,-11,0,scenario_curriculum_ckpt639_nnm,11,checkpoints_selfplay_e9_sp_ckpt335_1370M,5_vs_5
2524,-7,2,scenario_curriculum_ckpt639_nnm,9,checkpoints_selfplay_e9_sp_ckpt335_1370M,5_vs_5
2525,-9,0,scenario_curriculum_ckpt639_nnm,9,checkpoints_selfplay_e9_sp_ckpt335_1370M,5_vs_5
2526,-8,2,scenario_curriculum_ckpt639_nnm,10,checkpoints_selfplay_e9_sp_ckpt335_1370M,5_vs_5
2527,-17,0,scenario_curriculum_ckpt639_nnm,17,checkpoints_selfplay_e9_sp_ckpt335_1370M,5_vs_5
2528,-12,0,scenario_curriculum_ckpt639_nnm,12,checkpoints_selfplay_e9_sp_ckpt335_1370M,5_vs_5
2529,-3,2,scenario_curriculum_ckpt639_nnm,5,checkpoints_selfplay_e9_sp_ckpt335_1370M,5_vs_5
2530,-9,1,scenario_curriculum_ckpt639_nnm,10,checkpoints_selfplay_e9_sp_ckpt335_1370M,5_vs_5
2531,-9,1,scenario_curriculum_ckpt639_nnm,10,checkpoints_selfplay_e9_sp_ckpt335_1370M,5_vs_5
2532,-8,0,scenario_curriculum_ckpt639_nnm,8,checkpoints_selfplay_e9_sp_ckpt335_1370M,5_vs_5
2533,-7,4,scenario_curriculum_ckpt639_nnm,11,checkpoints_selfplay_e9_sp_ckpt335_1370M,5_vs_5
2534,-10,1,scenario_curriculum_ckpt639_nnm,11,checkpoints_selfplay_e9_sp_ckpt335_1370M,5_vs_5
2535,-7,2,scenario_curriculum_ckpt639_nnm,9,checkpoints_selfplay_e9_sp_ckpt335_1370M,5_vs_5
2536,-10,2,scenario_curriculum_ckpt639_nnm,12,checkpoints_selfplay_e9_sp_ckpt335_1370M,5_vs_5
2537,-8,2,scenario_curriculum_ckpt639_nnm,10,checkpoints_selfplay_e9_sp_ckpt335_1370M,5_vs_5
2538,-4,0,scenario_curriculum_ckpt639_nnm,4,checkpoints_selfplay_e9_sp_ckpt335_1370M,5_vs_5
2539,-9,1,scenario_curriculum_ckpt639_nnm,10,checkpoints_selfplay_e9_sp_ckpt335_1370M,5_vs_5
2540,-8,1,scenario_curriculum_ckpt639_nnm,9,checkpoints_sp_c_nb_e2_ckpt667,5_vs_5
2541,-6,0,scenario_curriculum_ckpt639_nnm,6,checkpoints_sp_c_nb_e2_ckpt667,5_vs_5
2542,-9,1,scenario_curriculum_ckpt639_nnm,10,checkpoints_sp_c_nb_e2_ckpt667,5_vs_5
2543,0,2,scenario_curriculum_ckpt639_nnm,2,checkpoints_sp_c_nb_e2_ckpt667,5_vs_5
2544,-12,0,scenario_curriculum_ckpt639_nnm,12,checkpoints_sp_c_nb_e2_ckpt667,5_vs_5
2545,-9,1,scenario_curriculum_ckpt639_nnm,10,checkpoints_sp_c_nb_e2_ckpt667,5_vs_5
2546,-11,0,scenario_curriculum_ckpt639_nnm,11,checkpoints_sp_c_nb_e2_ckpt667,5_vs_5
2547,-4,1,scenario_curriculum_ckpt639_nnm,5,checkpoints_sp_c_nb_e2_ckpt667,5_vs_5
2548,-14,0,scenario_curriculum_ckpt639_nnm,14,checkpoints_sp_c_nb_e2_ckpt667,5_vs_5
2549,-5,1,scenario_curriculum_ckpt639_nnm,6,checkpoints_sp_c_nb_e2_ckpt667,5_vs_5
2550,-7,0,scenario_curriculum_ckpt639_nnm,7,checkpoints_sp_c_nb_e2_ckpt667,5_vs_5
2551,-13,0,scenario_curriculum_ckpt639_nnm,13,checkpoints_sp_c_nb_e2_ckpt667,5_vs_5
2552,-11,1,scenario_curriculum_ckpt639_nnm,12,checkpoints_sp_c_nb_e2_ckpt667,5_vs_5
2553,-3,1,scenario_curriculum_ckpt639_nnm,4,checkpoints_sp_c_nb_e2_ckpt667,5_vs_5
2554,-8,0,scenario_curriculum_ckpt639_nnm,8,checkpoints_sp_c_nb_e2_ckpt667,5_vs_5
2555,-9,1,scenario_curriculum_ckpt639_nnm,10,checkpoints_sp_c_nb_e2_ckpt667,5_vs_5
2556,-9,0,scenario_curriculum_ckpt639_nnm,9,checkpoints_sp_c_nb_e2_ckpt667,5_vs_5
2557,-8,1,scenario_curriculum_ckpt639_nnm,9,checkpoints_sp_c_nb_e2_ckpt667,5_vs_5
2558,-9,0,scenario_curriculum_ckpt639_nnm,9,checkpoints_sp_c_nb_e2_ckpt667,5_vs_5
2559,-12,0,scenario_curriculum_ckpt639_nnm,12,checkpoints_sp_c_nb_e2_ckpt667,5_vs_5
2560,2,5,scenario_curriculum_ckpt639_nnm,3,scenario_curriculum_ckpt639_nnm,5_vs_5
2561,-4,1,scenario_curriculum_ckpt639_nnm,5,scenario_curriculum_ckpt639_nnm,5_vs_5
2562,1,5,scenario_curriculum_ckpt639_nnm,4,scenario_curriculum_ckpt639_nnm,5_vs_5
2563,-1,5,scenario_curriculum_ckpt639_nnm,6,scenario_curriculum_ckpt639_nnm,5_vs_5
2564,0,3,scenario_curriculum_ckpt639_nnm,3,scenario_curriculum_ckpt639_nnm,5_vs_5
2565,2,4,scenario_curriculum_ckpt639_nnm,2,scenario_curriculum_ckpt639_nnm,5_vs_5
2566,1,6,scenario_curriculum_ckpt639_nnm,5,scenario_curriculum_ckpt639_nnm,5_vs_5
2567,1,4,scenario_curriculum_ckpt639_nnm,3,scenario_curriculum_ckpt639_nnm,5_vs_5
2568,-1,3,scenario_curriculum_ckpt639_nnm,4,scenario_curriculum_ckpt639_nnm,5_vs_5
2569,-3,3,scenario_curriculum_ckpt639_nnm,6,scenario_curriculum_ckpt639_nnm,5_vs_5
2570,0,2,scenario_curriculum_ckpt639_nnm,2,scenario_curriculum_ckpt639_nnm,5_vs_5
2571,-1,4,scenario_curriculum_ckpt639_nnm,5,scenario_curriculum_ckpt639_nnm,5_vs_5
2572,1,4,scenario_curriculum_ckpt639_nnm,3,scenario_curriculum_ckpt639_nnm,5_vs_5
2573,3,5,scenario_curriculum_ckpt639_nnm,2,scenario_curriculum_ckpt639_nnm,5_vs_5
2574,1,3,scenario_curriculum_ckpt639_nnm,2,scenario_curriculum_ckpt639_nnm,5_vs_5
2575,6,9,scenario_curriculum_ckpt639_nnm,3,scenario_curriculum_ckpt639_nnm,5_vs_5
2576,2,6,scenario_curriculum_ckpt639_nnm,4,scenario_curriculum_ckpt639_nnm,5_vs_5
2577,4,5,scenario_curriculum_ckpt639_nnm,1,scenario_curriculum_ckpt639_nnm,5_vs_5
2578,-1,3,scenario_curriculum_ckpt639_nnm,4,scenario_curriculum_ckpt639_nnm,5_vs_5
2579,0,4,scenario_curriculum_ckpt639_nnm,4,scenario_curriculum_ckpt639_nnm,5_vs_5
2580,-1,3,scenario_curriculum_ckpt639_nnm,4,m_sp_arch_medium_heads_conv16_0_bt_32_r313_m288_1370M,5_vs_5
2581,0,2,scenario_curriculum_ckpt639_nnm,2,m_sp_arch_medium_heads_conv16_0_bt_32_r313_m288_1370M,5_vs_5
2582,-5,2,scenario_curriculum_ckpt639_nnm,7,m_sp_arch_medium_heads_conv16_0_bt_32_r313_m288_1370M,5_vs_5
2583,1,4,scenario_curriculum_ckpt639_nnm,3,m_sp_arch_medium_heads_conv16_0_bt_32_r313_m288_1370M,5_vs_5
2584,-3,1,scenario_curriculum_ckpt639_nnm,4,m_sp_arch_medium_heads_conv16_0_bt_32_r313_m288_1370M,5_vs_5
2585,-2,2,scenario_curriculum_ckpt639_nnm,4,m_sp_arch_medium_heads_conv16_0_bt_32_r313_m288_1370M,5_vs_5
2586,-6,0,scenario_curriculum_ckpt639_nnm,6,m_sp_arch_medium_heads_conv16_0_bt_32_r313_m288_1370M,5_vs_5
2587,-1,1,scenario_curriculum_ckpt639_nnm,2,m_sp_arch_medium_heads_conv16_0_bt_32_r313_m288_1370M,5_vs_5
2588,0,2,scenario_curriculum_ckpt639_nnm,2,m_sp_arch_medium_heads_conv16_0_bt_32_r313_m288_1370M,5_vs_5
2589,3,5,scenario_curriculum_ckpt639_nnm,2,m_sp_arch_medium_heads_conv16_0_bt_32_r313_m288_1370M,5_vs_5
2590,0,2,scenario_curriculum_ckpt639_nnm,2,m_sp_arch_medium_heads_conv16_0_bt_32_r313_m288_1370M,5_vs_5
2591,-4,0,scenario_curriculum_ckpt639_nnm,4,m_sp_arch_medium_heads_conv16_0_bt_32_r313_m288_1370M,5_vs_5
2592,-1,3,scenario_curriculum_ckpt639_nnm,4,m_sp_arch_medium_heads_conv16_0_bt_32_r313_m288_1370M,5_vs_5
2593,0,2,scenario_curriculum_ckpt639_nnm,2,m_sp_arch_medium_heads_conv16_0_bt_32_r313_m288_1370M,5_vs_5
2594,-2,1,scenario_curriculum_ckpt639_nnm,3,m_sp_arch_medium_heads_conv16_0_bt_32_r313_m288_1370M,5_vs_5
2595,-3,0,scenario_curriculum_ckpt639_nnm,3,m_sp_arch_medium_heads_conv16_0_bt_32_r313_m288_1370M,5_vs_5
2596,-5,0,scenario_curriculum_ckpt639_nnm,5,m_sp_arch_medium_heads_conv16_0_bt_32_r313_m288_1370M,5_vs_5
2597,-5,2,scenario_curriculum_ckpt639_nnm,7,m_sp_arch_medium_heads_conv16_0_bt_32_r313_m288_1370M,5_vs_5
2598,-3,0,scenario_curriculum_ckpt639_nnm,3,m_sp_arch_medium_heads_conv16_0_bt_32_r313_m288_1370M,5_vs_5
2599,-1,3,scenario_curriculum_ckpt639_nnm,4,m_sp_arch_medium_heads_conv16_0_bt_32_r313_m288_1370M,5_vs_5
2600,-9,1,scenario_curriculum_ckpt639_nnm,10,m_sp_arch_longer_heads_bt_32_r310_m277_1370M,5_vs_5
2601,-9,1,scenario_curriculum_ckpt639_nnm,10,m_sp_arch_longer_heads_bt_32_r310_m277_1370M,5_vs_5
2602,-4,3,scenario_curriculum_ckpt639_nnm,7,m_sp_arch_longer_heads_bt_32_r310_m277_1370M,5_vs_5
2603,-11,1,scenario_curriculum_ckpt639_nnm,12,m_sp_arch_longer_heads_bt_32_r310_m277_1370M,5_vs_5
2604,-2,2,scenario_curriculum_ckpt639_nnm,4,m_sp_arch_longer_heads_bt_32_r310_m277_1370M,5_vs_5
2605,-7,1,scenario_curriculum_ckpt639_nnm,8,m_sp_arch_longer_heads_bt_32_r310_m277_1370M,5_vs_5
2606,-5,0,scenario_curriculum_ckpt639_nnm,5,m_sp_arch_longer_heads_bt_32_r310_m277_1370M,5_vs_5
2607,-5,0,scenario_curriculum_ckpt639_nnm,5,m_sp_arch_longer_heads_bt_32_r310_m277_1370M,5_vs_5
2608,-7,1,scenario_curriculum_ckpt639_nnm,8,m_sp_arch_longer_heads_bt_32_r310_m277_1370M,5_vs_5
2609,-7,1,scenario_curriculum_ckpt639_nnm,8,m_sp_arch_longer_heads_bt_32_r310_m277_1370M,5_vs_5
2610,-5,1,scenario_curriculum_ckpt639_nnm,6,m_sp_arch_longer_heads_bt_32_r310_m277_1370M,5_vs_5
2611,-11,0,scenario_curriculum_ckpt639_nnm,11,m_sp_arch_longer_heads_bt_32_r310_m277_1370M,5_vs_5
2612,-12,0,scenario_curriculum_ckpt639_nnm,12,m_sp_arch_longer_heads_bt_32_r310_m277_1370M,5_vs_5
2613,-5,0,scenario_curriculum_ckpt639_nnm,5,m_sp_arch_longer_heads_bt_32_r310_m277_1370M,5_vs_5
2614,-4,1,scenario_curriculum_ckpt639_nnm,5,m_sp_arch_longer_heads_bt_32_r310_m277_1370M,5_vs_5
2615,-2,3,scenario_curriculum_ckpt639_nnm,5,m_sp_arch_longer_heads_bt_32_r310_m277_1370M,5_vs_5
2616,-4,1,scenario_curriculum_ckpt639_nnm,5,m_sp_arch_longer_heads_bt_32_r310_m277_1370M,5_vs_5
2617,-9,1,scenario_curriculum_ckpt639_nnm,10,m_sp_arch_longer_heads_bt_32_r310_m277_1370M,5_vs_5
2618,-7,0,scenario_curriculum_ckpt639_nnm,7,m_sp_arch_longer_heads_bt_32_r310_m277_1370M,5_vs_5
2619,-4,4,scenario_curriculum_ckpt639_nnm,8,m_sp_arch_longer_heads_bt_32_r310_m277_1370M,5_vs_5
2620,-7,2,scenario_curriculum_ckpt639_nnm,9,m_sp_arch_medium_heads_bt_32_r201_m273_1370M,5_vs_5
2621,-2,5,scenario_curriculum_ckpt639_nnm,7,m_sp_arch_medium_heads_bt_32_r201_m273_1370M,5_vs_5
2622,-2,6,scenario_curriculum_ckpt639_nnm,8,m_sp_arch_medium_heads_bt_32_r201_m273_1370M,5_vs_5
2623,-3,3,scenario_curriculum_ckpt639_nnm,6,m_sp_arch_medium_heads_bt_32_r201_m273_1370M,5_vs_5
2624,-5,2,scenario_curriculum_ckpt639_nnm,7,m_sp_arch_medium_heads_bt_32_r201_m273_1370M,5_vs_5
2625,-9,2,scenario_curriculum_ckpt639_nnm,11,m_sp_arch_medium_heads_bt_32_r201_m273_1370M,5_vs_5
2626,0,5,scenario_curriculum_ckpt639_nnm,5,m_sp_arch_medium_heads_bt_32_r201_m273_1370M,5_vs_5
2627,-5,2,scenario_curriculum_ckpt639_nnm,7,m_sp_arch_medium_heads_bt_32_r201_m273_1370M,5_vs_5
2628,-8,1,scenario_curriculum_ckpt639_nnm,9,m_sp_arch_medium_heads_bt_32_r201_m273_1370M,5_vs_5
2629,-2,3,scenario_curriculum_ckpt639_nnm,5,m_sp_arch_medium_heads_bt_32_r201_m273_1370M,5_vs_5
2630,-4,4,scenario_curriculum_ckpt639_nnm,8,m_sp_arch_medium_heads_bt_32_r201_m273_1370M,5_vs_5
2631,-3,4,scenario_curriculum_ckpt639_nnm,7,m_sp_arch_medium_heads_bt_32_r201_m273_1370M,5_vs_5
2632,-1,4,scenario_curriculum_ckpt639_nnm,5,m_sp_arch_medium_heads_bt_32_r201_m273_1370M,5_vs_5
2633,-4,3,scenario_curriculum_ckpt639_nnm,7,m_sp_arch_medium_heads_bt_32_r201_m273_1370M,5_vs_5
2634,-2,5,scenario_curriculum_ckpt639_nnm,7,m_sp_arch_medium_heads_bt_32_r201_m273_1370M,5_vs_5
2635,-4,3,scenario_curriculum_ckpt639_nnm,7,m_sp_arch_medium_heads_bt_32_r201_m273_1370M,5_vs_5
2636,-4,3,scenario_curriculum_ckpt639_nnm,7,m_sp_arch_medium_heads_bt_32_r201_m273_1370M,5_vs_5
2637,-5,5,scenario_curriculum_ckpt639_nnm,10,m_sp_arch_medium_heads_bt_32_r201_m273_1370M,5_vs_5
2638,-4,4,scenario_curriculum_ckpt639_nnm,8,m_sp_arch_medium_heads_bt_32_r201_m273_1370M,5_vs_5
2639,-4,7,scenario_curriculum_ckpt639_nnm,11,m_sp_arch_medium_heads_bt_32_r201_m273_1370M,5_vs_5
2640,-13,0,scenario_curriculum_ckpt639_nnm,13,m_sp_arch_4x1_bt_32_r201_m335,5_vs_5
2641,-20,0,scenario_curriculum_ckpt639_nnm,20,m_sp_arch_4x1_bt_32_r201_m335,5_vs_5
2642,-9,0,scenario_curriculum_ckpt639_nnm,9,m_sp_arch_4x1_bt_32_r201_m335,5_vs_5
2643,-14,0,scenario_curriculum_ckpt639_nnm,14,m_sp_arch_4x1_bt_32_r201_m335,5_vs_5
2644,-15,0,scenario_curriculum_ckpt639_nnm,15,m_sp_arch_4x1_bt_32_r201_m335,5_vs_5
2645,-12,0,scenario_curriculum_ckpt639_nnm,12,m_sp_arch_4x1_bt_32_r201_m335,5_vs_5
2646,-13,0,scenario_curriculum_ckpt639_nnm,13,m_sp_arch_4x1_bt_32_r201_m335,5_vs_5
2647,-13,0,scenario_curriculum_ckpt639_nnm,13,m_sp_arch_4x1_bt_32_r201_m335,5_vs_5
2648,-13,0,scenario_curriculum_ckpt639_nnm,13,m_sp_arch_4x1_bt_32_r201_m335,5_vs_5
2649,-16,0,scenario_curriculum_ckpt639_nnm,16,m_sp_arch_4x1_bt_32_r201_m335,5_vs_5
2650,-12,0,scenario_curriculum_ckpt639_nnm,12,m_sp_arch_4x1_bt_32_r201_m335,5_vs_5
2651,-17,0,scenario_curriculum_ckpt639_nnm,17,m_sp_arch_4x1_bt_32_r201_m335,5_vs_5
2652,-16,0,scenario_curriculum_ckpt639_nnm,16,m_sp_arch_4x1_bt_32_r201_m335,5_vs_5
2653,-12,0,scenario_curriculum_ckpt639_nnm,12,m_sp_arch_4x1_bt_32_r201_m335,5_vs_5
2654,-17,0,scenario_curriculum_ckpt639_nnm,17,m_sp_arch_4x1_bt_32_r201_m335,5_vs_5
2655,-15,0,scenario_curriculum_ckpt639_nnm,15,m_sp_arch_4x1_bt_32_r201_m335,5_vs_5
2656,-13,0,scenario_curriculum_ckpt639_nnm,13,m_sp_arch_4x1_bt_32_r201_m335,5_vs_5
2657,-15,0,scenario_curriculum_ckpt639_nnm,15,m_sp_arch_4x1_bt_32_r201_m335,5_vs_5
2658,-14,0,scenario_curriculum_ckpt639_nnm,14,m_sp_arch_4x1_bt_32_r201_m335,5_vs_5
2659,-13,0,scenario_curriculum_ckpt639_nnm,13,m_sp_arch_4x1_bt_32_r201_m335,5_vs_5
2660,-13,0,scenario_curriculum_ckpt639_nnm,13,m_sp_arch_4x1_bt_32_r201_cont3_m650,5_vs_5
2661,-11,0,scenario_curriculum_ckpt639_nnm,11,m_sp_arch_4x1_bt_32_r201_cont3_m650,5_vs_5
2662,-8,0,scenario_curriculum_ckpt639_nnm,8,m_sp_arch_4x1_bt_32_r201_cont3_m650,5_vs_5
2663,-12,0,scenario_curriculum_ckpt639_nnm,12,m_sp_arch_4x1_bt_32_r201_cont3_m650,5_vs_5
2664,-12,0,scenario_curriculum_ckpt639_nnm,12,m_sp_arch_4x1_bt_32_r201_cont3_m650,5_vs_5
2665,-14,0,scenario_curriculum_ckpt639_nnm,14,m_sp_arch_4x1_bt_32_r201_cont3_m650,5_vs_5
2666,-11,0,scenario_curriculum_ckpt639_nnm,11,m_sp_arch_4x1_bt_32_r201_cont3_m650,5_vs_5
2667,-12,0,scenario_curriculum_ckpt639_nnm,12,m_sp_arch_4x1_bt_32_r201_cont3_m650,5_vs_5
2668,-16,0,scenario_curriculum_ckpt639_nnm,16,m_sp_arch_4x1_bt_32_r201_cont3_m650,5_vs_5
2669,-11,0,scenario_curriculum_ckpt639_nnm,11,m_sp_arch_4x1_bt_32_r201_cont3_m650,5_vs_5
2670,-9,0,scenario_curriculum_ckpt639_nnm,9,m_sp_arch_4x1_bt_32_r201_cont3_m650,5_vs_5
2671,-18,1,scenario_curriculum_ckpt639_nnm,19,m_sp_arch_4x1_bt_32_r201_cont3_m650,5_vs_5
2672,-12,0,scenario_curriculum_ckpt639_nnm,12,m_sp_arch_4x1_bt_32_r201_cont3_m650,5_vs_5
2673,-10,0,scenario_curriculum_ckpt639_nnm,10,m_sp_arch_4x1_bt_32_r201_cont3_m650,5_vs_5
2674,-9,0,scenario_curriculum_ckpt639_nnm,9,m_sp_arch_4x1_bt_32_r201_cont3_m650,5_vs_5
2675,-18,0,scenario_curriculum_ckpt639_nnm,18,m_sp_arch_4x1_bt_32_r201_cont3_m650,5_vs_5
2676,-15,1,scenario_curriculum_ckpt639_nnm,16,m_sp_arch_4x1_bt_32_r201_cont3_m650,5_vs_5
2677,-8,0,scenario_curriculum_ckpt639_nnm,8,m_sp_arch_4x1_bt_32_r201_cont3_m650,5_vs_5
2678,-12,0,scenario_curriculum_ckpt639_nnm,12,m_sp_arch_4x1_bt_32_r201_cont3_m650,5_vs_5
2679,-15,0,scenario_curriculum_ckpt639_nnm,15,m_sp_arch_4x1_bt_32_r201_cont3_m650,5_vs_5
2680,-3,0,scenario_curriculum_ckpt639_nnm,3,explt_v0_7_2_m54,5_vs_5
2681,-4,0,scenario_curriculum_ckpt639_nnm,4,explt_v0_7_2_m54,5_vs_5
2682,-2,0,scenario_curriculum_ckpt639_nnm,2,explt_v0_7_2_m54,5_vs_5
2683,-4,0,scenario_curriculum_ckpt639_nnm,4,explt_v0_7_2_m54,5_vs_5
2684,-3,1,scenario_curriculum_ckpt639_nnm,4,explt_v0_7_2_m54,5_vs_5
2685,-4,1,scenario_curriculum_ckpt639_nnm,5,explt_v0_7_2_m54,5_vs_5
2686,-1,0,scenario_curriculum_ckpt639_nnm,1,explt_v0_7_2_m54,5_vs_5
2687,-1,2,scenario_curriculum_ckpt639_nnm,3,explt_v0_7_2_m54,5_vs_5
2688,-1,1,scenario_curriculum_ckpt639_nnm,2,explt_v0_7_2_m54,5_vs_5
2689,-5,0,scenario_curriculum_ckpt639_nnm,5,explt_v0_7_2_m54,5_vs_5
2690,-1,1,scenario_curriculum_ckpt639_nnm,2,explt_v0_7_2_m54,5_vs_5
2691,-1,0,scenario_curriculum_ckpt639_nnm,1,explt_v0_7_2_m54,5_vs_5
2692,-1,1,scenario_curriculum_ckpt639_nnm,2,explt_v0_7_2_m54,5_vs_5
2693,0,0,scenario_curriculum_ckpt639_nnm,0,explt_v0_7_2_m54,5_vs_5
2694,-1,0,scenario_curriculum_ckpt639_nnm,1,explt_v0_7_2_m54,5_vs_5
2695,-2,1,scenario_curriculum_ckpt639_nnm,3,explt_v0_7_2_m54,5_vs_5
2696,-1,1,scenario_curriculum_ckpt639_nnm,2,explt_v0_7_2_m54,5_vs_5
2697,-1,0,scenario_curriculum_ckpt639_nnm,1,explt_v0_7_2_m54,5_vs_5
2698,-2,0,scenario_curriculum_ckpt639_nnm,2,explt_v0_7_2_m54,5_vs_5
2699,0,2,scenario_curriculum_ckpt639_nnm,2,explt_v0_7_2_m54,5_vs_5
2700,-14,0,scenario_curriculum_ckpt639_nnm,14,m_sp_sc3v3_arch_2x1_32_r500_cont4x1_m224,5_vs_5
2701,-12,1,scenario_curriculum_ckpt639_nnm,13,m_sp_sc3v3_arch_2x1_32_r500_cont4x1_m224,5_vs_5
2702,-19,0,scenario_curriculum_ckpt639_nnm,19,m_sp_sc3v3_arch_2x1_32_r500_cont4x1_m224,5_vs_5
2703,-7,0,scenario_curriculum_ckpt639_nnm,7,m_sp_sc3v3_arch_2x1_32_r500_cont4x1_m224,5_vs_5
2704,-13,0,scenario_curriculum_ckpt639_nnm,13,m_sp_sc3v3_arch_2x1_32_r500_cont4x1_m224,5_vs_5
2705,-7,0,scenario_curriculum_ckpt639_nnm,7,m_sp_sc3v3_arch_2x1_32_r500_cont4x1_m224,5_vs_5
2706,-17,0,scenario_curriculum_ckpt639_nnm,17,m_sp_sc3v3_arch_2x1_32_r500_cont4x1_m224,5_vs_5
2707,-12,0,scenario_curriculum_ckpt639_nnm,12,m_sp_sc3v3_arch_2x1_32_r500_cont4x1_m224,5_vs_5
2708,-11,0,scenario_curriculum_ckpt639_nnm,11,m_sp_sc3v3_arch_2x1_32_r500_cont4x1_m224,5_vs_5
2709,-11,0,scenario_curriculum_ckpt639_nnm,11,m_sp_sc3v3_arch_2x1_32_r500_cont4x1_m224,5_vs_5
2710,-16,0,scenario_curriculum_ckpt639_nnm,16,m_sp_sc3v3_arch_2x1_32_r500_cont4x1_m224,5_vs_5
2711,-16,0,scenario_curriculum_ckpt639_nnm,16,m_sp_sc3v3_arch_2x1_32_r500_cont4x1_m224,5_vs_5
2712,-18,0,scenario_curriculum_ckpt639_nnm,18,m_sp_sc3v3_arch_2x1_32_r500_cont4x1_m224,5_vs_5
2713,-17,0,scenario_curriculum_ckpt639_nnm,17,m_sp_sc3v3_arch_2x1_32_r500_cont4x1_m224,5_vs_5
2714,-13,1,scenario_curriculum_ckpt639_nnm,14,m_sp_sc3v3_arch_2x1_32_r500_cont4x1_m224,5_vs_5
2715,-14,0,scenario_curriculum_ckpt639_nnm,14,m_sp_sc3v3_arch_2x1_32_r500_cont4x1_m224,5_vs_5
2716,-14,0,scenario_curriculum_ckpt639_nnm,14,m_sp_sc3v3_arch_2x1_32_r500_cont4x1_m224,5_vs_5
2717,-16,0,scenario_curriculum_ckpt639_nnm,16,m_sp_sc3v3_arch_2x1_32_r500_cont4x1_m224,5_vs_5
2718,-16,0,scenario_curriculum_ckpt639_nnm,16,m_sp_sc3v3_arch_2x1_32_r500_cont4x1_m224,5_vs_5
2719,-16,0,scenario_curriculum_ckpt639_nnm,16,m_sp_sc3v3_arch_2x1_32_r500_cont4x1_m224,5_vs_5
2720,-8,0,scenario_curriculum_ckpt639_nnm,8,m_sp_arch_4x1_bt_32_roles_r500_m335,5_vs_5
2721,-15,1,scenario_curriculum_ckpt639_nnm,16,m_sp_arch_4x1_bt_32_roles_r500_m335,5_vs_5
2722,-20,0,scenario_curriculum_ckpt639_nnm,20,m_sp_arch_4x1_bt_32_roles_r500_m335,5_vs_5
2723,-15,0,scenario_curriculum_ckpt639_nnm,15,m_sp_arch_4x1_bt_32_roles_r500_m335,5_vs_5
2724,-15,0,scenario_curriculum_ckpt639_nnm,15,m_sp_arch_4x1_bt_32_roles_r500_m335,5_vs_5
2725,-12,1,scenario_curriculum_ckpt639_nnm,13,m_sp_arch_4x1_bt_32_roles_r500_m335,5_vs_5
2726,-9,1,scenario_curriculum_ckpt639_nnm,10,m_sp_arch_4x1_bt_32_roles_r500_m335,5_vs_5
2727,-15,1,scenario_curriculum_ckpt639_nnm,16,m_sp_arch_4x1_bt_32_roles_r500_m335,5_vs_5
2728,-16,0,scenario_curriculum_ckpt639_nnm,16,m_sp_arch_4x1_bt_32_roles_r500_m335,5_vs_5
2729,-19,0,scenario_curriculum_ckpt639_nnm,19,m_sp_arch_4x1_bt_32_roles_r500_m335,5_vs_5
2730,-13,0,scenario_curriculum_ckpt639_nnm,13,m_sp_arch_4x1_bt_32_roles_r500_m335,5_vs_5
2731,-14,0,scenario_curriculum_ckpt639_nnm,14,m_sp_arch_4x1_bt_32_roles_r500_m335,5_vs_5
2732,-14,0,scenario_curriculum_ckpt639_nnm,14,m_sp_arch_4x1_bt_32_roles_r500_m335,5_vs_5
2733,-15,0,scenario_curriculum_ckpt639_nnm,15,m_sp_arch_4x1_bt_32_roles_r500_m335,5_vs_5
2734,-16,0,scenario_curriculum_ckpt639_nnm,16,m_sp_arch_4x1_bt_32_roles_r500_m335,5_vs_5
2735,-10,1,scenario_curriculum_ckpt639_nnm,11,m_sp_arch_4x1_bt_32_roles_r500_m335,5_vs_5
2736,-13,0,scenario_curriculum_ckpt639_nnm,13,m_sp_arch_4x1_bt_32_roles_r500_m335,5_vs_5
2737,-11,1,scenario_curriculum_ckpt639_nnm,12,m_sp_arch_4x1_bt_32_roles_r500_m335,5_vs_5
2738,-14,2,scenario_curriculum_ckpt639_nnm,16,m_sp_arch_4x1_bt_32_roles_r500_m335,5_vs_5
2739,-7,0,scenario_curriculum_ckpt639_nnm,7,m_sp_arch_4x1_bt_32_roles_r500_m335,5_vs_5
2740,3,3,explt_v0_7_2_m54,0,easy_bots,5_vs_5
2741,4,4,explt_v0_7_2_m54,0,easy_bots,5_vs_5
2742,4,4,explt_v0_7_2_m54,0,easy_bots,5_vs_5
2743,3,4,explt_v0_7_2_m54,1,easy_bots,5_vs_5
2744,1,2,explt_v0_7_2_m54,1,easy_bots,5_vs_5
2745,2,4,explt_v0_7_2_m54,2,easy_bots,5_vs_5
2746,4,4,explt_v0_7_2_m54,0,easy_bots,5_vs_5
2747,3,4,explt_v0_7_2_m54,1,easy_bots,5_vs_5
2748,1,1,explt_v0_7_2_m54,0,easy_bots,5_vs_5
2749,3,4,explt_v0_7_2_m54,1,easy_bots,5_vs_5
2750,2,3,explt_v0_7_2_m54,1,easy_bots,5_vs_5
2751,2,3,explt_v0_7_2_m54,1,easy_bots,5_vs_5
2752,2,2,explt_v0_7_2_m54,0,easy_bots,5_vs_5
2753,3,4,explt_v0_7_2_m54,1,easy_bots,5_vs_5
2754,3,4,explt_v0_7_2_m54,1,easy_bots,5_vs_5
2755,0,2,explt_v0_7_2_m54,2,easy_bots,5_vs_5
2756,1,2,explt_v0_7_2_m54,1,easy_bots,5_vs_5
2757,0,1,explt_v0_7_2_m54,1,easy_bots,5_vs_5
2758,2,2,explt_v0_7_2_m54,0,easy_bots,5_vs_5
2759,4,4,explt_v0_7_2_m54,0,easy_bots,5_vs_5
2760,-2,0,explt_v0_7_2_m54,2,medium_bots,5_vs_5_medium
2761,-2,0,explt_v0_7_2_m54,2,medium_bots,5_vs_5_medium
2762,-1,0,explt_v0_7_2_m54,1,medium_bots,5_vs_5_medium
2763,0,1,explt_v0_7_2_m54,1,medium_bots,5_vs_5_medium
2764,-1,1,explt_v0_7_2_m54,2,medium_bots,5_vs_5_medium
2765,0,0,explt_v0_7_2_m54,0,medium_bots,5_vs_5_medium
2766,-1,1,explt_v0_7_2_m54,2,medium_bots,5_vs_5_medium
2767,0,0,explt_v0_7_2_m54,0,medium_bots,5_vs_5_medium
2768,-2,0,explt_v0_7_2_m54,2,medium_bots,5_vs_5_medium
2769,-1,0,explt_v0_7_2_m54,1,medium_bots,5_vs_5_medium
2770,-1,0,explt_v0_7_2_m54,1,medium_bots,5_vs_5_medium
2771,-2,0,explt_v0_7_2_m54,2,medium_bots,5_vs_5_medium
2772,-1,0,explt_v0_7_2_m54,1,medium_bots,5_vs_5_medium
2773,0,0,explt_v0_7_2_m54,0,medium_bots,5_vs_5_medium
2774,1,1,explt_v0_7_2_m54,0,medium_bots,5_vs_5_medium
2775,0,0,explt_v0_7_2_m54,0,medium_bots,5_vs_5_medium
2776,-2,0,explt_v0_7_2_m54,2,medium_bots,5_vs_5_medium
2777,-1,0,explt_v0_7_2_m54,1,medium_bots,5_vs_5_medium
2778,0,0,explt_v0_7_2_m54,0,medium_bots,5_vs_5_medium
2779,-2,0,explt_v0_7_2_m54,2,medium_bots,5_vs_5_medium
2780,0,0,explt_v0_7_2_m54,0,hard_bots,5_vs_5_hard
2781,0,1,explt_v0_7_2_m54,1,hard_bots,5_vs_5_hard
2782,-4,0,explt_v0_7_2_m54,4,hard_bots,5_vs_5_hard
2783,-3,0,explt_v0_7_2_m54,3,hard_bots,5_vs_5_hard
2784,-1,0,explt_v0_7_2_m54,1,hard_bots,5_vs_5_hard
2785,-2,0,explt_v0_7_2_m54,2,hard_bots,5_vs_5_hard
2786,-2,0,explt_v0_7_2_m54,2,hard_bots,5_vs_5_hard
2787,-1,1,explt_v0_7_2_m54,2,hard_bots,5_vs_5_hard
2788,0,1,explt_v0_7_2_m54,1,hard_bots,5_vs_5_hard
2789,2,2,explt_v0_7_2_m54,0,hard_bots,5_vs_5_hard
2790,-1,0,explt_v0_7_2_m54,1,hard_bots,5_vs_5_hard
2791,1,1,explt_v0_7_2_m54,0,hard_bots,5_vs_5_hard
2792,-1,1,explt_v0_7_2_m54,2,hard_bots,5_vs_5_hard
2793,0,0,explt_v0_7_2_m54,0,hard_bots,5_vs_5_hard
2794,-2,0,explt_v0_7_2_m54,2,hard_bots,5_vs_5_hard
2795,1,2,explt_v0_7_2_m54,1,hard_bots,5_vs_5_hard
2796,0,0,explt_v0_7_2_m54,0,hard_bots,5_vs_5_hard
2797,-3,0,explt_v0_7_2_m54,3,hard_bots,5_vs_5_hard
2798,0,1,explt_v0_7_2_m54,1,hard_bots,5_vs_5_hard
2799,0,0,explt_v0_7_2_m54,0,hard_bots,5_vs_5_hard
2800,0,2,explt_v0_7_2_m54,2,f5v0to1to2t05_e2_ckpt291,5_vs_5
2801,1,1,explt_v0_7_2_m54,0,f5v0to1to2t05_e2_ckpt291,5_vs_5
2802,2,2,explt_v0_7_2_m54,0,f5v0to1to2t05_e2_ckpt291,5_vs_5
2803,3,3,explt_v0_7_2_m54,0,f5v0to1to2t05_e2_ckpt291,5_vs_5
2804,1,1,explt_v0_7_2_m54,0,f5v0to1to2t05_e2_ckpt291,5_vs_5
2805,2,3,explt_v0_7_2_m54,1,f5v0to1to2t05_e2_ckpt291,5_vs_5
2806,5,6,explt_v0_7_2_m54,1,f5v0to1to2t05_e2_ckpt291,5_vs_5
2807,1,1,explt_v0_7_2_m54,0,f5v0to1to2t05_e2_ckpt291,5_vs_5
2808,1,2,explt_v0_7_2_m54,1,f5v0to1to2t05_e2_ckpt291,5_vs_5
2809,0,1,explt_v0_7_2_m54,1,f5v0to1to2t05_e2_ckpt291,5_vs_5
2810,3,3,explt_v0_7_2_m54,0,f5v0to1to5_e2_ckpt252,5_vs_5
2811,0,1,explt_v0_7_2_m54,1,f5v0to1to5_e2_ckpt252,5_vs_5
2812,3,4,explt_v0_7_2_m54,1,f5v0to1to5_e2_ckpt252,5_vs_5
2813,3,3,explt_v0_7_2_m54,0,f5v0to1to5_e2_ckpt252,5_vs_5
2814,2,2,explt_v0_7_2_m54,0,f5v0to1to5_e2_ckpt252,5_vs_5
2815,2,2,explt_v0_7_2_m54,0,f5v0to1to5_e2_ckpt252,5_vs_5
2816,3,3,explt_v0_7_2_m54,0,f5v0to1to5_e2_ckpt252,5_vs_5
2817,1,1,explt_v0_7_2_m54,0,f5v0to1to5_e2_ckpt252,5_vs_5
2818,2,2,explt_v0_7_2_m54,0,f5v0to1to5_e2_ckpt252,5_vs_5
2819,1,2,explt_v0_7_2_m54,1,f5v0to1to5_e2_ckpt252,5_vs_5
2820,5,5,explt_v0_7_2_m54,0,scon_e3_p2_hard_ckpt840,5_vs_5
2821,2,2,explt_v0_7_2_m54,0,scon_e3_p2_hard_ckpt840,5_vs_5
2822,1,1,explt_v0_7_2_m54,0,scon_e3_p2_hard_ckpt840,5_vs_5
2823,2,2,explt_v0_7_2_m54,0,scon_e3_p2_hard_ckpt840,5_vs_5
2824,2,2,explt_v0_7_2_m54,0,scon_e3_p2_hard_ckpt840,5_vs_5
2825,1,1,explt_v0_7_2_m54,0,scon_e3_p2_hard_ckpt840,5_vs_5
2826,3,3,explt_v0_7_2_m54,0,scon_e3_p2_hard_ckpt840,5_vs_5
2827,2,2,explt_v0_7_2_m54,0,scon_e3_p2_hard_ckpt840,5_vs_5
2828,2,2,explt_v0_7_2_m54,0,scon_e3_p2_hard_ckpt840,5_vs_5
2829,3,3,explt_v0_7_2_m54,0,scon_e3_p2_hard_ckpt840,5_vs_5
2830,1,2,explt_v0_7_2_m54,1,less_then_partially_randomized_checkpoints_bots_4_heads_38_ckpt108,5_vs_5
2831,-1,1,explt_v0_7_2_m54,2,less_then_partially_randomized_checkpoints_bots_4_heads_38_ckpt108,5_vs_5
2832,2,2,explt_v0_7_2_m54,0,less_then_partially_randomized_checkpoints_bots_4_heads_38_ckpt108,5_vs_5
2833,0,0,explt_v0_7_2_m54,0,less_then_partially_randomized_checkpoints_bots_4_heads_38_ckpt108,5_vs_5
2834,2,2,explt_v0_7_2_m54,0,less_then_partially_randomized_checkpoints_bots_4_heads_38_ckpt108,5_vs_5
2835,1,1,explt_v0_7_2_m54,0,less_then_partially_randomized_checkpoints_bots_4_heads_38_ckpt108,5_vs_5
2836,2,3,explt_v0_7_2_m54,1,less_then_partially_randomized_checkpoints_bots_4_heads_38_ckpt108,5_vs_5
2837,3,3,explt_v0_7_2_m54,0,less_then_partially_randomized_checkpoints_bots_4_heads_38_ckpt108,5_vs_5
2838,0,2,explt_v0_7_2_m54,2,less_then_partially_randomized_checkpoints_bots_4_heads_38_ckpt108,5_vs_5
2839,2,3,explt_v0_7_2_m54,1,less_then_partially_randomized_checkpoints_bots_4_heads_38_ckpt108,5_vs_5
2840,2,2,explt_v0_7_2_m54,0,less_then_partially_randomized_entropy_checkpoints_bots_4_heads_39_ckpt109,5_vs_5
2841,6,6,explt_v0_7_2_m54,0,less_then_partially_randomized_entropy_checkpoints_bots_4_heads_39_ckpt109,5_vs_5
2842,-1,2,explt_v0_7_2_m54,3,less_then_partially_randomized_entropy_checkpoints_bots_4_heads_39_ckpt109,5_vs_5
2843,1,3,explt_v0_7_2_m54,2,less_then_partially_randomized_entropy_checkpoints_bots_4_heads_39_ckpt109,5_vs_5
2844,3,3,explt_v0_7_2_m54,0,less_then_partially_randomized_entropy_checkpoints_bots_4_heads_39_ckpt109,5_vs_5
2845,2,2,explt_v0_7_2_m54,0,less_then_partially_randomized_entropy_checkpoints_bots_4_heads_39_ckpt109,5_vs_5
2846,3,3,explt_v0_7_2_m54,0,less_then_partially_randomized_entropy_checkpoints_bots_4_heads_39_ckpt109,5_vs_5
2847,3,3,explt_v0_7_2_m54,0,less_then_partially_randomized_entropy_checkpoints_bots_4_heads_39_ckpt109,5_vs_5
2848,2,3,explt_v0_7_2_m54,1,less_then_partially_randomized_entropy_checkpoints_bots_4_heads_39_ckpt109,5_vs_5
2849,3,4,explt_v0_7_2_m54,1,less_then_partially_randomized_entropy_checkpoints_bots_4_heads_39_ckpt109,5_vs_5
2850,1,2,explt_v0_7_2_m54,1,reward_shaping_checkpoints_bots_4_heads_1_ckpt360,5_vs_5
2851,2,3,explt_v0_7_2_m54,1,reward_shaping_checkpoints_bots_4_heads_1_ckpt360,5_vs_5
2852,2,2,explt_v0_7_2_m54,0,reward_shaping_checkpoints_bots_4_heads_1_ckpt360,5_vs_5
2853,3,3,explt_v0_7_2_m54,0,reward_shaping_checkpoints_bots_4_heads_1_ckpt360,5_vs_5
2854,4,4,explt_v0_7_2_m54,0,reward_shaping_checkpoints_bots_4_heads_1_ckpt360,5_vs_5
2855,1,1,explt_v0_7_2_m54,0,reward_shaping_checkpoints_bots_4_heads_1_ckpt360,5_vs_5
2856,0,1,explt_v0_7_2_m54,1,reward_shaping_checkpoints_bots_4_heads_1_ckpt360,5_vs_5
2857,6,6,explt_v0_7_2_m54,0,reward_shaping_checkpoints_bots_4_heads_1_ckpt360,5_vs_5
2858,2,2,explt_v0_7_2_m54,0,reward_shaping_checkpoints_bots_4_heads_1_ckpt360,5_vs_5
2859,5,5,explt_v0_7_2_m54,0,reward_shaping_checkpoints_bots_4_heads_1_ckpt360,5_vs_5
2860,0,1,explt_v0_7_2_m54,1,checkpoints_selfplay_e9_sp_ckpt274,5_vs_5
2861,0,3,explt_v0_7_2_m54,3,checkpoints_selfplay_e9_sp_ckpt274,5_vs_5
2862,0,0,explt_v0_7_2_m54,0,checkpoints_selfplay_e9_sp_ckpt274,5_vs_5
2863,1,2,explt_v0_7_2_m54,1,checkpoints_selfplay_e9_sp_ckpt274,5_vs_5
2864,1,3,explt_v0_7_2_m54,2,checkpoints_selfplay_e9_sp_ckpt274,5_vs_5
2865,0,2,explt_v0_7_2_m54,2,checkpoints_selfplay_e9_sp_ckpt274,5_vs_5
2866,3,3,explt_v0_7_2_m54,0,checkpoints_selfplay_e9_sp_ckpt274,5_vs_5
2867,-2,1,explt_v0_7_2_m54,3,checkpoints_selfplay_e9_sp_ckpt274,5_vs_5
2868,4,5,explt_v0_7_2_m54,1,checkpoints_selfplay_e9_sp_ckpt274,5_vs_5
2869,-1,0,explt_v0_7_2_m54,1,checkpoints_selfplay_e9_sp_ckpt274,5_vs_5
2870,1,2,explt_v0_7_2_m54,1,checkpoints_sp_c_nb_e2_ckpt667,5_vs_5
2871,0,1,explt_v0_7_2_m54,1,checkpoints_sp_c_nb_e2_ckpt667,5_vs_5
2872,3,5,explt_v0_7_2_m54,2,checkpoints_sp_c_nb_e2_ckpt667,5_vs_5
2873,2,3,explt_v0_7_2_m54,1,checkpoints_sp_c_nb_e2_ckpt667,5_vs_5
2874,1,1,explt_v0_7_2_m54,0,checkpoints_sp_c_nb_e2_ckpt667,5_vs_5
2875,1,3,explt_v0_7_2_m54,2,checkpoints_sp_c_nb_e2_ckpt667,5_vs_5
2876,-1,0,explt_v0_7_2_m54,1,checkpoints_sp_c_nb_e2_ckpt667,5_vs_5
2877,2,2,explt_v0_7_2_m54,0,checkpoints_sp_c_nb_e2_ckpt667,5_vs_5
2878,-3,1,explt_v0_7_2_m54,4,checkpoints_sp_c_nb_e2_ckpt667,5_vs_5
2879,5,6,explt_v0_7_2_m54,1,checkpoints_sp_c_nb_e2_ckpt667,5_vs_5
2880,2,2,explt_v0_7_2_m54,0,scenario_curriculum_ckpt830,5_vs_5
2881,5,5,explt_v0_7_2_m54,0,scenario_curriculum_ckpt830,5_vs_5
2882,4,4,explt_v0_7_2_m54,0,scenario_curriculum_ckpt830,5_vs_5
2883,2,2,explt_v0_7_2_m54,0,scenario_curriculum_ckpt830,5_vs_5
2884,0,0,explt_v0_7_2_m54,0,scenario_curriculum_ckpt830,5_vs_5
2885,4,4,explt_v0_7_2_m54,0,scenario_curriculum_ckpt830,5_vs_5
2886,2,2,explt_v0_7_2_m54,0,scenario_curriculum_ckpt830,5_vs_5
2887,3,3,explt_v0_7_2_m54,0,scenario_curriculum_ckpt830,5_vs_5
2888,8,8,explt_v0_7_2_m54,0,scenario_curriculum_ckpt830,5_vs_5
2889,0,0,explt_v0_7_2_m54,0,scenario_curriculum_ckpt830,5_vs_5
2890,2,3,explt_v0_7_2_m54,1,m_sp_arch_medium_heads_conv16_0_bt_32_r313_m335,5_vs_5
2891,4,4,explt_v0_7_2_m54,0,m_sp_arch_medium_heads_conv16_0_bt_32_r313_m335,5_vs_5
2892,1,2,explt_v0_7_2_m54,1,m_sp_arch_medium_heads_conv16_0_bt_32_r313_m335,5_vs_5
2893,4,4,explt_v0_7_2_m54,0,m_sp_arch_medium_heads_conv16_0_bt_32_r313_m335,5_vs_5
2894,2,3,explt_v0_7_2_m54,1,m_sp_arch_medium_heads_conv16_0_bt_32_r313_m335,5_vs_5
2895,5,5,explt_v0_7_2_m54,0,m_sp_arch_medium_heads_conv16_0_bt_32_r313_m335,5_vs_5
2896,0,1,explt_v0_7_2_m54,1,m_sp_arch_medium_heads_conv16_0_bt_32_r313_m335,5_vs_5
2897,2,2,explt_v0_7_2_m54,0,m_sp_arch_medium_heads_conv16_0_bt_32_r313_m335,5_vs_5
2898,3,3,explt_v0_7_2_m54,0,m_sp_arch_medium_heads_conv16_0_bt_32_r313_m335,5_vs_5
2899,4,5,explt_v0_7_2_m54,1,m_sp_arch_medium_heads_conv16_0_bt_32_r313_m335,5_vs_5
2900,1,1,explt_v0_7_2_m54,0,m_sp_arch_longer_heads_bt_32_r201_m335,5_vs_5
2901,5,5,explt_v0_7_2_m54,0,m_sp_arch_longer_heads_bt_32_r201_m335,5_vs_5
2902,2,2,explt_v0_7_2_m54,0,m_sp_arch_longer_heads_bt_32_r201_m335,5_vs_5
2903,-1,0,explt_v0_7_2_m54,1,m_sp_arch_longer_heads_bt_32_r201_m335,5_vs_5
2904,2,3,explt_v0_7_2_m54,1,m_sp_arch_longer_heads_bt_32_r201_m335,5_vs_5
2905,1,2,explt_v0_7_2_m54,1,m_sp_arch_longer_heads_bt_32_r201_m335,5_vs_5
2906,2,2,explt_v0_7_2_m54,0,m_sp_arch_longer_heads_bt_32_r201_m335,5_vs_5
2907,2,2,explt_v0_7_2_m54,0,m_sp_arch_longer_heads_bt_32_r201_m335,5_vs_5
2908,1,2,explt_v0_7_2_m54,1,m_sp_arch_longer_heads_bt_32_r201_m335,5_vs_5
2909,0,0,explt_v0_7_2_m54,0,m_sp_arch_longer_heads_bt_32_r201_m335,5_vs_5
2910,2,2,explt_v0_7_2_m54,0,m_sp_arch_medium_heads_bt_32_r201_m335,5_vs_5
2911,1,3,explt_v0_7_2_m54,2,m_sp_arch_medium_heads_bt_32_r201_m335,5_vs_5
2912,2,2,explt_v0_7_2_m54,0,m_sp_arch_medium_heads_bt_32_r201_m335,5_vs_5
2913,5,5,explt_v0_7_2_m54,0,m_sp_arch_medium_heads_bt_32_r201_m335,5_vs_5
2914,1,2,explt_v0_7_2_m54,1,m_sp_arch_medium_heads_bt_32_r201_m335,5_vs_5
2915,3,4,explt_v0_7_2_m54,1,m_sp_arch_medium_heads_bt_32_r201_m335,5_vs_5
2916,6,6,explt_v0_7_2_m54,0,m_sp_arch_medium_heads_bt_32_r201_m335,5_vs_5
2917,1,3,explt_v0_7_2_m54,2,m_sp_arch_medium_heads_bt_32_r201_m335,5_vs_5
2918,3,4,explt_v0_7_2_m54,1,m_sp_arch_medium_heads_bt_32_r201_m335,5_vs_5
2919,3,3,explt_v0_7_2_m54,0,m_sp_arch_medium_heads_bt_32_r201_m335,5_vs_5
2920,3,3,explt_v0_7_2_m54,0,m_sp_arch_4x1_bt_32_r201_m335,5_vs_5
2921,0,2,explt_v0_7_2_m54,2,m_sp_arch_4x1_bt_32_r201_m335,5_vs_5
2922,3,3,explt_v0_7_2_m54,0,m_sp_arch_4x1_bt_32_r201_m335,5_vs_5
2923,2,2,explt_v0_7_2_m54,0,m_sp_arch_4x1_bt_32_r201_m335,5_vs_5
2924,3,3,explt_v0_7_2_m54,0,m_sp_arch_4x1_bt_32_r201_m335,5_vs_5
2925,2,2,explt_v0_7_2_m54,0,m_sp_arch_4x1_bt_32_r201_m335,5_vs_5
2926,0,1,explt_v0_7_2_m54,1,m_sp_arch_4x1_bt_32_r201_m335,5_vs_5
2927,1,3,explt_v0_7_2_m54,2,m_sp_arch_4x1_bt_32_r201_m335,5_vs_5
2928,0,3,explt_v0_7_2_m54,3,m_sp_arch_4x1_bt_32_r201_m335,5_vs_5
2929,3,4,explt_v0_7_2_m54,1,m_sp_arch_4x1_bt_32_r201_m335,5_vs_5
2930,1,2,explt_v0_7_2_m54,1,m_sp_arch_4x1_bt_32_r201_cont3_m650,5_vs_5
2931,0,0,explt_v0_7_2_m54,0,m_sp_arch_4x1_bt_32_r201_cont3_m650,5_vs_5
2932,0,1,explt_v0_7_2_m54,1,m_sp_arch_4x1_bt_32_r201_cont3_m650,5_vs_5
2933,1,1,explt_v0_7_2_m54,0,m_sp_arch_4x1_bt_32_r201_cont3_m650,5_vs_5
2934,1,3,explt_v0_7_2_m54,2,m_sp_arch_4x1_bt_32_r201_cont3_m650,5_vs_5
2935,3,3,explt_v0_7_2_m54,0,m_sp_arch_4x1_bt_32_r201_cont3_m650,5_vs_5
2936,-2,0,explt_v0_7_2_m54,2,m_sp_arch_4x1_bt_32_r201_cont3_m650,5_vs_5
2937,-1,2,explt_v0_7_2_m54,3,m_sp_arch_4x1_bt_32_r201_cont3_m650,5_vs_5
2938,1,3,explt_v0_7_2_m54,2,m_sp_arch_4x1_bt_32_r201_cont3_m650,5_vs_5
2939,1,2,explt_v0_7_2_m54,1,m_sp_arch_4x1_bt_32_r201_cont3_m650,5_vs_5
2940,0,2,explt_v0_7_2_m54,2,explt_v0_7_2_m54,5_vs_5
2941,1,2,explt_v0_7_2_m54,1,explt_v0_7_2_m54,5_vs_5
2942,2,3,explt_v0_7_2_m54,1,explt_v0_7_2_m54,5_vs_5
2943,2,2,explt_v0_7_2_m54,0,explt_v0_7_2_m54,5_vs_5
2944,0,3,explt_v0_7_2_m54,3,explt_v0_7_2_m54,5_vs_5
2945,1,1,explt_v0_7_2_m54,0,explt_v0_7_2_m54,5_vs_5
2946,2,3,explt_v0_7_2_m54,1,explt_v0_7_2_m54,5_vs_5
2947,0,2,explt_v0_7_2_m54,2,explt_v0_7_2_m54,5_vs_5
2948,-2,2,explt_v0_7_2_m54,4,explt_v0_7_2_m54,5_vs_5
2949,1,3,explt_v0_7_2_m54,2,explt_v0_7_2_m54,5_vs_5
2950,2,3,explt_v0_7_2_m54,1,m_sp_sc3v3_arch_2x1_32_r500_cont4x1_m224,5_vs_5
2951,-4,0,explt_v0_7_2_m54,4,m_sp_sc3v3_arch_2x1_32_r500_cont4x1_m224,5_vs_5
2952,-1,3,explt_v0_7_2_m54,4,m_sp_sc3v3_arch_2x1_32_r500_cont4x1_m224,5_vs_5
2953,0,2,explt_v0_7_2_m54,2,m_sp_sc3v3_arch_2x1_32_r500_cont4x1_m224,5_vs_5
2954,-3,1,explt_v0_7_2_m54,4,m_sp_sc3v3_arch_2x1_32_r500_cont4x1_m224,5_vs_5
2955,-2,0,explt_v0_7_2_m54,2,m_sp_sc3v3_arch_2x1_32_r500_cont4x1_m224,5_vs_5
2956,-2,2,explt_v0_7_2_m54,4,m_sp_sc3v3_arch_2x1_32_r500_cont4x1_m224,5_vs_5
2957,2,2,explt_v0_7_2_m54,0,m_sp_sc3v3_arch_2x1_32_r500_cont4x1_m224,5_vs_5
2958,-1,2,explt_v0_7_2_m54,3,m_sp_sc3v3_arch_2x1_32_r500_cont4x1_m224,5_vs_5
2959,2,2,explt_v0_7_2_m54,0,m_sp_sc3v3_arch_2x1_32_r500_cont4x1_m224,5_vs_5
2960,1,1,explt_v0_7_2_m54,0,m_sp_arch_4x1_bt_32_roles_r500_m335,5_vs_5
2961,-1,3,explt_v0_7_2_m54,4,m_sp_arch_4x1_bt_32_roles_r500_m335,5_vs_5
2962,-1,0,explt_v0_7_2_m54,1,m_sp_arch_4x1_bt_32_roles_r500_m335,5_vs_5
2963,-3,1,explt_v0_7_2_m54,4,m_sp_arch_4x1_bt_32_roles_r500_m335,5_vs_5
2964,0,2,explt_v0_7_2_m54,2,m_sp_arch_4x1_bt_32_roles_r500_m335,5_vs_5
2965,-1,2,explt_v0_7_2_m54,3,m_sp_arch_4x1_bt_32_roles_r500_m335,5_vs_5
2966,-2,1,explt_v0_7_2_m54,3,m_sp_arch_4x1_bt_32_roles_r500_m335,5_vs_5
2967,0,2,explt_v0_7_2_m54,2,m_sp_arch_4x1_bt_32_roles_r500_m335,5_vs_5
2968,-1,2,explt_v0_7_2_m54,3,m_sp_arch_4x1_bt_32_roles_r500_m335,5_vs_5
2969,0,1,explt_v0_7_2_m54,1,m_sp_arch_4x1_bt_32_roles_r500_m335,5_vs_5
2970,-2,1,m_sp_arch_medium_heads_bt_32_r201_m273_1370M,3,easy_bots,5_vs_5
2971,-1,0,m_sp_arch_medium_heads_bt_32_r201_m273_1370M,1,easy_bots,5_vs_5
2972,2,3,m_sp_arch_medium_heads_bt_32_r201_m273_1370M,1,easy_bots,5_vs_5
2973,1,1,m_sp_arch_medium_heads_bt_32_r201_m273_1370M,0,easy_bots,5_vs_5
2974,2,4,m_sp_arch_medium_heads_bt_32_r201_m273_1370M,2,easy_bots,5_vs_5
2975,0,2,m_sp_arch_medium_heads_bt_32_r201_m273_1370M,2,easy_bots,5_vs_5
2976,1,1,m_sp_arch_medium_heads_bt_32_r201_m273_1370M,0,easy_bots,5_vs_5
2977,1,3,m_sp_arch_medium_heads_bt_32_r201_m273_1370M,2,easy_bots,5_vs_5
2978,2,2,m_sp_arch_medium_heads_bt_32_r201_m273_1370M,0,easy_bots,5_vs_5
2979,-4,0,m_sp_arch_medium_heads_bt_32_r201_m273_1370M,4,easy_bots,5_vs_5
2980,3,3,m_sp_arch_medium_heads_bt_32_r201_m273_1370M,0,easy_bots,5_vs_5
2981,0,0,m_sp_arch_medium_heads_bt_32_r201_m273_1370M,0,easy_bots,5_vs_5
2982,2,3,m_sp_arch_medium_heads_bt_32_r201_m273_1370M,1,easy_bots,5_vs_5
2983,-1,0,m_sp_arch_medium_heads_bt_32_r201_m273_1370M,1,easy_bots,5_vs_5
2984,0,0,m_sp_arch_medium_heads_bt_32_r201_m273_1370M,0,easy_bots,5_vs_5
2985,-1,0,m_sp_arch_medium_heads_bt_32_r201_m273_1370M,1,easy_bots,5_vs_5
2986,3,3,m_sp_arch_medium_heads_bt_32_r201_m273_1370M,0,easy_bots,5_vs_5
2987,-1,0,m_sp_arch_medium_heads_bt_32_r201_m273_1370M,1,easy_bots,5_vs_5
2988,2,3,m_sp_arch_medium_heads_bt_32_r201_m273_1370M,1,easy_bots,5_vs_5
2989,-2,2,m_sp_arch_medium_heads_bt_32_r201_m273_1370M,4,easy_bots,5_vs_5
2990,0,1,m_sp_arch_medium_heads_bt_32_r201_m273_1370M,1,medium_bots,5_vs_5_medium
2991,-1,1,m_sp_arch_medium_heads_bt_32_r201_m273_1370M,2,medium_bots,5_vs_5_medium
2992,-2,1,m_sp_arch_medium_heads_bt_32_r201_m273_1370M,3,medium_bots,5_vs_5_medium
2993,-3,1,m_sp_arch_medium_heads_bt_32_r201_m273_1370M,4,medium_bots,5_vs_5_medium
2994,0,1,m_sp_arch_medium_heads_bt_32_r201_m273_1370M,1,medium_bots,5_vs_5_medium
2995,-2,0,m_sp_arch_medium_heads_bt_32_r201_m273_1370M,2,medium_bots,5_vs_5_medium
2996,-2,0,m_sp_arch_medium_heads_bt_32_r201_m273_1370M,2,medium_bots,5_vs_5_medium
2997,-1,0,m_sp_arch_medium_heads_bt_32_r201_m273_1370M,1,medium_bots,5_vs_5_medium
2998,0,0,m_sp_arch_medium_heads_bt_32_r201_m273_1370M,0,medium_bots,5_vs_5_medium
2999,-1,0,m_sp_arch_medium_heads_bt_32_r201_m273_1370M,1,medium_bots,5_vs_5_medium
3000,-1,0,m_sp_arch_medium_heads_bt_32_r201_m273_1370M,1,medium_bots,5_vs_5_medium
3001,-4,1,m_sp_arch_medium_heads_bt_32_r201_m273_1370M,5,medium_bots,5_vs_5_medium
3002,0,3,m_sp_arch_medium_heads_bt_32_r201_m273_1370M,3,medium_bots,5_vs_5_medium
3003,0,0,m_sp_arch_medium_heads_bt_32_r201_m273_1370M,0,medium_bots,5_vs_5_medium
3004,-1,0,m_sp_arch_medium_heads_bt_32_r201_m273_1370M,1,medium_bots,5_vs_5_medium
3005,-2,0,m_sp_arch_medium_heads_bt_32_r201_m273_1370M,2,medium_bots,5_vs_5_medium
3006,0,1,m_sp_arch_medium_heads_bt_32_r201_m273_1370M,1,medium_bots,5_vs_5_medium
3007,-1,0,m_sp_arch_medium_heads_bt_32_r201_m273_1370M,1,medium_bots,5_vs_5_medium
3008,-1,1,m_sp_arch_medium_heads_bt_32_r201_m273_1370M,2,medium_bots,5_vs_5_medium
3009,1,1,m_sp_arch_medium_heads_bt_32_r201_m273_1370M,0,medium_bots,5_vs_5_medium
3010,0,0,m_sp_arch_medium_heads_bt_32_r201_m273_1370M,0,hard_bots,5_vs_5_hard
3011,0,2,m_sp_arch_medium_heads_bt_32_r201_m273_1370M,2,hard_bots,5_vs_5_hard
3012,-1,0,m_sp_arch_medium_heads_bt_32_r201_m273_1370M,1,hard_bots,5_vs_5_hard
3013,1,2,m_sp_arch_medium_heads_bt_32_r201_m273_1370M,1,hard_bots,5_vs_5_hard
3014,-2,0,m_sp_arch_medium_heads_bt_32_r201_m273_1370M,2,hard_bots,5_vs_5_hard
3015,0,0,m_sp_arch_medium_heads_bt_32_r201_m273_1370M,0,hard_bots,5_vs_5_hard
3016,-1,1,m_sp_arch_medium_heads_bt_32_r201_m273_1370M,2,hard_bots,5_vs_5_hard
3017,-1,1,m_sp_arch_medium_heads_bt_32_r201_m273_1370M,2,hard_bots,5_vs_5_hard
3018,-2,1,m_sp_arch_medium_heads_bt_32_r201_m273_1370M,3,hard_bots,5_vs_5_hard
3019,-1,0,m_sp_arch_medium_heads_bt_32_r201_m273_1370M,1,hard_bots,5_vs_5_hard
3020,1,3,m_sp_arch_medium_heads_bt_32_r201_m273_1370M,2,hard_bots,5_vs_5_hard
3021,0,0,m_sp_arch_medium_heads_bt_32_r201_m273_1370M,0,hard_bots,5_vs_5_hard
3022,-1,1,m_sp_arch_medium_heads_bt_32_r201_m273_1370M,2,hard_bots,5_vs_5_hard
3023,-1,1,m_sp_arch_medium_heads_bt_32_r201_m273_1370M,2,hard_bots,5_vs_5_hard
3024,-1,1,m_sp_arch_medium_heads_bt_32_r201_m273_1370M,2,hard_bots,5_vs_5_hard
3025,0,1,m_sp_arch_medium_heads_bt_32_r201_m273_1370M,1,hard_bots,5_vs_5_hard
3026,-1,0,m_sp_arch_medium_heads_bt_32_r201_m273_1370M,1,hard_bots,5_vs_5_hard
3027,-2,1,m_sp_arch_medium_heads_bt_32_r201_m273_1370M,3,hard_bots,5_vs_5_hard
3028,-4,0,m_sp_arch_medium_heads_bt_32_r201_m273_1370M,4,hard_bots,5_vs_5_hard
3029,-1,0,m_sp_arch_medium_heads_bt_32_r201_m273_1370M,1,hard_bots,5_vs_5_hard
3030,7,7,m_sp_arch_medium_heads_bt_32_r201_m273_1370M,0,f5v0to1to2t05_e2_ckpt291,5_vs_5
3031,2,4,m_sp_arch_medium_heads_bt_32_r201_m273_1370M,2,f5v0to1to2t05_e2_ckpt291,5_vs_5
3032,5,7,m_sp_arch_medium_heads_bt_32_r201_m273_1370M,2,f5v0to1to2t05_e2_ckpt291,5_vs_5
3033,3,6,m_sp_arch_medium_heads_bt_32_r201_m273_1370M,3,f5v0to1to2t05_e2_ckpt291,5_vs_5
3034,0,4,m_sp_arch_medium_heads_bt_32_r201_m273_1370M,4,f5v0to1to2t05_e2_ckpt291,5_vs_5
3035,3,5,m_sp_arch_medium_heads_bt_32_r201_m273_1370M,2,f5v0to1to2t05_e2_ckpt291,5_vs_5
3036,-1,0,m_sp_arch_medium_heads_bt_32_r201_m273_1370M,1,f5v0to1to2t05_e2_ckpt291,5_vs_5
3037,5,7,m_sp_arch_medium_heads_bt_32_r201_m273_1370M,2,f5v0to1to2t05_e2_ckpt291,5_vs_5
3038,3,7,m_sp_arch_medium_heads_bt_32_r201_m273_1370M,4,f5v0to1to2t05_e2_ckpt291,5_vs_5
3039,6,6,m_sp_arch_medium_heads_bt_32_r201_m273_1370M,0,f5v0to1to2t05_e2_ckpt291,5_vs_5
3040,7,8,m_sp_arch_medium_heads_bt_32_r201_m273_1370M,1,f5v0to1to2t05_e2_ckpt291,5_vs_5
3041,7,8,m_sp_arch_medium_heads_bt_32_r201_m273_1370M,1,f5v0to1to2t05_e2_ckpt291,5_vs_5
3042,3,5,m_sp_arch_medium_heads_bt_32_r201_m273_1370M,2,f5v0to1to2t05_e2_ckpt291,5_vs_5
3043,5,8,m_sp_arch_medium_heads_bt_32_r201_m273_1370M,3,f5v0to1to2t05_e2_ckpt291,5_vs_5
3044,8,10,m_sp_arch_medium_heads_bt_32_r201_m273_1370M,2,f5v0to1to2t05_e2_ckpt291,5_vs_5
3045,1,5,m_sp_arch_medium_heads_bt_32_r201_m273_1370M,4,f5v0to1to2t05_e2_ckpt291,5_vs_5
3046,1,5,m_sp_arch_medium_heads_bt_32_r201_m273_1370M,4,f5v0to1to2t05_e2_ckpt291,5_vs_5
3047,1,5,m_sp_arch_medium_heads_bt_32_r201_m273_1370M,4,f5v0to1to2t05_e2_ckpt291,5_vs_5
3048,5,8,m_sp_arch_medium_heads_bt_32_r201_m273_1370M,3,f5v0to1to2t05_e2_ckpt291,5_vs_5
3049,5,8,m_sp_arch_medium_heads_bt_32_r201_m273_1370M,3,f5v0to1to2t05_e2_ckpt291,5_vs_5
3050,6,8,m_sp_arch_medium_heads_bt_32_r201_m273_1370M,2,f5v0to1to5_e2_ckpt252,5_vs_5
3051,1,4,m_sp_arch_medium_heads_bt_32_r201_m273_1370M,3,f5v0to1to5_e2_ckpt252,5_vs_5
3052,3,7,m_sp_arch_medium_heads_bt_32_r201_m273_1370M,4,f5v0to1to5_e2_ckpt252,5_vs_5
3053,3,7,m_sp_arch_medium_heads_bt_32_r201_m273_1370M,4,f5v0to1to5_e2_ckpt252,5_vs_5
3054,5,8,m_sp_arch_medium_heads_bt_32_r201_m273_1370M,3,f5v0to1to5_e2_ckpt252,5_vs_5
3055,1,4,m_sp_arch_medium_heads_bt_32_r201_m273_1370M,3,f5v0to1to5_e2_ckpt252,5_vs_5
3056,2,5,m_sp_arch_medium_heads_bt_32_r201_m273_1370M,3,f5v0to1to5_e2_ckpt252,5_vs_5
3057,2,3,m_sp_arch_medium_heads_bt_32_r201_m273_1370M,1,f5v0to1to5_e2_ckpt252,5_vs_5
3058,0,4,m_sp_arch_medium_heads_bt_32_r201_m273_1370M,4,f5v0to1to5_e2_ckpt252,5_vs_5
3059,5,6,m_sp_arch_medium_heads_bt_32_r201_m273_1370M,1,f5v0to1to5_e2_ckpt252,5_vs_5
3060,5,9,m_sp_arch_medium_heads_bt_32_r201_m273_1370M,4,f5v0to1to5_e2_ckpt252,5_vs_5
3061,5,10,m_sp_arch_medium_heads_bt_32_r201_m273_1370M,5,f5v0to1to5_e2_ckpt252,5_vs_5
3062,1,6,m_sp_arch_medium_heads_bt_32_r201_m273_1370M,5,f5v0to1to5_e2_ckpt252,5_vs_5
3063,1,6,m_sp_arch_medium_heads_bt_32_r201_m273_1370M,5,f5v0to1to5_e2_ckpt252,5_vs_5
3064,4,5,m_sp_arch_medium_heads_bt_32_r201_m273_1370M,1,f5v0to1to5_e2_ckpt252,5_vs_5
3065,0,2,m_sp_arch_medium_heads_bt_32_r201_m273_1370M,2,f5v0to1to5_e2_ckpt252,5_vs_5
3066,9,10,m_sp_arch_medium_heads_bt_32_r201_m273_1370M,1,f5v0to1to5_e2_ckpt252,5_vs_5
3067,2,5,m_sp_arch_medium_heads_bt_32_r201_m273_1370M,3,f5v0to1to5_e2_ckpt252,5_vs_5
3068,1,4,m_sp_arch_medium_heads_bt_32_r201_m273_1370M,3,f5v0to1to5_e2_ckpt252,5_vs_5
3069,2,5,m_sp_arch_medium_heads_bt_32_r201_m273_1370M,3,f5v0to1to5_e2_ckpt252,5_vs_5
3070,7,9,m_sp_arch_medium_heads_bt_32_r201_m273_1370M,2,scon_e3_p2_hard_ckpt840,5_vs_5
3071,2,5,m_sp_arch_medium_heads_bt_32_r201_m273_1370M,3,scon_e3_p2_hard_ckpt840,5_vs_5
3072,3,4,m_sp_arch_medium_heads_bt_32_r201_m273_1370M,1,scon_e3_p2_hard_ckpt840,5_vs_5
3073,7,8,m_sp_arch_medium_heads_bt_32_r201_m273_1370M,1,scon_e3_p2_hard_ckpt840,5_vs_5
3074,4,6,m_sp_arch_medium_heads_bt_32_r201_m273_1370M,2,scon_e3_p2_hard_ckpt840,5_vs_5
3075,4,8,m_sp_arch_medium_heads_bt_32_r201_m273_1370M,4,scon_e3_p2_hard_ckpt840,5_vs_5
3076,6,6,m_sp_arch_medium_heads_bt_32_r201_m273_1370M,0,scon_e3_p2_hard_ckpt840,5_vs_5
3077,6,7,m_sp_arch_medium_heads_bt_32_r201_m273_1370M,1,scon_e3_p2_hard_ckpt840,5_vs_5
3078,5,7,m_sp_arch_medium_heads_bt_32_r201_m273_1370M,2,scon_e3_p2_hard_ckpt840,5_vs_5
3079,5,8,m_sp_arch_medium_heads_bt_32_r201_m273_1370M,3,scon_e3_p2_hard_ckpt840,5_vs_5
3080,3,5,m_sp_arch_medium_heads_bt_32_r201_m273_1370M,2,scon_e3_p2_hard_ckpt840,5_vs_5
3081,7,8,m_sp_arch_medium_heads_bt_32_r201_m273_1370M,1,scon_e3_p2_hard_ckpt840,5_vs_5
3082,6,8,m_sp_arch_medium_heads_bt_32_r201_m273_1370M,2,scon_e3_p2_hard_ckpt840,5_vs_5
3083,4,5,m_sp_arch_medium_heads_bt_32_r201_m273_1370M,1,scon_e3_p2_hard_ckpt840,5_vs_5
3084,2,6,m_sp_arch_medium_heads_bt_32_r201_m273_1370M,4,scon_e3_p2_hard_ckpt840,5_vs_5
3085,1,3,m_sp_arch_medium_heads_bt_32_r201_m273_1370M,2,scon_e3_p2_hard_ckpt840,5_vs_5
3086,2,3,m_sp_arch_medium_heads_bt_32_r201_m273_1370M,1,scon_e3_p2_hard_ckpt840,5_vs_5
3087,1,2,m_sp_arch_medium_heads_bt_32_r201_m273_1370M,1,scon_e3_p2_hard_ckpt840,5_vs_5
3088,2,6,m_sp_arch_medium_heads_bt_32_r201_m273_1370M,4,scon_e3_p2_hard_ckpt840,5_vs_5
3089,2,2,m_sp_arch_medium_heads_bt_32_r201_m273_1370M,0,scon_e3_p2_hard_ckpt840,5_vs_5
3090,2,7,m_sp_arch_medium_heads_bt_32_r201_m273_1370M,5,less_then_partially_randomized_checkpoints_bots_4_heads_38_ckpt108,5_vs_5
3091,2,5,m_sp_arch_medium_heads_bt_32_r201_m273_1370M,3,less_then_partially_randomized_checkpoints_bots_4_heads_38_ckpt108,5_vs_5
3092,6,7,m_sp_arch_medium_heads_bt_32_r201_m273_1370M,1,less_then_partially_randomized_checkpoints_bots_4_heads_38_ckpt108,5_vs_5
3093,8,9,m_sp_arch_medium_heads_bt_32_r201_m273_1370M,1,less_then_partially_randomized_checkpoints_bots_4_heads_38_ckpt108,5_vs_5
3094,9,12,m_sp_arch_medium_heads_bt_32_r201_m273_1370M,3,less_then_partially_randomized_checkpoints_bots_4_heads_38_ckpt108,5_vs_5
3095,3,5,m_sp_arch_medium_heads_bt_32_r201_m273_1370M,2,less_then_partially_randomized_checkpoints_bots_4_heads_38_ckpt108,5_vs_5
3096,6,9,m_sp_arch_medium_heads_bt_32_r201_m273_1370M,3,less_then_partially_randomized_checkpoints_bots_4_heads_38_ckpt108,5_vs_5
3097,2,8,m_sp_arch_medium_heads_bt_32_r201_m273_1370M,6,less_then_partially_randomized_checkpoints_bots_4_heads_38_ckpt108,5_vs_5
3098,4,6,m_sp_arch_medium_heads_bt_32_r201_m273_1370M,2,less_then_partially_randomized_checkpoints_bots_4_heads_38_ckpt108,5_vs_5
3099,4,5,m_sp_arch_medium_heads_bt_32_r201_m273_1370M,1,less_then_partially_randomized_checkpoints_bots_4_heads_38_ckpt108,5_vs_5
3100,2,5,m_sp_arch_medium_heads_bt_32_r201_m273_1370M,3,less_then_partially_randomized_checkpoints_bots_4_heads_38_ckpt108,5_vs_5
3101,2,6,m_sp_arch_medium_heads_bt_32_r201_m273_1370M,4,less_then_partially_randomized_checkpoints_bots_4_heads_38_ckpt108,5_vs_5
3102,2,4,m_sp_arch_medium_heads_bt_32_r201_m273_1370M,2,less_then_partially_randomized_checkpoints_bots_4_heads_38_ckpt108,5_vs_5
3103,8,8,m_sp_arch_medium_heads_bt_32_r201_m273_1370M,0,less_then_partially_randomized_checkpoints_bots_4_heads_38_ckpt108,5_vs_5
3104,7,8,m_sp_arch_medium_heads_bt_32_r201_m273_1370M,1,less_then_partially_randomized_checkpoints_bots_4_heads_38_ckpt108,5_vs_5
3105,5,7,m_sp_arch_medium_heads_bt_32_r201_m273_1370M,2,less_then_partially_randomized_checkpoints_bots_4_heads_38_ckpt108,5_vs_5
3106,2,7,m_sp_arch_medium_heads_bt_32_r201_m273_1370M,5,less_then_partially_randomized_checkpoints_bots_4_heads_38_ckpt108,5_vs_5
3107,4,6,m_sp_arch_medium_heads_bt_32_r201_m273_1370M,2,less_then_partially_randomized_checkpoints_bots_4_heads_38_ckpt108,5_vs_5
3108,2,6,m_sp_arch_medium_heads_bt_32_r201_m273_1370M,4,less_then_partially_randomized_checkpoints_bots_4_heads_38_ckpt108,5_vs_5
3109,3,5,m_sp_arch_medium_heads_bt_32_r201_m273_1370M,2,less_then_partially_randomized_checkpoints_bots_4_heads_38_ckpt108,5_vs_5
3110,8,9,m_sp_arch_medium_heads_bt_32_r201_m273_1370M,1,less_then_partially_randomized_entropy_checkpoints_bots_4_heads_39_ckpt109,5_vs_5
3111,5,7,m_sp_arch_medium_heads_bt_32_r201_m273_1370M,2,less_then_partially_randomized_entropy_checkpoints_bots_4_heads_39_ckpt109,5_vs_5
3112,3,7,m_sp_arch_medium_heads_bt_32_r201_m273_1370M,4,less_then_partially_randomized_entropy_checkpoints_bots_4_heads_39_ckpt109,5_vs_5
3113,0,2,m_sp_arch_medium_heads_bt_32_r201_m273_1370M,2,less_then_partially_randomized_entropy_checkpoints_bots_4_heads_39_ckpt109,5_vs_5
3114,8,11,m_sp_arch_medium_heads_bt_32_r201_m273_1370M,3,less_then_partially_randomized_entropy_checkpoints_bots_4_heads_39_ckpt109,5_vs_5
3115,2,6,m_sp_arch_medium_heads_bt_32_r201_m273_1370M,4,less_then_partially_randomized_entropy_checkpoints_bots_4_heads_39_ckpt109,5_vs_5
3116,5,9,m_sp_arch_medium_heads_bt_32_r201_m273_1370M,4,less_then_partially_randomized_entropy_checkpoints_bots_4_heads_39_ckpt109,5_vs_5
3117,8,10,m_sp_arch_medium_heads_bt_32_r201_m273_1370M,2,less_then_partially_randomized_entropy_checkpoints_bots_4_heads_39_ckpt109,5_vs_5
3118,5,7,m_sp_arch_medium_heads_bt_32_r201_m273_1370M,2,less_then_partially_randomized_entropy_checkpoints_bots_4_heads_39_ckpt109,5_vs_5
3119,3,5,m_sp_arch_medium_heads_bt_32_r201_m273_1370M,2,less_then_partially_randomized_entropy_checkpoints_bots_4_heads_39_ckpt109,5_vs_5
3120,5,8,m_sp_arch_medium_heads_bt_32_r201_m273_1370M,3,less_then_partially_randomized_entropy_checkpoints_bots_4_heads_39_ckpt109,5_vs_5
3121,-1,3,m_sp_arch_medium_heads_bt_32_r201_m273_1370M,4,less_then_partially_randomized_entropy_checkpoints_bots_4_heads_39_ckpt109,5_vs_5
3122,0,3,m_sp_arch_medium_heads_bt_32_r201_m273_1370M,3,less_then_partially_randomized_entropy_checkpoints_bots_4_heads_39_ckpt109,5_vs_5
3123,10,12,m_sp_arch_medium_heads_bt_32_r201_m273_1370M,2,less_then_partially_randomized_entropy_checkpoints_bots_4_heads_39_ckpt109,5_vs_5
3124,5,7,m_sp_arch_medium_heads_bt_32_r201_m273_1370M,2,less_then_partially_randomized_entropy_checkpoints_bots_4_heads_39_ckpt109,5_vs_5
3125,5,8,m_sp_arch_medium_heads_bt_32_r201_m273_1370M,3,less_then_partially_randomized_entropy_checkpoints_bots_4_heads_39_ckpt109,5_vs_5
3126,0,6,m_sp_arch_medium_heads_bt_32_r201_m273_1370M,6,less_then_partially_randomized_entropy_checkpoints_bots_4_heads_39_ckpt109,5_vs_5
3127,8,12,m_sp_arch_medium_heads_bt_32_r201_m273_1370M,4,less_then_partially_randomized_entropy_checkpoints_bots_4_heads_39_ckpt109,5_vs_5
3128,7,7,m_sp_arch_medium_heads_bt_32_r201_m273_1370M,0,less_then_partially_randomized_entropy_checkpoints_bots_4_heads_39_ckpt109,5_vs_5
3129,3,8,m_sp_arch_medium_heads_bt_32_r201_m273_1370M,5,less_then_partially_randomized_entropy_checkpoints_bots_4_heads_39_ckpt109,5_vs_5
3130,6,6,m_sp_arch_medium_heads_bt_32_r201_m273_1370M,0,reward_shaping_checkpoints_bots_4_heads_1_ckpt360,5_vs_5
3131,4,7,m_sp_arch_medium_heads_bt_32_r201_m273_1370M,3,reward_shaping_checkpoints_bots_4_heads_1_ckpt360,5_vs_5
3132,8,9,m_sp_arch_medium_heads_bt_32_r201_m273_1370M,1,reward_shaping_checkpoints_bots_4_heads_1_ckpt360,5_vs_5
3133,6,7,m_sp_arch_medium_heads_bt_32_r201_m273_1370M,1,reward_shaping_checkpoints_bots_4_heads_1_ckpt360,5_vs_5
3134,6,7,m_sp_arch_medium_heads_bt_32_r201_m273_1370M,1,reward_shaping_checkpoints_bots_4_heads_1_ckpt360,5_vs_5
3135,4,6,m_sp_arch_medium_heads_bt_32_r201_m273_1370M,2,reward_shaping_checkpoints_bots_4_heads_1_ckpt360,5_vs_5
3136,6,8,m_sp_arch_medium_heads_bt_32_r201_m273_1370M,2,reward_shaping_checkpoints_bots_4_heads_1_ckpt360,5_vs_5
3137,1,3,m_sp_arch_medium_heads_bt_32_r201_m273_1370M,2,reward_shaping_checkpoints_bots_4_heads_1_ckpt360,5_vs_5
3138,6,8,m_sp_arch_medium_heads_bt_32_r201_m273_1370M,2,reward_shaping_checkpoints_bots_4_heads_1_ckpt360,5_vs_5
3139,8,8,m_sp_arch_medium_heads_bt_32_r201_m273_1370M,0,reward_shaping_checkpoints_bots_4_heads_1_ckpt360,5_vs_5
3140,4,7,m_sp_arch_medium_heads_bt_32_r201_m273_1370M,3,reward_shaping_checkpoints_bots_4_heads_1_ckpt360,5_vs_5
3141,2,5,m_sp_arch_medium_heads_bt_32_r201_m273_1370M,3,reward_shaping_checkpoints_bots_4_heads_1_ckpt360,5_vs_5
3142,9,10,m_sp_arch_medium_heads_bt_32_r201_m273_1370M,1,reward_shaping_checkpoints_bots_4_heads_1_ckpt360,5_vs_5
3143,5,6,m_sp_arch_medium_heads_bt_32_r201_m273_1370M,1,reward_shaping_checkpoints_bots_4_heads_1_ckpt360,5_vs_5
3144,8,8,m_sp_arch_medium_heads_bt_32_r201_m273_1370M,0,reward_shaping_checkpoints_bots_4_heads_1_ckpt360,5_vs_5
3145,5,6,m_sp_arch_medium_heads_bt_32_r201_m273_1370M,1,reward_shaping_checkpoints_bots_4_heads_1_ckpt360,5_vs_5
3146,8,9,m_sp_arch_medium_heads_bt_32_r201_m273_1370M,1,reward_shaping_checkpoints_bots_4_heads_1_ckpt360,5_vs_5
3147,6,8,m_sp_arch_medium_heads_bt_32_r201_m273_1370M,2,reward_shaping_checkpoints_bots_4_heads_1_ckpt360,5_vs_5
3148,7,8,m_sp_arch_medium_heads_bt_32_r201_m273_1370M,1,reward_shaping_checkpoints_bots_4_heads_1_ckpt360,5_vs_5
3149,2,4,m_sp_arch_medium_heads_bt_32_r201_m273_1370M,2,reward_shaping_checkpoints_bots_4_heads_1_ckpt360,5_vs_5
3150,-7,0,m_sp_arch_medium_heads_bt_32_r201_m273_1370M,7,checkpoints_selfplay_e9_sp_ckpt274,5_vs_5
3151,-10,0,m_sp_arch_medium_heads_bt_32_r201_m273_1370M,10,checkpoints_selfplay_e9_sp_ckpt274,5_vs_5
3152,-5,2,m_sp_arch_medium_heads_bt_32_r201_m273_1370M,7,checkpoints_selfplay_e9_sp_ckpt274,5_vs_5
3153,-8,2,m_sp_arch_medium_heads_bt_32_r201_m273_1370M,10,checkpoints_selfplay_e9_sp_ckpt274,5_vs_5
3154,-2,3,m_sp_arch_medium_heads_bt_32_r201_m273_1370M,5,checkpoints_selfplay_e9_sp_ckpt274,5_vs_5
3155,-10,2,m_sp_arch_medium_heads_bt_32_r201_m273_1370M,12,checkpoints_selfplay_e9_sp_ckpt274,5_vs_5
3156,-3,2,m_sp_arch_medium_heads_bt_32_r201_m273_1370M,5,checkpoints_selfplay_e9_sp_ckpt274,5_vs_5
3157,-5,2,m_sp_arch_medium_heads_bt_32_r201_m273_1370M,7,checkpoints_selfplay_e9_sp_ckpt274,5_vs_5
3158,-8,4,m_sp_arch_medium_heads_bt_32_r201_m273_1370M,12,checkpoints_selfplay_e9_sp_ckpt274,5_vs_5
3159,-6,3,m_sp_arch_medium_heads_bt_32_r201_m273_1370M,9,checkpoints_selfplay_e9_sp_ckpt274,5_vs_5
3160,-8,2,m_sp_arch_medium_heads_bt_32_r201_m273_1370M,10,checkpoints_selfplay_e9_sp_ckpt274,5_vs_5
3161,-2,1,m_sp_arch_medium_heads_bt_32_r201_m273_1370M,3,checkpoints_selfplay_e9_sp_ckpt274,5_vs_5
3162,-5,1,m_sp_arch_medium_heads_bt_32_r201_m273_1370M,6,checkpoints_selfplay_e9_sp_ckpt274,5_vs_5
3163,-3,4,m_sp_arch_medium_heads_bt_32_r201_m273_1370M,7,checkpoints_selfplay_e9_sp_ckpt274,5_vs_5
3164,-4,4,m_sp_arch_medium_heads_bt_32_r201_m273_1370M,8,checkpoints_selfplay_e9_sp_ckpt274,5_vs_5
3165,-6,1,m_sp_arch_medium_heads_bt_32_r201_m273_1370M,7,checkpoints_selfplay_e9_sp_ckpt274,5_vs_5
3166,-10,1,m_sp_arch_medium_heads_bt_32_r201_m273_1370M,11,checkpoints_selfplay_e9_sp_ckpt274,5_vs_5
3167,-2,2,m_sp_arch_medium_heads_bt_32_r201_m273_1370M,4,checkpoints_selfplay_e9_sp_ckpt274,5_vs_5
3168,-6,0,m_sp_arch_medium_heads_bt_32_r201_m273_1370M,6,checkpoints_selfplay_e9_sp_ckpt274,5_vs_5
3169,-8,2,m_sp_arch_medium_heads_bt_32_r201_m273_1370M,10,checkpoints_selfplay_e9_sp_ckpt274,5_vs_5
3170,2,5,m_sp_arch_medium_heads_bt_32_r201_m273_1370M,3,checkpoints_selfplay_e9_sp_ckpt335_1370M,5_vs_5
3171,-3,0,m_sp_arch_medium_heads_bt_32_r201_m273_1370M,3,checkpoints_selfplay_e9_sp_ckpt335_1370M,5_vs_5
3172,-6,2,m_sp_arch_medium_heads_bt_32_r201_m273_1370M,8,checkpoints_selfplay_e9_sp_ckpt335_1370M,5_vs_5
3173,-3,2,m_sp_arch_medium_heads_bt_32_r201_m273_1370M,5,checkpoints_selfplay_e9_sp_ckpt335_1370M,5_vs_5
3174,-6,3,m_sp_arch_medium_heads_bt_32_r201_m273_1370M,9,checkpoints_selfplay_e9_sp_ckpt335_1370M,5_vs_5
3175,-9,2,m_sp_arch_medium_heads_bt_32_r201_m273_1370M,11,checkpoints_selfplay_e9_sp_ckpt335_1370M,5_vs_5
3176,-5,1,m_sp_arch_medium_heads_bt_32_r201_m273_1370M,6,checkpoints_selfplay_e9_sp_ckpt335_1370M,5_vs_5
3177,-8,2,m_sp_arch_medium_heads_bt_32_r201_m273_1370M,10,checkpoints_selfplay_e9_sp_ckpt335_1370M,5_vs_5
3178,-8,1,m_sp_arch_medium_heads_bt_32_r201_m273_1370M,9,checkpoints_selfplay_e9_sp_ckpt335_1370M,5_vs_5
3179,-9,1,m_sp_arch_medium_heads_bt_32_r201_m273_1370M,10,checkpoints_selfplay_e9_sp_ckpt335_1370M,5_vs_5
3180,-9,0,m_sp_arch_medium_heads_bt_32_r201_m273_1370M,9,checkpoints_selfplay_e9_sp_ckpt335_1370M,5_vs_5
3181,-7,4,m_sp_arch_medium_heads_bt_32_r201_m273_1370M,11,checkpoints_selfplay_e9_sp_ckpt335_1370M,5_vs_5
3182,-4,5,m_sp_arch_medium_heads_bt_32_r201_m273_1370M,9,checkpoints_selfplay_e9_sp_ckpt335_1370M,5_vs_5
3183,-9,2,m_sp_arch_medium_heads_bt_32_r201_m273_1370M,11,checkpoints_selfplay_e9_sp_ckpt335_1370M,5_vs_5
3184,-8,0,m_sp_arch_medium_heads_bt_32_r201_m273_1370M,8,checkpoints_selfplay_e9_sp_ckpt335_1370M,5_vs_5
3185,-6,0,m_sp_arch_medium_heads_bt_32_r201_m273_1370M,6,checkpoints_selfplay_e9_sp_ckpt335_1370M,5_vs_5
3186,-8,0,m_sp_arch_medium_heads_bt_32_r201_m273_1370M,8,checkpoints_selfplay_e9_sp_ckpt335_1370M,5_vs_5
3187,-7,0,m_sp_arch_medium_heads_bt_32_r201_m273_1370M,7,checkpoints_selfplay_e9_sp_ckpt335_1370M,5_vs_5
3188,-6,2,m_sp_arch_medium_heads_bt_32_r201_m273_1370M,8,checkpoints_selfplay_e9_sp_ckpt335_1370M,5_vs_5
3189,-4,4,m_sp_arch_medium_heads_bt_32_r201_m273_1370M,8,checkpoints_selfplay_e9_sp_ckpt335_1370M,5_vs_5
3190,-6,0,m_sp_arch_medium_heads_bt_32_r201_m273_1370M,6,checkpoints_sp_c_nb_e2_ckpt667,5_vs_5
3191,-8,1,m_sp_arch_medium_heads_bt_32_r201_m273_1370M,9,checkpoints_sp_c_nb_e2_ckpt667,5_vs_5
3192,-11,0,m_sp_arch_medium_heads_bt_32_r201_m273_1370M,11,checkpoints_sp_c_nb_e2_ckpt667,5_vs_5
3193,-7,1,m_sp_arch_medium_heads_bt_32_r201_m273_1370M,8,checkpoints_sp_c_nb_e2_ckpt667,5_vs_5
3194,-9,0,m_sp_arch_medium_heads_bt_32_r201_m273_1370M,9,checkpoints_sp_c_nb_e2_ckpt667,5_vs_5
3195,-7,1,m_sp_arch_medium_heads_bt_32_r201_m273_1370M,8,checkpoints_sp_c_nb_e2_ckpt667,5_vs_5
3196,-6,0,m_sp_arch_medium_heads_bt_32_r201_m273_1370M,6,checkpoints_sp_c_nb_e2_ckpt667,5_vs_5
3197,-3,0,m_sp_arch_medium_heads_bt_32_r201_m273_1370M,3,checkpoints_sp_c_nb_e2_ckpt667,5_vs_5
3198,-7,1,m_sp_arch_medium_heads_bt_32_r201_m273_1370M,8,checkpoints_sp_c_nb_e2_ckpt667,5_vs_5
3199,-3,2,m_sp_arch_medium_heads_bt_32_r201_m273_1370M,5,checkpoints_sp_c_nb_e2_ckpt667,5_vs_5
3200,-9,2,m_sp_arch_medium_heads_bt_32_r201_m273_1370M,11,checkpoints_sp_c_nb_e2_ckpt667,5_vs_5
3201,0,0,m_sp_arch_medium_heads_bt_32_r201_m273_1370M,0,checkpoints_sp_c_nb_e2_ckpt667,5_vs_5
3202,-7,0,m_sp_arch_medium_heads_bt_32_r201_m273_1370M,7,checkpoints_sp_c_nb_e2_ckpt667,5_vs_5
3203,-6,0,m_sp_arch_medium_heads_bt_32_r201_m273_1370M,6,checkpoints_sp_c_nb_e2_ckpt667,5_vs_5
3204,-9,0,m_sp_arch_medium_heads_bt_32_r201_m273_1370M,9,checkpoints_sp_c_nb_e2_ckpt667,5_vs_5
3205,-4,2,m_sp_arch_medium_heads_bt_32_r201_m273_1370M,6,checkpoints_sp_c_nb_e2_ckpt667,5_vs_5
3206,-8,0,m_sp_arch_medium_heads_bt_32_r201_m273_1370M,8,checkpoints_sp_c_nb_e2_ckpt667,5_vs_5
3207,-10,1,m_sp_arch_medium_heads_bt_32_r201_m273_1370M,11,checkpoints_sp_c_nb_e2_ckpt667,5_vs_5
3208,-9,0,m_sp_arch_medium_heads_bt_32_r201_m273_1370M,9,checkpoints_sp_c_nb_e2_ckpt667,5_vs_5
3209,-3,1,m_sp_arch_medium_heads_bt_32_r201_m273_1370M,4,checkpoints_sp_c_nb_e2_ckpt667,5_vs_5
3210,2,2,m_sp_arch_medium_heads_bt_32_r201_m273_1370M,0,scenario_curriculum_ckpt830,5_vs_5
3211,6,6,m_sp_arch_medium_heads_bt_32_r201_m273_1370M,0,scenario_curriculum_ckpt830,5_vs_5
3212,2,2,m_sp_arch_medium_heads_bt_32_r201_m273_1370M,0,scenario_curriculum_ckpt830,5_vs_5
3213,8,8,m_sp_arch_medium_heads_bt_32_r201_m273_1370M,0,scenario_curriculum_ckpt830,5_vs_5
3214,4,4,m_sp_arch_medium_heads_bt_32_r201_m273_1370M,0,scenario_curriculum_ckpt830,5_vs_5
3215,0,0,m_sp_arch_medium_heads_bt_32_r201_m273_1370M,0,scenario_curriculum_ckpt830,5_vs_5
3216,1,1,m_sp_arch_medium_heads_bt_32_r201_m273_1370M,0,scenario_curriculum_ckpt830,5_vs_5
3217,3,3,m_sp_arch_medium_heads_bt_32_r201_m273_1370M,0,scenario_curriculum_ckpt830,5_vs_5
3218,7,7,m_sp_arch_medium_heads_bt_32_r201_m273_1370M,0,scenario_curriculum_ckpt830,5_vs_5
3219,5,5,m_sp_arch_medium_heads_bt_32_r201_m273_1370M,0,scenario_curriculum_ckpt830,5_vs_5
3220,8,8,m_sp_arch_medium_heads_bt_32_r201_m273_1370M,0,scenario_curriculum_ckpt830,5_vs_5
3221,6,6,m_sp_arch_medium_heads_bt_32_r201_m273_1370M,0,scenario_curriculum_ckpt830,5_vs_5
3222,1,1,m_sp_arch_medium_heads_bt_32_r201_m273_1370M,0,scenario_curriculum_ckpt830,5_vs_5
3223,3,3,m_sp_arch_medium_heads_bt_32_r201_m273_1370M,0,scenario_curriculum_ckpt830,5_vs_5
3224,1,1,m_sp_arch_medium_heads_bt_32_r201_m273_1370M,0,scenario_curriculum_ckpt830,5_vs_5
3225,4,4,m_sp_arch_medium_heads_bt_32_r201_m273_1370M,0,scenario_curriculum_ckpt830,5_vs_5
3226,3,3,m_sp_arch_medium_heads_bt_32_r201_m273_1370M,0,scenario_curriculum_ckpt830,5_vs_5
3227,4,4,m_sp_arch_medium_heads_bt_32_r201_m273_1370M,0,scenario_curriculum_ckpt830,5_vs_5
3228,8,8,m_sp_arch_medium_heads_bt_32_r201_m273_1370M,0,scenario_curriculum_ckpt830,5_vs_5
3229,10,10,m_sp_arch_medium_heads_bt_32_r201_m273_1370M,0,scenario_curriculum_ckpt830,5_vs_5
3230,-2,2,m_sp_arch_medium_heads_bt_32_r201_m273_1370M,4,m_sp_arch_medium_heads_conv16_0_bt_32_r313_m335,5_vs_5
3231,-4,2,m_sp_arch_medium_heads_bt_32_r201_m273_1370M,6,m_sp_arch_medium_heads_conv16_0_bt_32_r313_m335,5_vs_5
3232,-2,1,m_sp_arch_medium_heads_bt_32_r201_m273_1370M,3,m_sp_arch_medium_heads_conv16_0_bt_32_r313_m335,5_vs_5
3233,0,3,m_sp_arch_medium_heads_bt_32_r201_m273_1370M,3,m_sp_arch_medium_heads_conv16_0_bt_32_r313_m335,5_vs_5
3234,-2,2,m_sp_arch_medium_heads_bt_32_r201_m273_1370M,4,m_sp_arch_medium_heads_conv16_0_bt_32_r313_m335,5_vs_5
3235,-1,2,m_sp_arch_medium_heads_bt_32_r201_m273_1370M,3,m_sp_arch_medium_heads_conv16_0_bt_32_r313_m335,5_vs_5
3236,-4,0,m_sp_arch_medium_heads_bt_32_r201_m273_1370M,4,m_sp_arch_medium_heads_conv16_0_bt_32_r313_m335,5_vs_5
3237,-2,2,m_sp_arch_medium_heads_bt_32_r201_m273_1370M,4,m_sp_arch_medium_heads_conv16_0_bt_32_r313_m335,5_vs_5
3238,-2,0,m_sp_arch_medium_heads_bt_32_r201_m273_1370M,2,m_sp_arch_medium_heads_conv16_0_bt_32_r313_m335,5_vs_5
3239,0,3,m_sp_arch_medium_heads_bt_32_r201_m273_1370M,3,m_sp_arch_medium_heads_conv16_0_bt_32_r313_m335,5_vs_5
3240,-1,1,m_sp_arch_medium_heads_bt_32_r201_m273_1370M,2,m_sp_arch_medium_heads_conv16_0_bt_32_r313_m335,5_vs_5
3241,-5,2,m_sp_arch_medium_heads_bt_32_r201_m273_1370M,7,m_sp_arch_medium_heads_conv16_0_bt_32_r313_m335,5_vs_5
3242,-4,1,m_sp_arch_medium_heads_bt_32_r201_m273_1370M,5,m_sp_arch_medium_heads_conv16_0_bt_32_r313_m335,5_vs_5
3243,-4,0,m_sp_arch_medium_heads_bt_32_r201_m273_1370M,4,m_sp_arch_medium_heads_conv16_0_bt_32_r313_m335,5_vs_5
3244,-4,1,m_sp_arch_medium_heads_bt_32_r201_m273_1370M,5,m_sp_arch_medium_heads_conv16_0_bt_32_r313_m335,5_vs_5
3245,-2,1,m_sp_arch_medium_heads_bt_32_r201_m273_1370M,3,m_sp_arch_medium_heads_conv16_0_bt_32_r313_m335,5_vs_5
3246,-2,1,m_sp_arch_medium_heads_bt_32_r201_m273_1370M,3,m_sp_arch_medium_heads_conv16_0_bt_32_r313_m335,5_vs_5
3247,-3,1,m_sp_arch_medium_heads_bt_32_r201_m273_1370M,4,m_sp_arch_medium_heads_conv16_0_bt_32_r313_m335,5_vs_5
3248,-3,2,m_sp_arch_medium_heads_bt_32_r201_m273_1370M,5,m_sp_arch_medium_heads_conv16_0_bt_32_r313_m335,5_vs_5
3249,-2,0,m_sp_arch_medium_heads_bt_32_r201_m273_1370M,2,m_sp_arch_medium_heads_conv16_0_bt_32_r313_m335,5_vs_5
3250,-2,1,m_sp_arch_medium_heads_bt_32_r201_m273_1370M,3,m_sp_arch_medium_heads_conv16_0_bt_32_r313_m288_1370M,5_vs_5
3251,-3,1,m_sp_arch_medium_heads_bt_32_r201_m273_1370M,4,m_sp_arch_medium_heads_conv16_0_bt_32_r313_m288_1370M,5_vs_5
3252,4,5,m_sp_arch_medium_heads_bt_32_r201_m273_1370M,1,m_sp_arch_medium_heads_conv16_0_bt_32_r313_m288_1370M,5_vs_5
3253,1,3,m_sp_arch_medium_heads_bt_32_r201_m273_1370M,2,m_sp_arch_medium_heads_conv16_0_bt_32_r313_m288_1370M,5_vs_5
3254,0,3,m_sp_arch_medium_heads_bt_32_r201_m273_1370M,3,m_sp_arch_medium_heads_conv16_0_bt_32_r313_m288_1370M,5_vs_5
3255,0,4,m_sp_arch_medium_heads_bt_32_r201_m273_1370M,4,m_sp_arch_medium_heads_conv16_0_bt_32_r313_m288_1370M,5_vs_5
3256,-5,0,m_sp_arch_medium_heads_bt_32_r201_m273_1370M,5,m_sp_arch_medium_heads_conv16_0_bt_32_r313_m288_1370M,5_vs_5
3257,0,1,m_sp_arch_medium_heads_bt_32_r201_m273_1370M,1,m_sp_arch_medium_heads_conv16_0_bt_32_r313_m288_1370M,5_vs_5
3258,-3,1,m_sp_arch_medium_heads_bt_32_r201_m273_1370M,4,m_sp_arch_medium_heads_conv16_0_bt_32_r313_m288_1370M,5_vs_5
3259,0,2,m_sp_arch_medium_heads_bt_32_r201_m273_1370M,2,m_sp_arch_medium_heads_conv16_0_bt_32_r313_m288_1370M,5_vs_5
3260,0,3,m_sp_arch_medium_heads_bt_32_r201_m273_1370M,3,m_sp_arch_medium_heads_conv16_0_bt_32_r313_m288_1370M,5_vs_5
3261,0,2,m_sp_arch_medium_heads_bt_32_r201_m273_1370M,2,m_sp_arch_medium_heads_conv16_0_bt_32_r313_m288_1370M,5_vs_5
3262,5,5,m_sp_arch_medium_heads_bt_32_r201_m273_1370M,0,m_sp_arch_medium_heads_conv16_0_bt_32_r313_m288_1370M,5_vs_5
3263,-2,2,m_sp_arch_medium_heads_bt_32_r201_m273_1370M,4,m_sp_arch_medium_heads_conv16_0_bt_32_r313_m288_1370M,5_vs_5
3264,1,1,m_sp_arch_medium_heads_bt_32_r201_m273_1370M,0,m_sp_arch_medium_heads_conv16_0_bt_32_r313_m288_1370M,5_vs_5
3265,-1,2,m_sp_arch_medium_heads_bt_32_r201_m273_1370M,3,m_sp_arch_medium_heads_conv16_0_bt_32_r313_m288_1370M,5_vs_5
3266,0,2,m_sp_arch_medium_heads_bt_32_r201_m273_1370M,2,m_sp_arch_medium_heads_conv16_0_bt_32_r313_m288_1370M,5_vs_5
3267,-2,1,m_sp_arch_medium_heads_bt_32_r201_m273_1370M,3,m_sp_arch_medium_heads_conv16_0_bt_32_r313_m288_1370M,5_vs_5
3268,-3,1,m_sp_arch_medium_heads_bt_32_r201_m273_1370M,4,m_sp_arch_medium_heads_conv16_0_bt_32_r313_m288_1370M,5_vs_5
3269,1,3,m_sp_arch_medium_heads_bt_32_r201_m273_1370M,2,m_sp_arch_medium_heads_conv16_0_bt_32_r313_m288_1370M,5_vs_5
3270,-4,2,m_sp_arch_medium_heads_bt_32_r201_m273_1370M,6,m_sp_arch_longer_heads_bt_32_r201_m335,5_vs_5
3271,-3,2,m_sp_arch_medium_heads_bt_32_r201_m273_1370M,5,m_sp_arch_longer_heads_bt_32_r201_m335,5_vs_5
3272,-4,1,m_sp_arch_medium_heads_bt_32_r201_m273_1370M,5,m_sp_arch_longer_heads_bt_32_r201_m335,5_vs_5
3273,-2,2,m_sp_arch_medium_heads_bt_32_r201_m273_1370M,4,m_sp_arch_longer_heads_bt_32_r201_m335,5_vs_5
3274,-3,0,m_sp_arch_medium_heads_bt_32_r201_m273_1370M,3,m_sp_arch_longer_heads_bt_32_r201_m335,5_vs_5
3275,-7,0,m_sp_arch_medium_heads_bt_32_r201_m273_1370M,7,m_sp_arch_longer_heads_bt_32_r201_m335,5_vs_5
3276,0,1,m_sp_arch_medium_heads_bt_32_r201_m273_1370M,1,m_sp_arch_longer_heads_bt_32_r201_m335,5_vs_5
3277,-4,0,m_sp_arch_medium_heads_bt_32_r201_m273_1370M,4,m_sp_arch_longer_heads_bt_32_r201_m335,5_vs_5
3278,-2,2,m_sp_arch_medium_heads_bt_32_r201_m273_1370M,4,m_sp_arch_longer_heads_bt_32_r201_m335,5_vs_5
3279,-6,0,m_sp_arch_medium_heads_bt_32_r201_m273_1370M,6,m_sp_arch_longer_heads_bt_32_r201_m335,5_vs_5
3280,2,3,m_sp_arch_medium_heads_bt_32_r201_m273_1370M,1,m_sp_arch_longer_heads_bt_32_r201_m335,5_vs_5
3281,1,3,m_sp_arch_medium_heads_bt_32_r201_m273_1370M,2,m_sp_arch_longer_heads_bt_32_r201_m335,5_vs_5
3282,1,3,m_sp_arch_medium_heads_bt_32_r201_m273_1370M,2,m_sp_arch_longer_heads_bt_32_r201_m335,5_vs_5
3283,-5,0,m_sp_arch_medium_heads_bt_32_r201_m273_1370M,5,m_sp_arch_longer_heads_bt_32_r201_m335,5_vs_5
3284,0,3,m_sp_arch_medium_heads_bt_32_r201_m273_1370M,3,m_sp_arch_longer_heads_bt_32_r201_m335,5_vs_5
3285,-3,1,m_sp_arch_medium_heads_bt_32_r201_m273_1370M,4,m_sp_arch_longer_heads_bt_32_r201_m335,5_vs_5
3286,-3,1,m_sp_arch_medium_heads_bt_32_r201_m273_1370M,4,m_sp_arch_longer_heads_bt_32_r201_m335,5_vs_5
3287,-2,1,m_sp_arch_medium_heads_bt_32_r201_m273_1370M,3,m_sp_arch_longer_heads_bt_32_r201_m335,5_vs_5
3288,-1,1,m_sp_arch_medium_heads_bt_32_r201_m273_1370M,2,m_sp_arch_longer_heads_bt_32_r201_m335,5_vs_5
3289,-3,2,m_sp_arch_medium_heads_bt_32_r201_m273_1370M,5,m_sp_arch_longer_heads_bt_32_r201_m335,5_vs_5
3290,-1,4,m_sp_arch_medium_heads_bt_32_r201_m273_1370M,5,m_sp_arch_longer_heads_bt_32_r310_m277_1370M,5_vs_5
3291,-5,1,m_sp_arch_medium_heads_bt_32_r201_m273_1370M,6,m_sp_arch_longer_heads_bt_32_r310_m277_1370M,5_vs_5
3292,0,3,m_sp_arch_medium_heads_bt_32_r201_m273_1370M,3,m_sp_arch_longer_heads_bt_32_r310_m277_1370M,5_vs_5
3293,-6,1,m_sp_arch_medium_heads_bt_32_r201_m273_1370M,7,m_sp_arch_longer_heads_bt_32_r310_m277_1370M,5_vs_5
3294,-3,0,m_sp_arch_medium_heads_bt_32_r201_m273_1370M,3,m_sp_arch_longer_heads_bt_32_r310_m277_1370M,5_vs_5
3295,-9,1,m_sp_arch_medium_heads_bt_32_r201_m273_1370M,10,m_sp_arch_longer_heads_bt_32_r310_m277_1370M,5_vs_5
3296,-5,2,m_sp_arch_medium_heads_bt_32_r201_m273_1370M,7,m_sp_arch_longer_heads_bt_32_r310_m277_1370M,5_vs_5
3297,-7,0,m_sp_arch_medium_heads_bt_32_r201_m273_1370M,7,m_sp_arch_longer_heads_bt_32_r310_m277_1370M,5_vs_5
3298,-3,2,m_sp_arch_medium_heads_bt_32_r201_m273_1370M,5,m_sp_arch_longer_heads_bt_32_r310_m277_1370M,5_vs_5
3299,-8,1,m_sp_arch_medium_heads_bt_32_r201_m273_1370M,9,m_sp_arch_longer_heads_bt_32_r310_m277_1370M,5_vs_5
3300,-5,1,m_sp_arch_medium_heads_bt_32_r201_m273_1370M,6,m_sp_arch_longer_heads_bt_32_r310_m277_1370M,5_vs_5
3301,-5,3,m_sp_arch_medium_heads_bt_32_r201_m273_1370M,8,m_sp_arch_longer_heads_bt_32_r310_m277_1370M,5_vs_5
3302,-2,2,m_sp_arch_medium_heads_bt_32_r201_m273_1370M,4,m_sp_arch_longer_heads_bt_32_r310_m277_1370M,5_vs_5
3303,-2,1,m_sp_arch_medium_heads_bt_32_r201_m273_1370M,3,m_sp_arch_longer_heads_bt_32_r310_m277_1370M,5_vs_5
3304,-4,1,m_sp_arch_medium_heads_bt_32_r201_m273_1370M,5,m_sp_arch_longer_heads_bt_32_r310_m277_1370M,5_vs_5
3305,-7,0,m_sp_arch_medium_heads_bt_32_r201_m273_1370M,7,m_sp_arch_longer_heads_bt_32_r310_m277_1370M,5_vs_5
3306,-3,2,m_sp_arch_medium_heads_bt_32_r201_m273_1370M,5,m_sp_arch_longer_heads_bt_32_r310_m277_1370M,5_vs_5
3307,-5,3,m_sp_arch_medium_heads_bt_32_r201_m273_1370M,8,m_sp_arch_longer_heads_bt_32_r310_m277_1370M,5_vs_5
3308,0,3,m_sp_arch_medium_heads_bt_32_r201_m273_1370M,3,m_sp_arch_longer_heads_bt_32_r310_m277_1370M,5_vs_5
3309,-2,3,m_sp_arch_medium_heads_bt_32_r201_m273_1370M,5,m_sp_arch_longer_heads_bt_32_r310_m277_1370M,5_vs_5
3310,-3,2,m_sp_arch_medium_heads_bt_32_r201_m273_1370M,5,m_sp_arch_medium_heads_bt_32_r201_m335,5_vs_5
3311,-6,0,m_sp_arch_medium_heads_bt_32_r201_m273_1370M,6,m_sp_arch_medium_heads_bt_32_r201_m335,5_vs_5
3312,-5,1,m_sp_arch_medium_heads_bt_32_r201_m273_1370M,6,m_sp_arch_medium_heads_bt_32_r201_m335,5_vs_5
3313,-6,3,m_sp_arch_medium_heads_bt_32_r201_m273_1370M,9,m_sp_arch_medium_heads_bt_32_r201_m335,5_vs_5
3314,-5,2,m_sp_arch_medium_heads_bt_32_r201_m273_1370M,7,m_sp_arch_medium_heads_bt_32_r201_m335,5_vs_5
3315,-7,1,m_sp_arch_medium_heads_bt_32_r201_m273_1370M,8,m_sp_arch_medium_heads_bt_32_r201_m335,5_vs_5
3316,-1,3,m_sp_arch_medium_heads_bt_32_r201_m273_1370M,4,m_sp_arch_medium_heads_bt_32_r201_m335,5_vs_5
3317,-5,1,m_sp_arch_medium_heads_bt_32_r201_m273_1370M,6,m_sp_arch_medium_heads_bt_32_r201_m335,5_vs_5
3318,-6,0,m_sp_arch_medium_heads_bt_32_r201_m273_1370M,6,m_sp_arch_medium_heads_bt_32_r201_m335,5_vs_5
3319,0,4,m_sp_arch_medium_heads_bt_32_r201_m273_1370M,4,m_sp_arch_medium_heads_bt_32_r201_m335,5_vs_5
3320,-4,1,m_sp_arch_medium_heads_bt_32_r201_m273_1370M,5,m_sp_arch_medium_heads_bt_32_r201_m335,5_vs_5
3321,-3,2,m_sp_arch_medium_heads_bt_32_r201_m273_1370M,5,m_sp_arch_medium_heads_bt_32_r201_m335,5_vs_5
3322,-4,3,m_sp_arch_medium_heads_bt_32_r201_m273_1370M,7,m_sp_arch_medium_heads_bt_32_r201_m335,5_vs_5
3323,0,3,m_sp_arch_medium_heads_bt_32_r201_m273_1370M,3,m_sp_arch_medium_heads_bt_32_r201_m335,5_vs_5
3324,-2,6,m_sp_arch_medium_heads_bt_32_r201_m273_1370M,8,m_sp_arch_medium_heads_bt_32_r201_m335,5_vs_5
3325,-3,2,m_sp_arch_medium_heads_bt_32_r201_m273_1370M,5,m_sp_arch_medium_heads_bt_32_r201_m335,5_vs_5
3326,-4,3,m_sp_arch_medium_heads_bt_32_r201_m273_1370M,7,m_sp_arch_medium_heads_bt_32_r201_m335,5_vs_5
3327,0,7,m_sp_arch_medium_heads_bt_32_r201_m273_1370M,7,m_sp_arch_medium_heads_bt_32_r201_m335,5_vs_5
3328,-1,4,m_sp_arch_medium_heads_bt_32_r201_m273_1370M,5,m_sp_arch_medium_heads_bt_32_r201_m335,5_vs_5
3329,-4,3,m_sp_arch_medium_heads_bt_32_r201_m273_1370M,7,m_sp_arch_medium_heads_bt_32_r201_m335,5_vs_5
3330,-2,5,m_sp_arch_medium_heads_bt_32_r201_m273_1370M,7,m_sp_arch_medium_heads_bt_32_r201_m273_1370M,5_vs_5
3331,2,7,m_sp_arch_medium_heads_bt_32_r201_m273_1370M,5,m_sp_arch_medium_heads_bt_32_r201_m273_1370M,5_vs_5
3332,3,8,m_sp_arch_medium_heads_bt_32_r201_m273_1370M,5,m_sp_arch_medium_heads_bt_32_r201_m273_1370M,5_vs_5
3333,-3,7,m_sp_arch_medium_heads_bt_32_r201_m273_1370M,10,m_sp_arch_medium_heads_bt_32_r201_m273_1370M,5_vs_5
3334,0,5,m_sp_arch_medium_heads_bt_32_r201_m273_1370M,5,m_sp_arch_medium_heads_bt_32_r201_m273_1370M,5_vs_5
3335,-4,2,m_sp_arch_medium_heads_bt_32_r201_m273_1370M,6,m_sp_arch_medium_heads_bt_32_r201_m273_1370M,5_vs_5
3336,2,7,m_sp_arch_medium_heads_bt_32_r201_m273_1370M,5,m_sp_arch_medium_heads_bt_32_r201_m273_1370M,5_vs_5
3337,1,7,m_sp_arch_medium_heads_bt_32_r201_m273_1370M,6,m_sp_arch_medium_heads_bt_32_r201_m273_1370M,5_vs_5
3338,2,5,m_sp_arch_medium_heads_bt_32_r201_m273_1370M,3,m_sp_arch_medium_heads_bt_32_r201_m273_1370M,5_vs_5
3339,1,8,m_sp_arch_medium_heads_bt_32_r201_m273_1370M,7,m_sp_arch_medium_heads_bt_32_r201_m273_1370M,5_vs_5
3340,2,8,m_sp_arch_medium_heads_bt_32_r201_m273_1370M,6,m_sp_arch_medium_heads_bt_32_r201_m273_1370M,5_vs_5
3341,2,7,m_sp_arch_medium_heads_bt_32_r201_m273_1370M,5,m_sp_arch_medium_heads_bt_32_r201_m273_1370M,5_vs_5
3342,3,7,m_sp_arch_medium_heads_bt_32_r201_m273_1370M,4,m_sp_arch_medium_heads_bt_32_r201_m273_1370M,5_vs_5
3343,4,9,m_sp_arch_medium_heads_bt_32_r201_m273_1370M,5,m_sp_arch_medium_heads_bt_32_r201_m273_1370M,5_vs_5
3344,1,5,m_sp_arch_medium_heads_bt_32_r201_m273_1370M,4,m_sp_arch_medium_heads_bt_32_r201_m273_1370M,5_vs_5
3345,-1,5,m_sp_arch_medium_heads_bt_32_r201_m273_1370M,6,m_sp_arch_medium_heads_bt_32_r201_m273_1370M,5_vs_5
3346,-1,6,m_sp_arch_medium_heads_bt_32_r201_m273_1370M,7,m_sp_arch_medium_heads_bt_32_r201_m273_1370M,5_vs_5
3347,1,7,m_sp_arch_medium_heads_bt_32_r201_m273_1370M,6,m_sp_arch_medium_heads_bt_32_r201_m273_1370M,5_vs_5
3348,4,8,m_sp_arch_medium_heads_bt_32_r201_m273_1370M,4,m_sp_arch_medium_heads_bt_32_r201_m273_1370M,5_vs_5
3349,0,2,m_sp_arch_medium_heads_bt_32_r201_m273_1370M,2,m_sp_arch_medium_heads_bt_32_r201_m273_1370M,5_vs_5
3350,-7,2,m_sp_arch_medium_heads_bt_32_r201_m273_1370M,9,m_sp_arch_4x1_bt_32_r201_m335,5_vs_5
3351,-8,1,m_sp_arch_medium_heads_bt_32_r201_m273_1370M,9,m_sp_arch_4x1_bt_32_r201_m335,5_vs_5
3352,-7,0,m_sp_arch_medium_heads_bt_32_r201_m273_1370M,7,m_sp_arch_4x1_bt_32_r201_m335,5_vs_5
3353,-6,0,m_sp_arch_medium_heads_bt_32_r201_m273_1370M,6,m_sp_arch_4x1_bt_32_r201_m335,5_vs_5
3354,-8,0,m_sp_arch_medium_heads_bt_32_r201_m273_1370M,8,m_sp_arch_4x1_bt_32_r201_m335,5_vs_5
3355,-8,0,m_sp_arch_medium_heads_bt_32_r201_m273_1370M,8,m_sp_arch_4x1_bt_32_r201_m335,5_vs_5
3356,-6,1,m_sp_arch_medium_heads_bt_32_r201_m273_1370M,7,m_sp_arch_4x1_bt_32_r201_m335,5_vs_5
3357,-5,1,m_sp_arch_medium_heads_bt_32_r201_m273_1370M,6,m_sp_arch_4x1_bt_32_r201_m335,5_vs_5
3358,-9,0,m_sp_arch_medium_heads_bt_32_r201_m273_1370M,9,m_sp_arch_4x1_bt_32_r201_m335,5_vs_5
3359,-6,3,m_sp_arch_medium_heads_bt_32_r201_m273_1370M,9,m_sp_arch_4x1_bt_32_r201_m335,5_vs_5
3360,-7,0,m_sp_arch_medium_heads_bt_32_r201_m273_1370M,7,m_sp_arch_4x1_bt_32_r201_m335,5_vs_5
3361,-8,1,m_sp_arch_medium_heads_bt_32_r201_m273_1370M,9,m_sp_arch_4x1_bt_32_r201_m335,5_vs_5
3362,-12,0,m_sp_arch_medium_heads_bt_32_r201_m273_1370M,12,m_sp_arch_4x1_bt_32_r201_m335,5_vs_5
3363,-6,0,m_sp_arch_medium_heads_bt_32_r201_m273_1370M,6,m_sp_arch_4x1_bt_32_r201_m335,5_vs_5
3364,-9,0,m_sp_arch_medium_heads_bt_32_r201_m273_1370M,9,m_sp_arch_4x1_bt_32_r201_m335,5_vs_5
3365,-9,0,m_sp_arch_medium_heads_bt_32_r201_m273_1370M,9,m_sp_arch_4x1_bt_32_r201_m335,5_vs_5
3366,-10,1,m_sp_arch_medium_heads_bt_32_r201_m273_1370M,11,m_sp_arch_4x1_bt_32_r201_m335,5_vs_5
3367,-7,1,m_sp_arch_medium_heads_bt_32_r201_m273_1370M,8,m_sp_arch_4x1_bt_32_r201_m335,5_vs_5
3368,-4,0,m_sp_arch_medium_heads_bt_32_r201_m273_1370M,4,m_sp_arch_4x1_bt_32_r201_m335,5_vs_5
3369,-10,0,m_sp_arch_medium_heads_bt_32_r201_m273_1370M,10,m_sp_arch_4x1_bt_32_r201_m335,5_vs_5
3370,-6,1,m_sp_arch_medium_heads_bt_32_r201_m273_1370M,7,m_sp_arch_4x1_bt_32_r201_cont3_m650,5_vs_5
3371,-7,0,m_sp_arch_medium_heads_bt_32_r201_m273_1370M,7,m_sp_arch_4x1_bt_32_r201_cont3_m650,5_vs_5
3372,-4,0,m_sp_arch_medium_heads_bt_32_r201_m273_1370M,4,m_sp_arch_4x1_bt_32_r201_cont3_m650,5_vs_5
3373,-6,2,m_sp_arch_medium_heads_bt_32_r201_m273_1370M,8,m_sp_arch_4x1_bt_32_r201_cont3_m650,5_vs_5
3374,-8,2,m_sp_arch_medium_heads_bt_32_r201_m273_1370M,10,m_sp_arch_4x1_bt_32_r201_cont3_m650,5_vs_5
3375,-8,2,m_sp_arch_medium_heads_bt_32_r201_m273_1370M,10,m_sp_arch_4x1_bt_32_r201_cont3_m650,5_vs_5
3376,-9,1,m_sp_arch_medium_heads_bt_32_r201_m273_1370M,10,m_sp_arch_4x1_bt_32_r201_cont3_m650,5_vs_5
3377,-9,0,m_sp_arch_medium_heads_bt_32_r201_m273_1370M,9,m_sp_arch_4x1_bt_32_r201_cont3_m650,5_vs_5
3378,-5,1,m_sp_arch_medium_heads_bt_32_r201_m273_1370M,6,m_sp_arch_4x1_bt_32_r201_cont3_m650,5_vs_5
3379,-3,0,m_sp_arch_medium_heads_bt_32_r201_m273_1370M,3,m_sp_arch_4x1_bt_32_r201_cont3_m650,5_vs_5
3380,-2,3,m_sp_arch_medium_heads_bt_32_r201_m273_1370M,5,m_sp_arch_4x1_bt_32_r201_cont3_m650,5_vs_5
3381,-4,0,m_sp_arch_medium_heads_bt_32_r201_m273_1370M,4,m_sp_arch_4x1_bt_32_r201_cont3_m650,5_vs_5
3382,-8,0,m_sp_arch_medium_heads_bt_32_r201_m273_1370M,8,m_sp_arch_4x1_bt_32_r201_cont3_m650,5_vs_5
3383,-7,0,m_sp_arch_medium_heads_bt_32_r201_m273_1370M,7,m_sp_arch_4x1_bt_32_r201_cont3_m650,5_vs_5
3384,-6,2,m_sp_arch_medium_heads_bt_32_r201_m273_1370M,8,m_sp_arch_4x1_bt_32_r201_cont3_m650,5_vs_5
3385,-5,1,m_sp_arch_medium_heads_bt_32_r201_m273_1370M,6,m_sp_arch_4x1_bt_32_r201_cont3_m650,5_vs_5
3386,-7,1,m_sp_arch_medium_heads_bt_32_r201_m273_1370M,8,m_sp_arch_4x1_bt_32_r201_cont3_m650,5_vs_5
3387,-8,0,m_sp_arch_medium_heads_bt_32_r201_m273_1370M,8,m_sp_arch_4x1_bt_32_r201_cont3_m650,5_vs_5
3388,-6,2,m_sp_arch_medium_heads_bt_32_r201_m273_1370M,8,m_sp_arch_4x1_bt_32_r201_cont3_m650,5_vs_5
3389,-10,2,m_sp_arch_medium_heads_bt_32_r201_m273_1370M,12,m_sp_arch_4x1_bt_32_r201_cont3_m650,5_vs_5
3390,-1,1,m_sp_arch_medium_heads_bt_32_r201_m273_1370M,2,explt_v0_7_2_m54,5_vs_5
3391,-1,0,m_sp_arch_medium_heads_bt_32_r201_m273_1370M,1,explt_v0_7_2_m54,5_vs_5
3392,-1,0,m_sp_arch_medium_heads_bt_32_r201_m273_1370M,1,explt_v0_7_2_m54,5_vs_5
3393,-2,2,m_sp_arch_medium_heads_bt_32_r201_m273_1370M,4,explt_v0_7_2_m54,5_vs_5
3394,-2,1,m_sp_arch_medium_heads_bt_32_r201_m273_1370M,3,explt_v0_7_2_m54,5_vs_5
3395,-2,1,m_sp_arch_medium_heads_bt_32_r201_m273_1370M,3,explt_v0_7_2_m54,5_vs_5
3396,0,0,m_sp_arch_medium_heads_bt_32_r201_m273_1370M,0,explt_v0_7_2_m54,5_vs_5
3397,-2,0,m_sp_arch_medium_heads_bt_32_r201_m273_1370M,2,explt_v0_7_2_m54,5_vs_5
3398,1,2,m_sp_arch_medium_heads_bt_32_r201_m273_1370M,1,explt_v0_7_2_m54,5_vs_5
3399,-2,0,m_sp_arch_medium_heads_bt_32_r201_m273_1370M,2,explt_v0_7_2_m54,5_vs_5
3400,-1,1,m_sp_arch_medium_heads_bt_32_r201_m273_1370M,2,explt_v0_7_2_m54,5_vs_5
3401,-3,0,m_sp_arch_medium_heads_bt_32_r201_m273_1370M,3,explt_v0_7_2_m54,5_vs_5
3402,1,2,m_sp_arch_medium_heads_bt_32_r201_m273_1370M,1,explt_v0_7_2_m54,5_vs_5
3403,-3,0,m_sp_arch_medium_heads_bt_32_r201_m273_1370M,3,explt_v0_7_2_m54,5_vs_5
3404,-2,1,m_sp_arch_medium_heads_bt_32_r201_m273_1370M,3,explt_v0_7_2_m54,5_vs_5
3405,-4,0,m_sp_arch_medium_heads_bt_32_r201_m273_1370M,4,explt_v0_7_2_m54,5_vs_5
3406,-3,0,m_sp_arch_medium_heads_bt_32_r201_m273_1370M,3,explt_v0_7_2_m54,5_vs_5
3407,-5,1,m_sp_arch_medium_heads_bt_32_r201_m273_1370M,6,explt_v0_7_2_m54,5_vs_5
3408,-1,2,m_sp_arch_medium_heads_bt_32_r201_m273_1370M,3,explt_v0_7_2_m54,5_vs_5
3409,1,3,m_sp_arch_medium_heads_bt_32_r201_m273_1370M,2,explt_v0_7_2_m54,5_vs_5
3410,-2,4,m_sp_arch_medium_heads_bt_32_r201_m273_1370M,6,m_sp_sc3v3_arch_2x1_32_r500_cont4x1_m224,5_vs_5
3411,-4,2,m_sp_arch_medium_heads_bt_32_r201_m273_1370M,6,m_sp_sc3v3_arch_2x1_32_r500_cont4x1_m224,5_vs_5
3412,-4,2,m_sp_arch_medium_heads_bt_32_r201_m273_1370M,6,m_sp_sc3v3_arch_2x1_32_r500_cont4x1_m224,5_vs_5
3413,-3,2,m_sp_arch_medium_heads_bt_32_r201_m273_1370M,5,m_sp_sc3v3_arch_2x1_32_r500_cont4x1_m224,5_vs_5
3414,-5,1,m_sp_arch_medium_heads_bt_32_r201_m273_1370M,6,m_sp_sc3v3_arch_2x1_32_r500_cont4x1_m224,5_vs_5
3415,-8,0,m_sp_arch_medium_heads_bt_32_r201_m273_1370M,8,m_sp_sc3v3_arch_2x1_32_r500_cont4x1_m224,5_vs_5
3416,-3,5,m_sp_arch_medium_heads_bt_32_r201_m273_1370M,8,m_sp_sc3v3_arch_2x1_32_r500_cont4x1_m224,5_vs_5
3417,-6,3,m_sp_arch_medium_heads_bt_32_r201_m273_1370M,9,m_sp_sc3v3_arch_2x1_32_r500_cont4x1_m224,5_vs_5
3418,-4,3,m_sp_arch_medium_heads_bt_32_r201_m273_1370M,7,m_sp_sc3v3_arch_2x1_32_r500_cont4x1_m224,5_vs_5
3419,-4,2,m_sp_arch_medium_heads_bt_32_r201_m273_1370M,6,m_sp_sc3v3_arch_2x1_32_r500_cont4x1_m224,5_vs_5
3420,-4,4,m_sp_arch_medium_heads_bt_32_r201_m273_1370M,8,m_sp_sc3v3_arch_2x1_32_r500_cont4x1_m224,5_vs_5
3421,-4,1,m_sp_arch_medium_heads_bt_32_r201_m273_1370M,5,m_sp_sc3v3_arch_2x1_32_r500_cont4x1_m224,5_vs_5
3422,-6,0,m_sp_arch_medium_heads_bt_32_r201_m273_1370M,6,m_sp_sc3v3_arch_2x1_32_r500_cont4x1_m224,5_vs_5
3423,-8,0,m_sp_arch_medium_heads_bt_32_r201_m273_1370M,8,m_sp_sc3v3_arch_2x1_32_r500_cont4x1_m224,5_vs_5
3424,1,1,m_sp_arch_medium_heads_bt_32_r201_m273_1370M,0,m_sp_sc3v3_arch_2x1_32_r500_cont4x1_m224,5_vs_5
3425,-1,3,m_sp_arch_medium_heads_bt_32_r201_m273_1370M,4,m_sp_sc3v3_arch_2x1_32_r500_cont4x1_m224,5_vs_5
3426,-3,2,m_sp_arch_medium_heads_bt_32_r201_m273_1370M,5,m_sp_sc3v3_arch_2x1_32_r500_cont4x1_m224,5_vs_5
3427,-7,0,m_sp_arch_medium_heads_bt_32_r201_m273_1370M,7,m_sp_sc3v3_arch_2x1_32_r500_cont4x1_m224,5_vs_5
3428,-7,1,m_sp_arch_medium_heads_bt_32_r201_m273_1370M,8,m_sp_sc3v3_arch_2x1_32_r500_cont4x1_m224,5_vs_5
3429,-8,3,m_sp_arch_medium_heads_bt_32_r201_m273_1370M,11,m_sp_sc3v3_arch_2x1_32_r500_cont4x1_m224,5_vs_5
3430,-9,0,m_sp_arch_medium_heads_bt_32_r201_m273_1370M,9,m_sp_arch_4x1_bt_32_roles_r500_m335,5_vs_5
3431,-8,0,m_sp_arch_medium_heads_bt_32_r201_m273_1370M,8,m_sp_arch_4x1_bt_32_roles_r500_m335,5_vs_5
3432,-10,0,m_sp_arch_medium_heads_bt_32_r201_m273_1370M,10,m_sp_arch_4x1_bt_32_roles_r500_m335,5_vs_5
3433,-15,0,m_sp_arch_medium_heads_bt_32_r201_m273_1370M,15,m_sp_arch_4x1_bt_32_roles_r500_m335,5_vs_5
3434,-11,1,m_sp_arch_medium_heads_bt_32_r201_m273_1370M,12,m_sp_arch_4x1_bt_32_roles_r500_m335,5_vs_5
3435,-8,1,m_sp_arch_medium_heads_bt_32_r201_m273_1370M,9,m_sp_arch_4x1_bt_32_roles_r500_m335,5_vs_5
3436,-7,1,m_sp_arch_medium_heads_bt_32_r201_m273_1370M,8,m_sp_arch_4x1_bt_32_roles_r500_m335,5_vs_5
3437,-9,0,m_sp_arch_medium_heads_bt_32_r201_m273_1370M,9,m_sp_arch_4x1_bt_32_roles_r500_m335,5_vs_5
3438,-9,0,m_sp_arch_medium_heads_bt_32_r201_m273_1370M,9,m_sp_arch_4x1_bt_32_roles_r500_m335,5_vs_5
3439,-13,0,m_sp_arch_medium_heads_bt_32_r201_m273_1370M,13,m_sp_arch_4x1_bt_32_roles_r500_m335,5_vs_5
3440,-8,1,m_sp_arch_medium_heads_bt_32_r201_m273_1370M,9,m_sp_arch_4x1_bt_32_roles_r500_m335,5_vs_5
3441,-11,0,m_sp_arch_medium_heads_bt_32_r201_m273_1370M,11,m_sp_arch_4x1_bt_32_roles_r500_m335,5_vs_5
3442,-9,1,m_sp_arch_medium_heads_bt_32_r201_m273_1370M,10,m_sp_arch_4x1_bt_32_roles_r500_m335,5_vs_5
3443,-13,0,m_sp_arch_medium_heads_bt_32_r201_m273_1370M,13,m_sp_arch_4x1_bt_32_roles_r500_m335,5_vs_5
3444,-6,0,m_sp_arch_medium_heads_bt_32_r201_m273_1370M,6,m_sp_arch_4x1_bt_32_roles_r500_m335,5_vs_5
3445,-9,2,m_sp_arch_medium_heads_bt_32_r201_m273_1370M,11,m_sp_arch_4x1_bt_32_roles_r500_m335,5_vs_5
3446,-6,1,m_sp_arch_medium_heads_bt_32_r201_m273_1370M,7,m_sp_arch_4x1_bt_32_roles_r500_m335,5_vs_5
3447,-8,0,m_sp_arch_medium_heads_bt_32_r201_m273_1370M,8,m_sp_arch_4x1_bt_32_roles_r500_m335,5_vs_5
3448,-12,1,m_sp_arch_medium_heads_bt_32_r201_m273_1370M,13,m_sp_arch_4x1_bt_32_roles_r500_m335,5_vs_5
3449,-13,0,m_sp_arch_medium_heads_bt_32_r201_m273_1370M,13,m_sp_arch_4x1_bt_32_roles_r500_m335,5_vs_5
3450,0,0,m_sp_arch_medium_heads_conv16_0_bt_32_r313_m335,0,easy_bots,5_vs_5
3451,0,2,m_sp_arch_medium_heads_conv16_0_bt_32_r313_m335,2,easy_bots,5_vs_5
3452,-1,2,m_sp_arch_medium_heads_conv16_0_bt_32_r313_m335,3,easy_bots,5_vs_5
3453,0,0,m_sp_arch_medium_heads_conv16_0_bt_32_r313_m335,0,easy_bots,5_vs_5
3454,-1,0,m_sp_arch_medium_heads_conv16_0_bt_32_r313_m335,1,easy_bots,5_vs_5
3455,-1,1,m_sp_arch_medium_heads_conv16_0_bt_32_r313_m335,2,easy_bots,5_vs_5
3456,-2,0,m_sp_arch_medium_heads_conv16_0_bt_32_r313_m335,2,easy_bots,5_vs_5
3457,0,1,m_sp_arch_medium_heads_conv16_0_bt_32_r313_m335,1,easy_bots,5_vs_5
3458,-2,1,m_sp_arch_medium_heads_conv16_0_bt_32_r313_m335,3,easy_bots,5_vs_5
3459,0,0,m_sp_arch_medium_heads_conv16_0_bt_32_r313_m335,0,easy_bots,5_vs_5
3460,0,1,m_sp_arch_medium_heads_conv16_0_bt_32_r313_m335,1,easy_bots,5_vs_5
3461,-1,0,m_sp_arch_medium_heads_conv16_0_bt_32_r313_m335,1,easy_bots,5_vs_5
3462,-1,0,m_sp_arch_medium_heads_conv16_0_bt_32_r313_m335,1,easy_bots,5_vs_5
3463,0,1,m_sp_arch_medium_heads_conv16_0_bt_32_r313_m335,1,easy_bots,5_vs_5
3464,-2,0,m_sp_arch_medium_heads_conv16_0_bt_32_r313_m335,2,easy_bots,5_vs_5
3465,-1,0,m_sp_arch_medium_heads_conv16_0_bt_32_r313_m335,1,easy_bots,5_vs_5
3466,-1,3,m_sp_arch_medium_heads_conv16_0_bt_32_r313_m335,4,easy_bots,5_vs_5
3467,1,1,m_sp_arch_medium_heads_conv16_0_bt_32_r313_m335,0,easy_bots,5_vs_5
3468,1,2,m_sp_arch_medium_heads_conv16_0_bt_32_r313_m335,1,easy_bots,5_vs_5
3469,-2,1,m_sp_arch_medium_heads_conv16_0_bt_32_r313_m335,3,easy_bots,5_vs_5
3470,-3,1,m_sp_arch_medium_heads_conv16_0_bt_32_r313_m335,4,medium_bots,5_vs_5_medium
3471,1,2,m_sp_arch_medium_heads_conv16_0_bt_32_r313_m335,1,medium_bots,5_vs_5_medium
3472,-2,1,m_sp_arch_medium_heads_conv16_0_bt_32_r313_m335,3,medium_bots,5_vs_5_medium
3473,0,0,m_sp_arch_medium_heads_conv16_0_bt_32_r313_m335,0,medium_bots,5_vs_5_medium
3474,0,1,m_sp_arch_medium_heads_conv16_0_bt_32_r313_m335,1,medium_bots,5_vs_5_medium
3475,-3,0,m_sp_arch_medium_heads_conv16_0_bt_32_r313_m335,3,medium_bots,5_vs_5_medium
3476,-1,0,m_sp_arch_medium_heads_conv16_0_bt_32_r313_m335,1,medium_bots,5_vs_5_medium
3477,-2,0,m_sp_arch_medium_heads_conv16_0_bt_32_r313_m335,2,medium_bots,5_vs_5_medium
3478,-2,0,m_sp_arch_medium_heads_conv16_0_bt_32_r313_m335,2,medium_bots,5_vs_5_medium
3479,-2,0,m_sp_arch_medium_heads_conv16_0_bt_32_r313_m335,2,medium_bots,5_vs_5_medium
3480,0,1,m_sp_arch_medium_heads_conv16_0_bt_32_r313_m335,1,medium_bots,5_vs_5_medium
3481,-2,0,m_sp_arch_medium_heads_conv16_0_bt_32_r313_m335,2,medium_bots,5_vs_5_medium
3482,0,1,m_sp_arch_medium_heads_conv16_0_bt_32_r313_m335,1,medium_bots,5_vs_5_medium
3483,-1,1,m_sp_arch_medium_heads_conv16_0_bt_32_r313_m335,2,medium_bots,5_vs_5_medium
3484,0,2,m_sp_arch_medium_heads_conv16_0_bt_32_r313_m335,2,medium_bots,5_vs_5_medium
3485,-3,0,m_sp_arch_medium_heads_conv16_0_bt_32_r313_m335,3,medium_bots,5_vs_5_medium
3486,-2,0,m_sp_arch_medium_heads_conv16_0_bt_32_r313_m335,2,medium_bots,5_vs_5_medium
3487,-1,0,m_sp_arch_medium_heads_conv16_0_bt_32_r313_m335,1,medium_bots,5_vs_5_medium
3488,1,1,m_sp_arch_medium_heads_conv16_0_bt_32_r313_m335,0,medium_bots,5_vs_5_medium
3489,-1,0,m_sp_arch_medium_heads_conv16_0_bt_32_r313_m335,1,medium_bots,5_vs_5_medium
3490,-1,1,m_sp_arch_medium_heads_conv16_0_bt_32_r313_m335,2,hard_bots,5_vs_5_hard
3491,0,2,m_sp_arch_medium_heads_conv16_0_bt_32_r313_m335,2,hard_bots,5_vs_5_hard
3492,-1,0,m_sp_arch_medium_heads_conv16_0_bt_32_r313_m335,1,hard_bots,5_vs_5_hard
3493,-2,2,m_sp_arch_medium_heads_conv16_0_bt_32_r313_m335,4,hard_bots,5_vs_5_hard
3494,-3,1,m_sp_arch_medium_heads_conv16_0_bt_32_r313_m335,4,hard_bots,5_vs_5_hard
3495,-2,0,m_sp_arch_medium_heads_conv16_0_bt_32_r313_m335,2,hard_bots,5_vs_5_hard
3496,-3,1,m_sp_arch_medium_heads_conv16_0_bt_32_r313_m335,4,hard_bots,5_vs_5_hard
3497,0,1,m_sp_arch_medium_heads_conv16_0_bt_32_r313_m335,1,hard_bots,5_vs_5_hard
3498,-1,0,m_sp_arch_medium_heads_conv16_0_bt_32_r313_m335,1,hard_bots,5_vs_5_hard
3499,-3,0,m_sp_arch_medium_heads_conv16_0_bt_32_r313_m335,3,hard_bots,5_vs_5_hard
3500,0,1,m_sp_arch_medium_heads_conv16_0_bt_32_r313_m335,1,hard_bots,5_vs_5_hard
3501,0,0,m_sp_arch_medium_heads_conv16_0_bt_32_r313_m335,0,hard_bots,5_vs_5_hard
3502,-1,2,m_sp_arch_medium_heads_conv16_0_bt_32_r313_m335,3,hard_bots,5_vs_5_hard
3503,-1,1,m_sp_arch_medium_heads_conv16_0_bt_32_r313_m335,2,hard_bots,5_vs_5_hard
3504,-3,1,m_sp_arch_medium_heads_conv16_0_bt_32_r313_m335,4,hard_bots,5_vs_5_hard
3505,-1,1,m_sp_arch_medium_heads_conv16_0_bt_32_r313_m335,2,hard_bots,5_vs_5_hard
3506,-3,0,m_sp_arch_medium_heads_conv16_0_bt_32_r313_m335,3,hard_bots,5_vs_5_hard
3507,0,0,m_sp_arch_medium_heads_conv16_0_bt_32_r313_m335,0,hard_bots,5_vs_5_hard
3508,0,3,m_sp_arch_medium_heads_conv16_0_bt_32_r313_m335,3,hard_bots,5_vs_5_hard
3509,-1,2,m_sp_arch_medium_heads_conv16_0_bt_32_r313_m335,3,hard_bots,5_vs_5_hard
3510,-1,3,m_sp_arch_medium_heads_conv16_0_bt_32_r313_m335,4,f5v0to1to2t05_e2_ckpt291,5_vs_5
3511,-2,2,m_sp_arch_medium_heads_conv16_0_bt_32_r313_m335,4,f5v0to1to2t05_e2_ckpt291,5_vs_5
3512,5,7,m_sp_arch_medium_heads_conv16_0_bt_32_r313_m335,2,f5v0to1to2t05_e2_ckpt291,5_vs_5
3513,0,3,m_sp_arch_medium_heads_conv16_0_bt_32_r313_m335,3,f5v0to1to2t05_e2_ckpt291,5_vs_5
3514,2,4,m_sp_arch_medium_heads_conv16_0_bt_32_r313_m335,2,f5v0to1to2t05_e2_ckpt291,5_vs_5
3515,0,3,m_sp_arch_medium_heads_conv16_0_bt_32_r313_m335,3,f5v0to1to2t05_e2_ckpt291,5_vs_5
3516,1,5,m_sp_arch_medium_heads_conv16_0_bt_32_r313_m335,4,f5v0to1to2t05_e2_ckpt291,5_vs_5
3517,3,3,m_sp_arch_medium_heads_conv16_0_bt_32_r313_m335,0,f5v0to1to2t05_e2_ckpt291,5_vs_5
3518,3,4,m_sp_arch_medium_heads_conv16_0_bt_32_r313_m335,1,f5v0to1to2t05_e2_ckpt291,5_vs_5
3519,3,3,m_sp_arch_medium_heads_conv16_0_bt_32_r313_m335,0,f5v0to1to2t05_e2_ckpt291,5_vs_5
3520,4,4,m_sp_arch_medium_heads_conv16_0_bt_32_r313_m335,0,f5v0to1to5_e2_ckpt252,5_vs_5
3521,2,3,m_sp_arch_medium_heads_conv16_0_bt_32_r313_m335,1,f5v0to1to5_e2_ckpt252,5_vs_5
3522,1,3,m_sp_arch_medium_heads_conv16_0_bt_32_r313_m335,2,f5v0to1to5_e2_ckpt252,5_vs_5
3523,0,3,m_sp_arch_medium_heads_conv16_0_bt_32_r313_m335,3,f5v0to1to5_e2_ckpt252,5_vs_5
3524,0,2,m_sp_arch_medium_heads_conv16_0_bt_32_r313_m335,2,f5v0to1to5_e2_ckpt252,5_vs_5
3525,0,2,m_sp_arch_medium_heads_conv16_0_bt_32_r313_m335,2,f5v0to1to5_e2_ckpt252,5_vs_5
3526,1,2,m_sp_arch_medium_heads_conv16_0_bt_32_r313_m335,1,f5v0to1to5_e2_ckpt252,5_vs_5
3527,-2,2,m_sp_arch_medium_heads_conv16_0_bt_32_r313_m335,4,f5v0to1to5_e2_ckpt252,5_vs_5
3528,-2,2,m_sp_arch_medium_heads_conv16_0_bt_32_r313_m335,4,f5v0to1to5_e2_ckpt252,5_vs_5
3529,-3,1,m_sp_arch_medium_heads_conv16_0_bt_32_r313_m335,4,f5v0to1to5_e2_ckpt252,5_vs_5
3530,2,3,m_sp_arch_medium_heads_conv16_0_bt_32_r313_m335,1,scon_e3_p2_hard_ckpt840,5_vs_5
3531,1,1,m_sp_arch_medium_heads_conv16_0_bt_32_r313_m335,0,scon_e3_p2_hard_ckpt840,5_vs_5
3532,1,2,m_sp_arch_medium_heads_conv16_0_bt_32_r313_m335,1,scon_e3_p2_hard_ckpt840,5_vs_5
3533,3,3,m_sp_arch_medium_heads_conv16_0_bt_32_r313_m335,0,scon_e3_p2_hard_ckpt840,5_vs_5
3534,2,2,m_sp_arch_medium_heads_conv16_0_bt_32_r313_m335,0,scon_e3_p2_hard_ckpt840,5_vs_5
3535,3,3,m_sp_arch_medium_heads_conv16_0_bt_32_r313_m335,0,scon_e3_p2_hard_ckpt840,5_vs_5
3536,2,2,m_sp_arch_medium_heads_conv16_0_bt_32_r313_m335,0,scon_e3_p2_hard_ckpt840,5_vs_5
3537,4,4,m_sp_arch_medium_heads_conv16_0_bt_32_r313_m335,0,scon_e3_p2_hard_ckpt840,5_vs_5
3538,5,5,m_sp_arch_medium_heads_conv16_0_bt_32_r313_m335,0,scon_e3_p2_hard_ckpt840,5_vs_5
3539,4,4,m_sp_arch_medium_heads_conv16_0_bt_32_r313_m335,0,scon_e3_p2_hard_ckpt840,5_vs_5
3540,-4,1,m_sp_arch_medium_heads_conv16_0_bt_32_r313_m335,5,less_then_partially_randomized_checkpoints_bots_4_heads_38_ckpt108,5_vs_5
3541,1,2,m_sp_arch_medium_heads_conv16_0_bt_32_r313_m335,1,less_then_partially_randomized_checkpoints_bots_4_heads_38_ckpt108,5_vs_5
3542,-1,1,m_sp_arch_medium_heads_conv16_0_bt_32_r313_m335,2,less_then_partially_randomized_checkpoints_bots_4_heads_38_ckpt108,5_vs_5
3543,7,8,m_sp_arch_medium_heads_conv16_0_bt_32_r313_m335,1,less_then_partially_randomized_checkpoints_bots_4_heads_38_ckpt108,5_vs_5
3544,3,5,m_sp_arch_medium_heads_conv16_0_bt_32_r313_m335,2,less_then_partially_randomized_checkpoints_bots_4_heads_38_ckpt108,5_vs_5
3545,1,2,m_sp_arch_medium_heads_conv16_0_bt_32_r313_m335,1,less_then_partially_randomized_checkpoints_bots_4_heads_38_ckpt108,5_vs_5
3546,6,6,m_sp_arch_medium_heads_conv16_0_bt_32_r313_m335,0,less_then_partially_randomized_checkpoints_bots_4_heads_38_ckpt108,5_vs_5
3547,4,7,m_sp_arch_medium_heads_conv16_0_bt_32_r313_m335,3,less_then_partially_randomized_checkpoints_bots_4_heads_38_ckpt108,5_vs_5
3548,0,3,m_sp_arch_medium_heads_conv16_0_bt_32_r313_m335,3,less_then_partially_randomized_checkpoints_bots_4_heads_38_ckpt108,5_vs_5
3549,4,5,m_sp_arch_medium_heads_conv16_0_bt_32_r313_m335,1,less_then_partially_randomized_checkpoints_bots_4_heads_38_ckpt108,5_vs_5
3550,3,4,m_sp_arch_medium_heads_conv16_0_bt_32_r313_m335,1,less_then_partially_randomized_entropy_checkpoints_bots_4_heads_39_ckpt109,5_vs_5
3551,3,5,m_sp_arch_medium_heads_conv16_0_bt_32_r313_m335,2,less_then_partially_randomized_entropy_checkpoints_bots_4_heads_39_ckpt109,5_vs_5
3552,7,8,m_sp_arch_medium_heads_conv16_0_bt_32_r313_m335,1,less_then_partially_randomized_entropy_checkpoints_bots_4_heads_39_ckpt109,5_vs_5
3553,-2,3,m_sp_arch_medium_heads_conv16_0_bt_32_r313_m335,5,less_then_partially_randomized_entropy_checkpoints_bots_4_heads_39_ckpt109,5_vs_5
3554,2,3,m_sp_arch_medium_heads_conv16_0_bt_32_r313_m335,1,less_then_partially_randomized_entropy_checkpoints_bots_4_heads_39_ckpt109,5_vs_5
3555,1,4,m_sp_arch_medium_heads_conv16_0_bt_32_r313_m335,3,less_then_partially_randomized_entropy_checkpoints_bots_4_heads_39_ckpt109,5_vs_5
3556,3,3,m_sp_arch_medium_heads_conv16_0_bt_32_r313_m335,0,less_then_partially_randomized_entropy_checkpoints_bots_4_heads_39_ckpt109,5_vs_5
3557,1,4,m_sp_arch_medium_heads_conv16_0_bt_32_r313_m335,3,less_then_partially_randomized_entropy_checkpoints_bots_4_heads_39_ckpt109,5_vs_5
3558,4,6,m_sp_arch_medium_heads_conv16_0_bt_32_r313_m335,2,less_then_partially_randomized_entropy_checkpoints_bots_4_heads_39_ckpt109,5_vs_5
3559,1,4,m_sp_arch_medium_heads_conv16_0_bt_32_r313_m335,3,less_then_partially_randomized_entropy_checkpoints_bots_4_heads_39_ckpt109,5_vs_5
3560,-1,3,m_sp_arch_medium_heads_conv16_0_bt_32_r313_m335,4,reward_shaping_checkpoints_bots_4_heads_1_ckpt360,5_vs_5
3561,2,4,m_sp_arch_medium_heads_conv16_0_bt_32_r313_m335,2,reward_shaping_checkpoints_bots_4_heads_1_ckpt360,5_vs_5
3562,4,6,m_sp_arch_medium_heads_conv16_0_bt_32_r313_m335,2,reward_shaping_checkpoints_bots_4_heads_1_ckpt360,5_vs_5
3563,5,7,m_sp_arch_medium_heads_conv16_0_bt_32_r313_m335,2,reward_shaping_checkpoints_bots_4_heads_1_ckpt360,5_vs_5
3564,2,2,m_sp_arch_medium_heads_conv16_0_bt_32_r313_m335,0,reward_shaping_checkpoints_bots_4_heads_1_ckpt360,5_vs_5
3565,4,5,m_sp_arch_medium_heads_conv16_0_bt_32_r313_m335,1,reward_shaping_checkpoints_bots_4_heads_1_ckpt360,5_vs_5
3566,6,6,m_sp_arch_medium_heads_conv16_0_bt_32_r313_m335,0,reward_shaping_checkpoints_bots_4_heads_1_ckpt360,5_vs_5
3567,7,7,m_sp_arch_medium_heads_conv16_0_bt_32_r313_m335,0,reward_shaping_checkpoints_bots_4_heads_1_ckpt360,5_vs_5
3568,7,8,m_sp_arch_medium_heads_conv16_0_bt_32_r313_m335,1,reward_shaping_checkpoints_bots_4_heads_1_ckpt360,5_vs_5
3569,6,6,m_sp_arch_medium_heads_conv16_0_bt_32_r313_m335,0,reward_shaping_checkpoints_bots_4_heads_1_ckpt360,5_vs_5
3570,3,6,m_sp_arch_medium_heads_conv16_0_bt_32_r313_m335,3,checkpoints_selfplay_e9_sp_ckpt274,5_vs_5
3571,0,2,m_sp_arch_medium_heads_conv16_0_bt_32_r313_m335,2,checkpoints_selfplay_e9_sp_ckpt274,5_vs_5
3572,3,6,m_sp_arch_medium_heads_conv16_0_bt_32_r313_m335,3,checkpoints_selfplay_e9_sp_ckpt274,5_vs_5
3573,-1,3,m_sp_arch_medium_heads_conv16_0_bt_32_r313_m335,4,checkpoints_selfplay_e9_sp_ckpt274,5_vs_5
3574,-3,2,m_sp_arch_medium_heads_conv16_0_bt_32_r313_m335,5,checkpoints_selfplay_e9_sp_ckpt274,5_vs_5
3575,1,2,m_sp_arch_medium_heads_conv16_0_bt_32_r313_m335,1,checkpoints_selfplay_e9_sp_ckpt274,5_vs_5
3576,2,4,m_sp_arch_medium_heads_conv16_0_bt_32_r313_m335,2,checkpoints_selfplay_e9_sp_ckpt274,5_vs_5
3577,3,5,m_sp_arch_medium_heads_conv16_0_bt_32_r313_m335,2,checkpoints_selfplay_e9_sp_ckpt274,5_vs_5
3578,2,3,m_sp_arch_medium_heads_conv16_0_bt_32_r313_m335,1,checkpoints_selfplay_e9_sp_ckpt274,5_vs_5
3579,1,3,m_sp_arch_medium_heads_conv16_0_bt_32_r313_m335,2,checkpoints_selfplay_e9_sp_ckpt274,5_vs_5
3580,-2,0,m_sp_arch_medium_heads_conv16_0_bt_32_r313_m335,2,checkpoints_sp_c_nb_e2_ckpt667,5_vs_5
3581,-9,0,m_sp_arch_medium_heads_conv16_0_bt_32_r313_m335,9,checkpoints_sp_c_nb_e2_ckpt667,5_vs_5
3582,-3,1,m_sp_arch_medium_heads_conv16_0_bt_32_r313_m335,4,checkpoints_sp_c_nb_e2_ckpt667,5_vs_5
3583,-1,2,m_sp_arch_medium_heads_conv16_0_bt_32_r313_m335,3,checkpoints_sp_c_nb_e2_ckpt667,5_vs_5
3584,3,4,m_sp_arch_medium_heads_conv16_0_bt_32_r313_m335,1,checkpoints_sp_c_nb_e2_ckpt667,5_vs_5
3585,1,4,m_sp_arch_medium_heads_conv16_0_bt_32_r313_m335,3,checkpoints_sp_c_nb_e2_ckpt667,5_vs_5
3586,2,4,m_sp_arch_medium_heads_conv16_0_bt_32_r313_m335,2,checkpoints_sp_c_nb_e2_ckpt667,5_vs_5
3587,-2,3,m_sp_arch_medium_heads_conv16_0_bt_32_r313_m335,5,checkpoints_sp_c_nb_e2_ckpt667,5_vs_5
3588,-5,2,m_sp_arch_medium_heads_conv16_0_bt_32_r313_m335,7,checkpoints_sp_c_nb_e2_ckpt667,5_vs_5
3589,-6,0,m_sp_arch_medium_heads_conv16_0_bt_32_r313_m335,6,checkpoints_sp_c_nb_e2_ckpt667,5_vs_5
3590,0,0,m_sp_arch_medium_heads_conv16_0_bt_32_r313_m335,0,scenario_curriculum_ckpt830,5_vs_5
3591,4,4,m_sp_arch_medium_heads_conv16_0_bt_32_r313_m335,0,scenario_curriculum_ckpt830,5_vs_5
3592,1,1,m_sp_arch_medium_heads_conv16_0_bt_32_r313_m335,0,scenario_curriculum_ckpt830,5_vs_5
3593,0,0,m_sp_arch_medium_heads_conv16_0_bt_32_r313_m335,0,scenario_curriculum_ckpt830,5_vs_5
3594,3,3,m_sp_arch_medium_heads_conv16_0_bt_32_r313_m335,0,scenario_curriculum_ckpt830,5_vs_5
3595,2,2,m_sp_arch_medium_heads_conv16_0_bt_32_r313_m335,0,scenario_curriculum_ckpt830,5_vs_5
3596,3,4,m_sp_arch_medium_heads_conv16_0_bt_32_r313_m335,1,scenario_curriculum_ckpt830,5_vs_5
3597,1,1,m_sp_arch_medium_heads_conv16_0_bt_32_r313_m335,0,scenario_curriculum_ckpt830,5_vs_5
3598,3,3,m_sp_arch_medium_heads_conv16_0_bt_32_r313_m335,0,scenario_curriculum_ckpt830,5_vs_5
3599,1,1,m_sp_arch_medium_heads_conv16_0_bt_32_r313_m335,0,scenario_curriculum_ckpt830,5_vs_5
3600,0,2,m_sp_arch_medium_heads_conv16_0_bt_32_r313_m335,2,m_sp_arch_medium_heads_conv16_0_bt_32_r313_m335,5_vs_5
3601,1,5,m_sp_arch_medium_heads_conv16_0_bt_32_r313_m335,4,m_sp_arch_medium_heads_conv16_0_bt_32_r313_m335,5_vs_5
3602,1,3,m_sp_arch_medium_heads_conv16_0_bt_32_r313_m335,2,m_sp_arch_medium_heads_conv16_0_bt_32_r313_m335,5_vs_5
3603,-2,1,m_sp_arch_medium_heads_conv16_0_bt_32_r313_m335,3,m_sp_arch_medium_heads_conv16_0_bt_32_r313_m335,5_vs_5
3604,2,3,m_sp_arch_medium_heads_conv16_0_bt_32_r313_m335,1,m_sp_arch_medium_heads_conv16_0_bt_32_r313_m335,5_vs_5
3605,-2,0,m_sp_arch_medium_heads_conv16_0_bt_32_r313_m335,2,m_sp_arch_medium_heads_conv16_0_bt_32_r313_m335,5_vs_5
3606,0,3,m_sp_arch_medium_heads_conv16_0_bt_32_r313_m335,3,m_sp_arch_medium_heads_conv16_0_bt_32_r313_m335,5_vs_5
3607,1,3,m_sp_arch_medium_heads_conv16_0_bt_32_r313_m335,2,m_sp_arch_medium_heads_conv16_0_bt_32_r313_m335,5_vs_5
3608,0,3,m_sp_arch_medium_heads_conv16_0_bt_32_r313_m335,3,m_sp_arch_medium_heads_conv16_0_bt_32_r313_m335,5_vs_5
3609,0,2,m_sp_arch_medium_heads_conv16_0_bt_32_r313_m335,2,m_sp_arch_medium_heads_conv16_0_bt_32_r313_m335,5_vs_5
3610,0,2,m_sp_arch_medium_heads_conv16_0_bt_32_r313_m335,2,m_sp_arch_longer_heads_bt_32_r201_m335,5_vs_5
3611,1,1,m_sp_arch_medium_heads_conv16_0_bt_32_r313_m335,0,m_sp_arch_longer_heads_bt_32_r201_m335,5_vs_5
3612,4,6,m_sp_arch_medium_heads_conv16_0_bt_32_r313_m335,2,m_sp_arch_longer_heads_bt_32_r201_m335,5_vs_5
3613,1,1,m_sp_arch_medium_heads_conv16_0_bt_32_r313_m335,0,m_sp_arch_longer_heads_bt_32_r201_m335,5_vs_5
3614,-3,0,m_sp_arch_medium_heads_conv16_0_bt_32_r313_m335,3,m_sp_arch_longer_heads_bt_32_r201_m335,5_vs_5
3615,4,5,m_sp_arch_medium_heads_conv16_0_bt_32_r313_m335,1,m_sp_arch_longer_heads_bt_32_r201_m335,5_vs_5
3616,0,2,m_sp_arch_medium_heads_conv16_0_bt_32_r313_m335,2,m_sp_arch_longer_heads_bt_32_r201_m335,5_vs_5
3617,2,3,m_sp_arch_medium_heads_conv16_0_bt_32_r313_m335,1,m_sp_arch_longer_heads_bt_32_r201_m335,5_vs_5
3618,1,3,m_sp_arch_medium_heads_conv16_0_bt_32_r313_m335,2,m_sp_arch_longer_heads_bt_32_r201_m335,5_vs_5
3619,-3,2,m_sp_arch_medium_heads_conv16_0_bt_32_r313_m335,5,m_sp_arch_longer_heads_bt_32_r201_m335,5_vs_5
3620,1,2,m_sp_arch_medium_heads_conv16_0_bt_32_r313_m335,1,m_sp_arch_medium_heads_bt_32_r201_m335,5_vs_5
3621,1,4,m_sp_arch_medium_heads_conv16_0_bt_32_r313_m335,3,m_sp_arch_medium_heads_bt_32_r201_m335,5_vs_5
3622,1,2,m_sp_arch_medium_heads_conv16_0_bt_32_r313_m335,1,m_sp_arch_medium_heads_bt_32_r201_m335,5_vs_5
3623,5,5,m_sp_arch_medium_heads_conv16_0_bt_32_r313_m335,0,m_sp_arch_medium_heads_bt_32_r201_m335,5_vs_5
3624,6,6,m_sp_arch_medium_heads_conv16_0_bt_32_r313_m335,0,m_sp_arch_medium_heads_bt_32_r201_m335,5_vs_5
3625,3,3,m_sp_arch_medium_heads_conv16_0_bt_32_r313_m335,0,m_sp_arch_medium_heads_bt_32_r201_m335,5_vs_5
3626,2,5,m_sp_arch_medium_heads_conv16_0_bt_32_r313_m335,3,m_sp_arch_medium_heads_bt_32_r201_m335,5_vs_5
3627,1,2,m_sp_arch_medium_heads_conv16_0_bt_32_r313_m335,1,m_sp_arch_medium_heads_bt_32_r201_m335,5_vs_5
3628,-5,1,m_sp_arch_medium_heads_conv16_0_bt_32_r313_m335,6,m_sp_arch_medium_heads_bt_32_r201_m335,5_vs_5
3629,4,5,m_sp_arch_medium_heads_conv16_0_bt_32_r313_m335,1,m_sp_arch_medium_heads_bt_32_r201_m335,5_vs_5
3630,-4,0,m_sp_arch_medium_heads_conv16_0_bt_32_r313_m335,4,m_sp_arch_4x1_bt_32_r201_m335,5_vs_5
3631,-7,1,m_sp_arch_medium_heads_conv16_0_bt_32_r313_m335,8,m_sp_arch_4x1_bt_32_r201_m335,5_vs_5
3632,-5,2,m_sp_arch_medium_heads_conv16_0_bt_32_r313_m335,7,m_sp_arch_4x1_bt_32_r201_m335,5_vs_5
3633,-5,1,m_sp_arch_medium_heads_conv16_0_bt_32_r313_m335,6,m_sp_arch_4x1_bt_32_r201_m335,5_vs_5
3634,-5,2,m_sp_arch_medium_heads_conv16_0_bt_32_r313_m335,7,m_sp_arch_4x1_bt_32_r201_m335,5_vs_5
3635,-3,3,m_sp_arch_medium_heads_conv16_0_bt_32_r313_m335,6,m_sp_arch_4x1_bt_32_r201_m335,5_vs_5
3636,-7,0,m_sp_arch_medium_heads_conv16_0_bt_32_r313_m335,7,m_sp_arch_4x1_bt_32_r201_m335,5_vs_5
3637,-6,1,m_sp_arch_medium_heads_conv16_0_bt_32_r313_m335,7,m_sp_arch_4x1_bt_32_r201_m335,5_vs_5
3638,-5,1,m_sp_arch_medium_heads_conv16_0_bt_32_r313_m335,6,m_sp_arch_4x1_bt_32_r201_m335,5_vs_5
3639,-5,2,m_sp_arch_medium_heads_conv16_0_bt_32_r313_m335,7,m_sp_arch_4x1_bt_32_r201_m335,5_vs_5
3640,-4,0,m_sp_arch_medium_heads_conv16_0_bt_32_r313_m335,4,m_sp_arch_4x1_bt_32_r201_cont3_m650,5_vs_5
3641,-5,0,m_sp_arch_medium_heads_conv16_0_bt_32_r313_m335,5,m_sp_arch_4x1_bt_32_r201_cont3_m650,5_vs_5
3642,-6,0,m_sp_arch_medium_heads_conv16_0_bt_32_r313_m335,6,m_sp_arch_4x1_bt_32_r201_cont3_m650,5_vs_5
3643,-11,0,m_sp_arch_medium_heads_conv16_0_bt_32_r313_m335,11,m_sp_arch_4x1_bt_32_r201_cont3_m650,5_vs_5
3644,-6,0,m_sp_arch_medium_heads_conv16_0_bt_32_r313_m335,6,m_sp_arch_4x1_bt_32_r201_cont3_m650,5_vs_5
3645,-4,1,m_sp_arch_medium_heads_conv16_0_bt_32_r313_m335,5,m_sp_arch_4x1_bt_32_r201_cont3_m650,5_vs_5
3646,-3,1,m_sp_arch_medium_heads_conv16_0_bt_32_r313_m335,4,m_sp_arch_4x1_bt_32_r201_cont3_m650,5_vs_5
3647,-7,1,m_sp_arch_medium_heads_conv16_0_bt_32_r313_m335,8,m_sp_arch_4x1_bt_32_r201_cont3_m650,5_vs_5
3648,-6,0,m_sp_arch_medium_heads_conv16_0_bt_32_r313_m335,6,m_sp_arch_4x1_bt_32_r201_cont3_m650,5_vs_5
3649,-4,0,m_sp_arch_medium_heads_conv16_0_bt_32_r313_m335,4,m_sp_arch_4x1_bt_32_r201_cont3_m650,5_vs_5
3650,-4,1,m_sp_arch_medium_heads_conv16_0_bt_32_r313_m335,5,explt_v0_7_2_m54,5_vs_5
3651,-2,2,m_sp_arch_medium_heads_conv16_0_bt_32_r313_m335,4,explt_v0_7_2_m54,5_vs_5
3652,-4,1,m_sp_arch_medium_heads_conv16_0_bt_32_r313_m335,5,explt_v0_7_2_m54,5_vs_5
3653,-2,0,m_sp_arch_medium_heads_conv16_0_bt_32_r313_m335,2,explt_v0_7_2_m54,5_vs_5
3654,1,1,m_sp_arch_medium_heads_conv16_0_bt_32_r313_m335,0,explt_v0_7_2_m54,5_vs_5
3655,-5,0,m_sp_arch_medium_heads_conv16_0_bt_32_r313_m335,5,explt_v0_7_2_m54,5_vs_5
3656,-4,0,m_sp_arch_medium_heads_conv16_0_bt_32_r313_m335,4,explt_v0_7_2_m54,5_vs_5
3657,0,2,m_sp_arch_medium_heads_conv16_0_bt_32_r313_m335,2,explt_v0_7_2_m54,5_vs_5
3658,-5,0,m_sp_arch_medium_heads_conv16_0_bt_32_r313_m335,5,explt_v0_7_2_m54,5_vs_5
3659,-1,0,m_sp_arch_medium_heads_conv16_0_bt_32_r313_m335,1,explt_v0_7_2_m54,5_vs_5
3660,-7,1,m_sp_arch_medium_heads_conv16_0_bt_32_r313_m335,8,m_sp_sc3v3_arch_2x1_32_r500_cont4x1_m224,5_vs_5
3661,-4,1,m_sp_arch_medium_heads_conv16_0_bt_32_r313_m335,5,m_sp_sc3v3_arch_2x1_32_r500_cont4x1_m224,5_vs_5
3662,-6,0,m_sp_arch_medium_heads_conv16_0_bt_32_r313_m335,6,m_sp_sc3v3_arch_2x1_32_r500_cont4x1_m224,5_vs_5
3663,-4,0,m_sp_arch_medium_heads_conv16_0_bt_32_r313_m335,4,m_sp_sc3v3_arch_2x1_32_r500_cont4x1_m224,5_vs_5
3664,-3,2,m_sp_arch_medium_heads_conv16_0_bt_32_r313_m335,5,m_sp_sc3v3_arch_2x1_32_r500_cont4x1_m224,5_vs_5
3665,-5,0,m_sp_arch_medium_heads_conv16_0_bt_32_r313_m335,5,m_sp_sc3v3_arch_2x1_32_r500_cont4x1_m224,5_vs_5
3666,-3,1,m_sp_arch_medium_heads_conv16_0_bt_32_r313_m335,4,m_sp_sc3v3_arch_2x1_32_r500_cont4x1_m224,5_vs_5
3667,-5,0,m_sp_arch_medium_heads_conv16_0_bt_32_r313_m335,5,m_sp_sc3v3_arch_2x1_32_r500_cont4x1_m224,5_vs_5
3668,-5,3,m_sp_arch_medium_heads_conv16_0_bt_32_r313_m335,8,m_sp_sc3v3_arch_2x1_32_r500_cont4x1_m224,5_vs_5
3669,-3,1,m_sp_arch_medium_heads_conv16_0_bt_32_r313_m335,4,m_sp_sc3v3_arch_2x1_32_r500_cont4x1_m224,5_vs_5
3670,-10,0,m_sp_arch_medium_heads_conv16_0_bt_32_r313_m335,10,m_sp_arch_4x1_bt_32_roles_r500_m335,5_vs_5
3671,-8,0,m_sp_arch_medium_heads_conv16_0_bt_32_r313_m335,8,m_sp_arch_4x1_bt_32_roles_r500_m335,5_vs_5
3672,-8,2,m_sp_arch_medium_heads_conv16_0_bt_32_r313_m335,10,m_sp_arch_4x1_bt_32_roles_r500_m335,5_vs_5
3673,-10,1,m_sp_arch_medium_heads_conv16_0_bt_32_r313_m335,11,m_sp_arch_4x1_bt_32_roles_r500_m335,5_vs_5
3674,-6,0,m_sp_arch_medium_heads_conv16_0_bt_32_r313_m335,6,m_sp_arch_4x1_bt_32_roles_r500_m335,5_vs_5
3675,-4,1,m_sp_arch_medium_heads_conv16_0_bt_32_r313_m335,5,m_sp_arch_4x1_bt_32_roles_r500_m335,5_vs_5
3676,-8,0,m_sp_arch_medium_heads_conv16_0_bt_32_r313_m335,8,m_sp_arch_4x1_bt_32_roles_r500_m335,5_vs_5
3677,-7,1,m_sp_arch_medium_heads_conv16_0_bt_32_r313_m335,8,m_sp_arch_4x1_bt_32_roles_r500_m335,5_vs_5
3678,-6,2,m_sp_arch_medium_heads_conv16_0_bt_32_r313_m335,8,m_sp_arch_4x1_bt_32_roles_r500_m335,5_vs_5
3679,-6,1,m_sp_arch_medium_heads_conv16_0_bt_32_r313_m335,7,m_sp_arch_4x1_bt_32_roles_r500_m335,5_vs_5
3680,8,9,less_then_partially_randomized_checkpoints_bots_4_heads_38_ckpt108,1,easy_bots,5_vs_5
3681,8,10,less_then_partially_randomized_checkpoints_bots_4_heads_38_ckpt108,2,easy_bots,5_vs_5
3682,11,11,less_then_partially_randomized_checkpoints_bots_4_heads_38_ckpt108,0,easy_bots,5_vs_5
3683,10,10,less_then_partially_randomized_checkpoints_bots_4_heads_38_ckpt108,0,easy_bots,5_vs_5
3684,3,4,less_then_partially_randomized_checkpoints_bots_4_heads_38_ckpt108,1,easy_bots,5_vs_5
3685,10,11,less_then_partially_randomized_checkpoints_bots_4_heads_38_ckpt108,1,easy_bots,5_vs_5
3686,7,7,less_then_partially_randomized_checkpoints_bots_4_heads_38_ckpt108,0,easy_bots,5_vs_5
3687,5,6,less_then_partially_randomized_checkpoints_bots_4_heads_38_ckpt108,1,easy_bots,5_vs_5
3688,10,10,less_then_partially_randomized_checkpoints_bots_4_heads_38_ckpt108,0,easy_bots,5_vs_5
3689,11,12,less_then_partially_randomized_checkpoints_bots_4_heads_38_ckpt108,1,easy_bots,5_vs_5
3690,4,6,less_then_partially_randomized_checkpoints_bots_4_heads_38_ckpt108,2,easy_bots,5_vs_5
3691,9,11,less_then_partially_randomized_checkpoints_bots_4_heads_38_ckpt108,2,easy_bots,5_vs_5
3692,15,15,less_then_partially_randomized_checkpoints_bots_4_heads_38_ckpt108,0,easy_bots,5_vs_5
3693,7,9,less_then_partially_randomized_checkpoints_bots_4_heads_38_ckpt108,2,easy_bots,5_vs_5
3694,12,13,less_then_partially_randomized_checkpoints_bots_4_heads_38_ckpt108,1,easy_bots,5_vs_5
3695,6,7,less_then_partially_randomized_checkpoints_bots_4_heads_38_ckpt108,1,easy_bots,5_vs_5
3696,8,9,less_then_partially_randomized_checkpoints_bots_4_heads_38_ckpt108,1,easy_bots,5_vs_5
3697,12,12,less_then_partially_randomized_checkpoints_bots_4_heads_38_ckpt108,0,easy_bots,5_vs_5
3698,10,11,less_then_partially_randomized_checkpoints_bots_4_heads_38_ckpt108,1,easy_bots,5_vs_5
3699,11,11,less_then_partially_randomized_checkpoints_bots_4_heads_38_ckpt108,0,easy_bots,5_vs_5
3700,8,10,less_then_partially_randomized_checkpoints_bots_4_heads_38_ckpt108,2,medium_bots,5_vs_5_medium
3701,3,5,less_then_partially_randomized_checkpoints_bots_4_heads_38_ckpt108,2,medium_bots,5_vs_5_medium
3702,7,8,less_then_partially_randomized_checkpoints_bots_4_heads_38_ckpt108,1,medium_bots,5_vs_5_medium
3703,3,4,less_then_partially_randomized_checkpoints_bots_4_heads_38_ckpt108,1,medium_bots,5_vs_5_medium
3704,4,4,less_then_partially_randomized_checkpoints_bots_4_heads_38_ckpt108,0,medium_bots,5_vs_5_medium
3705,6,6,less_then_partially_randomized_checkpoints_bots_4_heads_38_ckpt108,0,medium_bots,5_vs_5_medium
3706,7,7,less_then_partially_randomized_checkpoints_bots_4_heads_38_ckpt108,0,medium_bots,5_vs_5_medium
3707,2,4,less_then_partially_randomized_checkpoints_bots_4_heads_38_ckpt108,2,medium_bots,5_vs_5_medium
3708,11,11,less_then_partially_randomized_checkpoints_bots_4_heads_38_ckpt108,0,medium_bots,5_vs_5_medium
3709,5,7,less_then_partially_randomized_checkpoints_bots_4_heads_38_ckpt108,2,medium_bots,5_vs_5_medium
3710,6,8,less_then_partially_randomized_checkpoints_bots_4_heads_38_ckpt108,2,medium_bots,5_vs_5_medium
3711,12,12,less_then_partially_randomized_checkpoints_bots_4_heads_38_ckpt108,0,medium_bots,5_vs_5_medium
3712,6,9,less_then_partially_randomized_checkpoints_bots_4_heads_38_ckpt108,3,medium_bots,5_vs_5_medium
3713,7,9,less_then_partially_randomized_checkpoints_bots_4_heads_38_ckpt108,2,medium_bots,5_vs_5_medium
3714,9,10,less_then_partially_randomized_checkpoints_bots_4_heads_38_ckpt108,1,medium_bots,5_vs_5_medium
3715,6,7,less_then_partially_randomized_checkpoints_bots_4_heads_38_ckpt108,1,medium_bots,5_vs_5_medium
3716,7,8,less_then_partially_randomized_checkpoints_bots_4_heads_38_ckpt108,1,medium_bots,5_vs_5_medium
3717,7,7,less_then_partially_randomized_checkpoints_bots_4_heads_38_ckpt108,0,medium_bots,5_vs_5_medium
3718,10,10,less_then_partially_randomized_checkpoints_bots_4_heads_38_ckpt108,0,medium_bots,5_vs_5_medium
3719,8,9,less_then_partially_randomized_checkpoints_bots_4_heads_38_ckpt108,1,medium_bots,5_vs_5_medium
3720,7,7,less_then_partially_randomized_checkpoints_bots_4_heads_38_ckpt108,0,hard_bots,5_vs_5_hard
3721,3,5,less_then_partially_randomized_checkpoints_bots_4_heads_38_ckpt108,2,hard_bots,5_vs_5_hard
3722,7,7,less_then_partially_randomized_checkpoints_bots_4_heads_38_ckpt108,0,hard_bots,5_vs_5_hard
3723,1,3,less_then_partially_randomized_checkpoints_bots_4_heads_38_ckpt108,2,hard_bots,5_vs_5_hard
3724,3,6,less_then_partially_randomized_checkpoints_bots_4_heads_38_ckpt108,3,hard_bots,5_vs_5_hard
3725,3,5,less_then_partially_randomized_checkpoints_bots_4_heads_38_ckpt108,2,hard_bots,5_vs_5_hard
3726,6,6,less_then_partially_randomized_checkpoints_bots_4_heads_38_ckpt108,0,hard_bots,5_vs_5_hard
3727,4,5,less_then_partially_randomized_checkpoints_bots_4_heads_38_ckpt108,1,hard_bots,5_vs_5_hard
3728,2,4,less_then_partially_randomized_checkpoints_bots_4_heads_38_ckpt108,2,hard_bots,5_vs_5_hard
3729,1,2,less_then_partially_randomized_checkpoints_bots_4_heads_38_ckpt108,1,hard_bots,5_vs_5_hard
3730,6,7,less_then_partially_randomized_checkpoints_bots_4_heads_38_ckpt108,1,hard_bots,5_vs_5_hard
3731,1,5,less_then_partially_randomized_checkpoints_bots_4_heads_38_ckpt108,4,hard_bots,5_vs_5_hard
3732,-1,1,less_then_partially_randomized_checkpoints_bots_4_heads_38_ckpt108,2,hard_bots,5_vs_5_hard
3733,5,6,less_then_partially_randomized_checkpoints_bots_4_heads_38_ckpt108,1,hard_bots,5_vs_5_hard
3734,2,3,less_then_partially_randomized_checkpoints_bots_4_heads_38_ckpt108,1,hard_bots,5_vs_5_hard
3735,2,4,less_then_partially_randomized_checkpoints_bots_4_heads_38_ckpt108,2,hard_bots,5_vs_5_hard
3736,7,8,less_then_partially_randomized_checkpoints_bots_4_heads_38_ckpt108,1,hard_bots,5_vs_5_hard
3737,5,6,less_then_partially_randomized_checkpoints_bots_4_heads_38_ckpt108,1,hard_bots,5_vs_5_hard
3738,1,2,less_then_partially_randomized_checkpoints_bots_4_heads_38_ckpt108,1,hard_bots,5_vs_5_hard
3739,4,5,less_then_partially_randomized_checkpoints_bots_4_heads_38_ckpt108,1,hard_bots,5_vs_5_hard
3740,-3,2,less_then_partially_randomized_checkpoints_bots_4_heads_38_ckpt108,5,f5v0to1to2t05_e2_ckpt291,5_vs_5
3741,2,4,less_then_partially_randomized_checkpoints_bots_4_heads_38_ckpt108,2,f5v0to1to2t05_e2_ckpt291,5_vs_5
3742,-1,2,less_then_partially_randomized_checkpoints_bots_4_heads_38_ckpt108,3,f5v0to1to2t05_e2_ckpt291,5_vs_5
3743,-1,1,less_then_partially_randomized_checkpoints_bots_4_heads_38_ckpt108,2,f5v0to1to2t05_e2_ckpt291,5_vs_5
3744,-5,2,less_then_partially_randomized_checkpoints_bots_4_heads_38_ckpt108,7,f5v0to1to2t05_e2_ckpt291,5_vs_5
3745,1,4,less_then_partially_randomized_checkpoints_bots_4_heads_38_ckpt108,3,f5v0to1to2t05_e2_ckpt291,5_vs_5
3746,-3,2,less_then_partially_randomized_checkpoints_bots_4_heads_38_ckpt108,5,f5v0to1to2t05_e2_ckpt291,5_vs_5
3747,-2,2,less_then_partially_randomized_checkpoints_bots_4_heads_38_ckpt108,4,f5v0to1to2t05_e2_ckpt291,5_vs_5
3748,0,4,less_then_partially_randomized_checkpoints_bots_4_heads_38_ckpt108,4,f5v0to1to2t05_e2_ckpt291,5_vs_5
3749,-2,1,less_then_partially_randomized_checkpoints_bots_4_heads_38_ckpt108,3,f5v0to1to2t05_e2_ckpt291,5_vs_5
3750,1,5,less_then_partially_randomized_checkpoints_bots_4_heads_38_ckpt108,4,f5v0to1to5_e2_ckpt252,5_vs_5
3751,1,4,less_then_partially_randomized_checkpoints_bots_4_heads_38_ckpt108,3,f5v0to1to5_e2_ckpt252,5_vs_5
3752,-2,3,less_then_partially_randomized_checkpoints_bots_4_heads_38_ckpt108,5,f5v0to1to5_e2_ckpt252,5_vs_5
3753,-1,2,less_then_partially_randomized_checkpoints_bots_4_heads_38_ckpt108,3,f5v0to1to5_e2_ckpt252,5_vs_5
3754,1,6,less_then_partially_randomized_checkpoints_bots_4_heads_38_ckpt108,5,f5v0to1to5_e2_ckpt252,5_vs_5
3755,0,7,less_then_partially_randomized_checkpoints_bots_4_heads_38_ckpt108,7,f5v0to1to5_e2_ckpt252,5_vs_5
3756,3,4,less_then_partially_randomized_checkpoints_bots_4_heads_38_ckpt108,1,f5v0to1to5_e2_ckpt252,5_vs_5
3757,-2,1,less_then_partially_randomized_checkpoints_bots_4_heads_38_ckpt108,3,f5v0to1to5_e2_ckpt252,5_vs_5
3758,-4,1,less_then_partially_randomized_checkpoints_bots_4_heads_38_ckpt108,5,f5v0to1to5_e2_ckpt252,5_vs_5
3759,3,4,less_then_partially_randomized_checkpoints_bots_4_heads_38_ckpt108,1,f5v0to1to5_e2_ckpt252,5_vs_5
3760,0,2,less_then_partially_randomized_checkpoints_bots_4_heads_38_ckpt108,2,scon_e3_p2_hard_ckpt840,5_vs_5
3761,1,1,less_then_partially_randomized_checkpoints_bots_4_heads_38_ckpt108,0,scon_e3_p2_hard_ckpt840,5_vs_5
3762,3,4,less_then_partially_randomized_checkpoints_bots_4_heads_38_ckpt108,1,scon_e3_p2_hard_ckpt840,5_vs_5
3763,1,2,less_then_partially_randomized_checkpoints_bots_4_heads_38_ckpt108,1,scon_e3_p2_hard_ckpt840,5_vs_5
3764,3,5,less_then_partially_randomized_checkpoints_bots_4_heads_38_ckpt108,2,scon_e3_p2_hard_ckpt840,5_vs_5
3765,-1,2,less_then_partially_randomized_checkpoints_bots_4_heads_38_ckpt108,3,scon_e3_p2_hard_ckpt840,5_vs_5
3766,2,4,less_then_partially_randomized_checkpoints_bots_4_heads_38_ckpt108,2,scon_e3_p2_hard_ckpt840,5_vs_5
3767,-3,1,less_then_partially_randomized_checkpoints_bots_4_heads_38_ckpt108,4,scon_e3_p2_hard_ckpt840,5_vs_5
3768,0,1,less_then_partially_randomized_checkpoints_bots_4_heads_38_ckpt108,1,scon_e3_p2_hard_ckpt840,5_vs_5
3769,3,4,less_then_partially_randomized_checkpoints_bots_4_heads_38_ckpt108,1,scon_e3_p2_hard_ckpt840,5_vs_5
3770,3,5,less_then_partially_randomized_checkpoints_bots_4_heads_38_ckpt108,2,less_then_partially_randomized_checkpoints_bots_4_heads_38_ckpt108,5_vs_5
3771,4,7,less_then_partially_randomized_checkpoints_bots_4_heads_38_ckpt108,3,less_then_partially_randomized_checkpoints_bots_4_heads_38_ckpt108,5_vs_5
3772,-2,4,less_then_partially_randomized_checkpoints_bots_4_heads_38_ckpt108,6,less_then_partially_randomized_checkpoints_bots_4_heads_38_ckpt108,5_vs_5
3773,-2,2,less_then_partially_randomized_checkpoints_bots_4_heads_38_ckpt108,4,less_then_partially_randomized_checkpoints_bots_4_heads_38_ckpt108,5_vs_5
3774,-1,3,less_then_partially_randomized_checkpoints_bots_4_heads_38_ckpt108,4,less_then_partially_randomized_checkpoints_bots_4_heads_38_ckpt108,5_vs_5
3775,-2,4,less_then_partially_randomized_checkpoints_bots_4_heads_38_ckpt108,6,less_then_partially_randomized_checkpoints_bots_4_heads_38_ckpt108,5_vs_5
3776,-2,3,less_then_partially_randomized_checkpoints_bots_4_heads_38_ckpt108,5,less_then_partially_randomized_checkpoints_bots_4_heads_38_ckpt108,5_vs_5
3777,0,4,less_then_partially_randomized_checkpoints_bots_4_heads_38_ckpt108,4,less_then_partially_randomized_checkpoints_bots_4_heads_38_ckpt108,5_vs_5
3778,-1,5,less_then_partially_randomized_checkpoints_bots_4_heads_38_ckpt108,6,less_then_partially_randomized_checkpoints_bots_4_heads_38_ckpt108,5_vs_5
3779,0,4,less_then_partially_randomized_checkpoints_bots_4_heads_38_ckpt108,4,less_then_partially_randomized_checkpoints_bots_4_heads_38_ckpt108,5_vs_5
3780,-1,3,less_then_partially_randomized_checkpoints_bots_4_heads_38_ckpt108,4,less_then_partially_randomized_entropy_checkpoints_bots_4_heads_39_ckpt109,5_vs_5
3781,-1,5,less_then_partially_randomized_checkpoints_bots_4_heads_38_ckpt108,6,less_then_partially_randomized_entropy_checkpoints_bots_4_heads_39_ckpt109,5_vs_5
3782,2,5,less_then_partially_randomized_checkpoints_bots_4_heads_38_ckpt108,3,less_then_partially_randomized_entropy_checkpoints_bots_4_heads_39_ckpt109,5_vs_5
3783,2,5,less_then_partially_randomized_checkpoints_bots_4_heads_38_ckpt108,3,less_then_partially_randomized_entropy_checkpoints_bots_4_heads_39_ckpt109,5_vs_5
3784,-1,3,less_then_partially_randomized_checkpoints_bots_4_heads_38_ckpt108,4,less_then_partially_randomized_entropy_checkpoints_bots_4_heads_39_ckpt109,5_vs_5
3785,0,4,less_then_partially_randomized_checkpoints_bots_4_heads_38_ckpt108,4,less_then_partially_randomized_entropy_checkpoints_bots_4_heads_39_ckpt109,5_vs_5
3786,2,5,less_then_partially_randomized_checkpoints_bots_4_heads_38_ckpt108,3,less_then_partially_randomized_entropy_checkpoints_bots_4_heads_39_ckpt109,5_vs_5
3787,1,3,less_then_partially_randomized_checkpoints_bots_4_heads_38_ckpt108,2,less_then_partially_randomized_entropy_checkpoints_bots_4_heads_39_ckpt109,5_vs_5
3788,4,6,less_then_partially_randomized_checkpoints_bots_4_heads_38_ckpt108,2,less_then_partially_randomized_entropy_checkpoints_bots_4_heads_39_ckpt109,5_vs_5
3789,1,4,less_then_partially_randomized_checkpoints_bots_4_heads_38_ckpt108,3,less_then_partially_randomized_entropy_checkpoints_bots_4_heads_39_ckpt109,5_vs_5
3790,-2,3,less_then_partially_randomized_checkpoints_bots_4_heads_38_ckpt108,5,reward_shaping_checkpoints_bots_4_heads_1_ckpt360,5_vs_5
3791,2,3,less_then_partially_randomized_checkpoints_bots_4_heads_38_ckpt108,1,reward_shaping_checkpoints_bots_4_heads_1_ckpt360,5_vs_5
3792,3,5,less_then_partially_randomized_checkpoints_bots_4_heads_38_ckpt108,2,reward_shaping_checkpoints_bots_4_heads_1_ckpt360,5_vs_5
3793,2,4,less_then_partially_randomized_checkpoints_bots_4_heads_38_ckpt108,2,reward_shaping_checkpoints_bots_4_heads_1_ckpt360,5_vs_5
3794,3,6,less_then_partially_randomized_checkpoints_bots_4_heads_38_ckpt108,3,reward_shaping_checkpoints_bots_4_heads_1_ckpt360,5_vs_5
3795,1,5,less_then_partially_randomized_checkpoints_bots_4_heads_38_ckpt108,4,reward_shaping_checkpoints_bots_4_heads_1_ckpt360,5_vs_5
3796,3,6,less_then_partially_randomized_checkpoints_bots_4_heads_38_ckpt108,3,reward_shaping_checkpoints_bots_4_heads_1_ckpt360,5_vs_5
3797,2,6,less_then_partially_randomized_checkpoints_bots_4_heads_38_ckpt108,4,reward_shaping_checkpoints_bots_4_heads_1_ckpt360,5_vs_5
3798,0,2,less_then_partially_randomized_checkpoints_bots_4_heads_38_ckpt108,2,reward_shaping_checkpoints_bots_4_heads_1_ckpt360,5_vs_5
3799,-1,4,less_then_partially_randomized_checkpoints_bots_4_heads_38_ckpt108,5,reward_shaping_checkpoints_bots_4_heads_1_ckpt360,5_vs_5
3800,-8,1,less_then_partially_randomized_checkpoints_bots_4_heads_38_ckpt108,9,checkpoints_selfplay_e9_sp_ckpt274,5_vs_5
3801,-9,3,less_then_partially_randomized_checkpoints_bots_4_heads_38_ckpt108,12,checkpoints_selfplay_e9_sp_ckpt274,5_vs_5
3802,-10,2,less_then_partially_randomized_checkpoints_bots_4_heads_38_ckpt108,12,checkpoints_selfplay_e9_sp_ckpt274,5_vs_5
3803,-2,2,less_then_partially_randomized_checkpoints_bots_4_heads_38_ckpt108,4,checkpoints_selfplay_e9_sp_ckpt274,5_vs_5
3804,-10,0,less_then_partially_randomized_checkpoints_bots_4_heads_38_ckpt108,10,checkpoints_selfplay_e9_sp_ckpt274,5_vs_5
3805,-6,1,less_then_partially_randomized_checkpoints_bots_4_heads_38_ckpt108,7,checkpoints_selfplay_e9_sp_ckpt274,5_vs_5
3806,-11,1,less_then_partially_randomized_checkpoints_bots_4_heads_38_ckpt108,12,checkpoints_selfplay_e9_sp_ckpt274,5_vs_5
3807,-11,0,less_then_partially_randomized_checkpoints_bots_4_heads_38_ckpt108,11,checkpoints_selfplay_e9_sp_ckpt274,5_vs_5
3808,-6,3,less_then_partially_randomized_checkpoints_bots_4_heads_38_ckpt108,9,checkpoints_selfplay_e9_sp_ckpt274,5_vs_5
3809,-11,2,less_then_partially_randomized_checkpoints_bots_4_heads_38_ckpt108,13,checkpoints_selfplay_e9_sp_ckpt274,5_vs_5
3810,-8,1,less_then_partially_randomized_checkpoints_bots_4_heads_38_ckpt108,9,checkpoints_sp_c_nb_e2_ckpt667,5_vs_5
3811,-10,1,less_then_partially_randomized_checkpoints_bots_4_heads_38_ckpt108,11,checkpoints_sp_c_nb_e2_ckpt667,5_vs_5
3812,-2,3,less_then_partially_randomized_checkpoints_bots_4_heads_38_ckpt108,5,checkpoints_sp_c_nb_e2_ckpt667,5_vs_5
3813,-6,2,less_then_partially_randomized_checkpoints_bots_4_heads_38_ckpt108,8,checkpoints_sp_c_nb_e2_ckpt667,5_vs_5
3814,-5,0,less_then_partially_randomized_checkpoints_bots_4_heads_38_ckpt108,5,checkpoints_sp_c_nb_e2_ckpt667,5_vs_5
3815,-6,0,less_then_partially_randomized_checkpoints_bots_4_heads_38_ckpt108,6,checkpoints_sp_c_nb_e2_ckpt667,5_vs_5
3816,-11,0,less_then_partially_randomized_checkpoints_bots_4_heads_38_ckpt108,11,checkpoints_sp_c_nb_e2_ckpt667,5_vs_5
3817,-5,1,less_then_partially_randomized_checkpoints_bots_4_heads_38_ckpt108,6,checkpoints_sp_c_nb_e2_ckpt667,5_vs_5
3818,-9,1,less_then_partially_randomized_checkpoints_bots_4_heads_38_ckpt108,10,checkpoints_sp_c_nb_e2_ckpt667,5_vs_5
3819,-5,2,less_then_partially_randomized_checkpoints_bots_4_heads_38_ckpt108,7,checkpoints_sp_c_nb_e2_ckpt667,5_vs_5
3820,3,3,less_then_partially_randomized_checkpoints_bots_4_heads_38_ckpt108,0,scenario_curriculum_ckpt830,5_vs_5
3821,0,0,less_then_partially_randomized_checkpoints_bots_4_heads_38_ckpt108,0,scenario_curriculum_ckpt830,5_vs_5
3822,1,1,less_then_partially_randomized_checkpoints_bots_4_heads_38_ckpt108,0,scenario_curriculum_ckpt830,5_vs_5
3823,0,0,less_then_partially_randomized_checkpoints_bots_4_heads_38_ckpt108,0,scenario_curriculum_ckpt830,5_vs_5
3824,1,1,less_then_partially_randomized_checkpoints_bots_4_heads_38_ckpt108,0,scenario_curriculum_ckpt830,5_vs_5
3825,3,3,less_then_partially_randomized_checkpoints_bots_4_heads_38_ckpt108,0,scenario_curriculum_ckpt830,5_vs_5
3826,2,2,less_then_partially_randomized_checkpoints_bots_4_heads_38_ckpt108,0,scenario_curriculum_ckpt830,5_vs_5
3827,1,1,less_then_partially_randomized_checkpoints_bots_4_heads_38_ckpt108,0,scenario_curriculum_ckpt830,5_vs_5
3828,2,2,less_then_partially_randomized_checkpoints_bots_4_heads_38_ckpt108,0,scenario_curriculum_ckpt830,5_vs_5
3829,0,0,less_then_partially_randomized_checkpoints_bots_4_heads_38_ckpt108,0,scenario_curriculum_ckpt830,5_vs_5
3830,2,5,less_then_partially_randomized_checkpoints_bots_4_heads_38_ckpt108,3,m_sp_arch_medium_heads_conv16_0_bt_32_r313_m335,5_vs_5
3831,-3,1,less_then_partially_randomized_checkpoints_bots_4_heads_38_ckpt108,4,m_sp_arch_medium_heads_conv16_0_bt_32_r313_m335,5_vs_5
3832,2,3,less_then_partially_randomized_checkpoints_bots_4_heads_38_ckpt108,1,m_sp_arch_medium_heads_conv16_0_bt_32_r313_m335,5_vs_5
3833,0,3,less_then_partially_randomized_checkpoints_bots_4_heads_38_ckpt108,3,m_sp_arch_medium_heads_conv16_0_bt_32_r313_m335,5_vs_5
3834,0,2,less_then_partially_randomized_checkpoints_bots_4_heads_38_ckpt108,2,m_sp_arch_medium_heads_conv16_0_bt_32_r313_m335,5_vs_5
3835,-2,1,less_then_partially_randomized_checkpoints_bots_4_heads_38_ckpt108,3,m_sp_arch_medium_heads_conv16_0_bt_32_r313_m335,5_vs_5
3836,0,3,less_then_partially_randomized_checkpoints_bots_4_heads_38_ckpt108,3,m_sp_arch_medium_heads_conv16_0_bt_32_r313_m335,5_vs_5
3837,-6,1,less_then_partially_randomized_checkpoints_bots_4_heads_38_ckpt108,7,m_sp_arch_medium_heads_conv16_0_bt_32_r313_m335,5_vs_5
3838,0,2,less_then_partially_randomized_checkpoints_bots_4_heads_38_ckpt108,2,m_sp_arch_medium_heads_conv16_0_bt_32_r313_m335,5_vs_5
3839,-1,2,less_then_partially_randomized_checkpoints_bots_4_heads_38_ckpt108,3,m_sp_arch_medium_heads_conv16_0_bt_32_r313_m335,5_vs_5
3840,-7,0,less_then_partially_randomized_checkpoints_bots_4_heads_38_ckpt108,7,m_sp_arch_longer_heads_bt_32_r201_m335,5_vs_5
3841,-8,0,less_then_partially_randomized_checkpoints_bots_4_heads_38_ckpt108,8,m_sp_arch_longer_heads_bt_32_r201_m335,5_vs_5
3842,-4,1,less_then_partially_randomized_checkpoints_bots_4_heads_38_ckpt108,5,m_sp_arch_longer_heads_bt_32_r201_m335,5_vs_5
3843,-6,1,less_then_partially_randomized_checkpoints_bots_4_heads_38_ckpt108,7,m_sp_arch_longer_heads_bt_32_r201_m335,5_vs_5
3844,-8,0,less_then_partially_randomized_checkpoints_bots_4_heads_38_ckpt108,8,m_sp_arch_longer_heads_bt_32_r201_m335,5_vs_5
3845,-7,0,less_then_partially_randomized_checkpoints_bots_4_heads_38_ckpt108,7,m_sp_arch_longer_heads_bt_32_r201_m335,5_vs_5
3846,-8,1,less_then_partially_randomized_checkpoints_bots_4_heads_38_ckpt108,9,m_sp_arch_longer_heads_bt_32_r201_m335,5_vs_5
3847,-1,2,less_then_partially_randomized_checkpoints_bots_4_heads_38_ckpt108,3,m_sp_arch_longer_heads_bt_32_r201_m335,5_vs_5
3848,-3,1,less_then_partially_randomized_checkpoints_bots_4_heads_38_ckpt108,4,m_sp_arch_longer_heads_bt_32_r201_m335,5_vs_5
3849,-5,1,less_then_partially_randomized_checkpoints_bots_4_heads_38_ckpt108,6,m_sp_arch_longer_heads_bt_32_r201_m335,5_vs_5
3850,-4,3,less_then_partially_randomized_checkpoints_bots_4_heads_38_ckpt108,7,m_sp_arch_medium_heads_bt_32_r201_m335,5_vs_5
3851,-2,4,less_then_partially_randomized_checkpoints_bots_4_heads_38_ckpt108,6,m_sp_arch_medium_heads_bt_32_r201_m335,5_vs_5
3852,0,5,less_then_partially_randomized_checkpoints_bots_4_heads_38_ckpt108,5,m_sp_arch_medium_heads_bt_32_r201_m335,5_vs_5
3853,-3,2,less_then_partially_randomized_checkpoints_bots_4_heads_38_ckpt108,5,m_sp_arch_medium_heads_bt_32_r201_m335,5_vs_5
3854,-6,1,less_then_partially_randomized_checkpoints_bots_4_heads_38_ckpt108,7,m_sp_arch_medium_heads_bt_32_r201_m335,5_vs_5
3855,-2,2,less_then_partially_randomized_checkpoints_bots_4_heads_38_ckpt108,4,m_sp_arch_medium_heads_bt_32_r201_m335,5_vs_5
3856,-3,2,less_then_partially_randomized_checkpoints_bots_4_heads_38_ckpt108,5,m_sp_arch_medium_heads_bt_32_r201_m335,5_vs_5
3857,-6,1,less_then_partially_randomized_checkpoints_bots_4_heads_38_ckpt108,7,m_sp_arch_medium_heads_bt_32_r201_m335,5_vs_5
3858,-4,2,less_then_partially_randomized_checkpoints_bots_4_heads_38_ckpt108,6,m_sp_arch_medium_heads_bt_32_r201_m335,5_vs_5
3859,-6,1,less_then_partially_randomized_checkpoints_bots_4_heads_38_ckpt108,7,m_sp_arch_medium_heads_bt_32_r201_m335,5_vs_5
3860,-13,0,less_then_partially_randomized_checkpoints_bots_4_heads_38_ckpt108,13,m_sp_arch_4x1_bt_32_r201_m335,5_vs_5
3861,-10,1,less_then_partially_randomized_checkpoints_bots_4_heads_38_ckpt108,11,m_sp_arch_4x1_bt_32_r201_m335,5_vs_5
3862,-17,0,less_then_partially_randomized_checkpoints_bots_4_heads_38_ckpt108,17,m_sp_arch_4x1_bt_32_r201_m335,5_vs_5
3863,-11,0,less_then_partially_randomized_checkpoints_bots_4_heads_38_ckpt108,11,m_sp_arch_4x1_bt_32_r201_m335,5_vs_5
3864,-15,1,less_then_partially_randomized_checkpoints_bots_4_heads_38_ckpt108,16,m_sp_arch_4x1_bt_32_r201_m335,5_vs_5
3865,-9,0,less_then_partially_randomized_checkpoints_bots_4_heads_38_ckpt108,9,m_sp_arch_4x1_bt_32_r201_m335,5_vs_5
3866,-6,0,less_then_partially_randomized_checkpoints_bots_4_heads_38_ckpt108,6,m_sp_arch_4x1_bt_32_r201_m335,5_vs_5
3867,-11,0,less_then_partially_randomized_checkpoints_bots_4_heads_38_ckpt108,11,m_sp_arch_4x1_bt_32_r201_m335,5_vs_5
3868,-8,1,less_then_partially_randomized_checkpoints_bots_4_heads_38_ckpt108,9,m_sp_arch_4x1_bt_32_r201_m335,5_vs_5
3869,-14,0,less_then_partially_randomized_checkpoints_bots_4_heads_38_ckpt108,14,m_sp_arch_4x1_bt_32_r201_m335,5_vs_5
3870,-13,0,less_then_partially_randomized_checkpoints_bots_4_heads_38_ckpt108,13,m_sp_arch_4x1_bt_32_r201_cont3_m650,5_vs_5
3871,-14,0,less_then_partially_randomized_checkpoints_bots_4_heads_38_ckpt108,14,m_sp_arch_4x1_bt_32_r201_cont3_m650,5_vs_5
3872,-9,0,less_then_partially_randomized_checkpoints_bots_4_heads_38_ckpt108,9,m_sp_arch_4x1_bt_32_r201_cont3_m650,5_vs_5
3873,-10,1,less_then_partially_randomized_checkpoints_bots_4_heads_38_ckpt108,11,m_sp_arch_4x1_bt_32_r201_cont3_m650,5_vs_5
3874,-8,0,less_then_partially_randomized_checkpoints_bots_4_heads_38_ckpt108,8,m_sp_arch_4x1_bt_32_r201_cont3_m650,5_vs_5
3875,-13,1,less_then_partially_randomized_checkpoints_bots_4_heads_38_ckpt108,14,m_sp_arch_4x1_bt_32_r201_cont3_m650,5_vs_5
3876,-10,1,less_then_partially_randomized_checkpoints_bots_4_heads_38_ckpt108,11,m_sp_arch_4x1_bt_32_r201_cont3_m650,5_vs_5
3877,-16,0,less_then_partially_randomized_checkpoints_bots_4_heads_38_ckpt108,16,m_sp_arch_4x1_bt_32_r201_cont3_m650,5_vs_5
3878,-15,0,less_then_partially_randomized_checkpoints_bots_4_heads_38_ckpt108,15,m_sp_arch_4x1_bt_32_r201_cont3_m650,5_vs_5
3879,-11,0,less_then_partially_randomized_checkpoints_bots_4_heads_38_ckpt108,11,m_sp_arch_4x1_bt_32_r201_cont3_m650,5_vs_5
3880,-2,2,less_then_partially_randomized_checkpoints_bots_4_heads_38_ckpt108,4,explt_v0_7_2_m54,5_vs_5
3881,-7,0,less_then_partially_randomized_checkpoints_bots_4_heads_38_ckpt108,7,explt_v0_7_2_m54,5_vs_5
3882,-3,0,less_then_partially_randomized_checkpoints_bots_4_heads_38_ckpt108,3,explt_v0_7_2_m54,5_vs_5
3883,-1,0,less_then_partially_randomized_checkpoints_bots_4_heads_38_ckpt108,1,explt_v0_7_2_m54,5_vs_5
3884,-5,0,less_then_partially_randomized_checkpoints_bots_4_heads_38_ckpt108,5,explt_v0_7_2_m54,5_vs_5
3885,-7,0,less_then_partially_randomized_checkpoints_bots_4_heads_38_ckpt108,7,explt_v0_7_2_m54,5_vs_5
3886,0,3,less_then_partially_randomized_checkpoints_bots_4_heads_38_ckpt108,3,explt_v0_7_2_m54,5_vs_5
3887,-1,1,less_then_partially_randomized_checkpoints_bots_4_heads_38_ckpt108,2,explt_v0_7_2_m54,5_vs_5
3888,-2,0,less_then_partially_randomized_checkpoints_bots_4_heads_38_ckpt108,2,explt_v0_7_2_m54,5_vs_5
3889,-1,1,less_then_partially_randomized_checkpoints_bots_4_heads_38_ckpt108,2,explt_v0_7_2_m54,5_vs_5
3890,-11,0,less_then_partially_randomized_checkpoints_bots_4_heads_38_ckpt108,11,m_sp_sc3v3_arch_2x1_32_r500_cont4x1_m224,5_vs_5
3891,-16,0,less_then_partially_randomized_checkpoints_bots_4_heads_38_ckpt108,16,m_sp_sc3v3_arch_2x1_32_r500_cont4x1_m224,5_vs_5
3892,-8,0,less_then_partially_randomized_checkpoints_bots_4_heads_38_ckpt108,8,m_sp_sc3v3_arch_2x1_32_r500_cont4x1_m224,5_vs_5
3893,-10,0,less_then_partially_randomized_checkpoints_bots_4_heads_38_ckpt108,10,m_sp_sc3v3_arch_2x1_32_r500_cont4x1_m224,5_vs_5
3894,-14,0,less_then_partially_randomized_checkpoints_bots_4_heads_38_ckpt108,14,m_sp_sc3v3_arch_2x1_32_r500_cont4x1_m224,5_vs_5
3895,-9,1,less_then_partially_randomized_checkpoints_bots_4_heads_38_ckpt108,10,m_sp_sc3v3_arch_2x1_32_r500_cont4x1_m224,5_vs_5
3896,-10,2,less_then_partially_randomized_checkpoints_bots_4_heads_38_ckpt108,12,m_sp_sc3v3_arch_2x1_32_r500_cont4x1_m224,5_vs_5
3897,-15,0,less_then_partially_randomized_checkpoints_bots_4_heads_38_ckpt108,15,m_sp_sc3v3_arch_2x1_32_r500_cont4x1_m224,5_vs_5
3898,-11,1,less_then_partially_randomized_checkpoints_bots_4_heads_38_ckpt108,12,m_sp_sc3v3_arch_2x1_32_r500_cont4x1_m224,5_vs_5
3899,-12,0,less_then_partially_randomized_checkpoints_bots_4_heads_38_ckpt108,12,m_sp_sc3v3_arch_2x1_32_r500_cont4x1_m224,5_vs_5
3900,-14,0,less_then_partially_randomized_checkpoints_bots_4_heads_38_ckpt108,14,m_sp_arch_4x1_bt_32_roles_r500_m335,5_vs_5
3901,-10,1,less_then_partially_randomized_checkpoints_bots_4_heads_38_ckpt108,11,m_sp_arch_4x1_bt_32_roles_r500_m335,5_vs_5
3902,-10,0,less_then_partially_randomized_checkpoints_bots_4_heads_38_ckpt108,10,m_sp_arch_4x1_bt_32_roles_r500_m335,5_vs_5
3903,-14,1,less_then_partially_randomized_checkpoints_bots_4_heads_38_ckpt108,15,m_sp_arch_4x1_bt_32_roles_r500_m335,5_vs_5
3904,-13,1,less_then_partially_randomized_checkpoints_bots_4_heads_38_ckpt108,14,m_sp_arch_4x1_bt_32_roles_r500_m335,5_vs_5
3905,-7,1,less_then_partially_randomized_checkpoints_bots_4_heads_38_ckpt108,8,m_sp_arch_4x1_bt_32_roles_r500_m335,5_vs_5
3906,-12,0,less_then_partially_randomized_checkpoints_bots_4_heads_38_ckpt108,12,m_sp_arch_4x1_bt_32_roles_r500_m335,5_vs_5
3907,-13,0,less_then_partially_randomized_checkpoints_bots_4_heads_38_ckpt108,13,m_sp_arch_4x1_bt_32_roles_r500_m335,5_vs_5
3908,-16,1,less_then_partially_randomized_checkpoints_bots_4_heads_38_ckpt108,17,m_sp_arch_4x1_bt_32_roles_r500_m335,5_vs_5
3909,-16,0,less_then_partially_randomized_checkpoints_bots_4_heads_38_ckpt108,16,m_sp_arch_4x1_bt_32_roles_r500_m335,5_vs_5
3910,8,9,f5v0to1to2t05_e2_ckpt291,1,easy_bots,5_vs_5
3911,10,12,f5v0to1to2t05_e2_ckpt291,2,easy_bots,5_vs_5
3912,10,10,f5v0to1to2t05_e2_ckpt291,0,easy_bots,5_vs_5
3913,13,14,f5v0to1to2t05_e2_ckpt291,1,easy_bots,5_vs_5
3914,13,13,f5v0to1to2t05_e2_ckpt291,0,easy_bots,5_vs_5
3915,8,8,f5v0to1to2t05_e2_ckpt291,0,easy_bots,5_vs_5
3916,10,11,f5v0to1to2t05_e2_ckpt291,1,easy_bots,5_vs_5
3917,18,19,f5v0to1to2t05_e2_ckpt291,1,easy_bots,5_vs_5
3918,17,17,f5v0to1to2t05_e2_ckpt291,0,easy_bots,5_vs_5
3919,11,11,f5v0to1to2t05_e2_ckpt291,0,easy_bots,5_vs_5
3920,17,17,f5v0to1to2t05_e2_ckpt291,0,easy_bots,5_vs_5
3921,5,6,f5v0to1to2t05_e2_ckpt291,1,easy_bots,5_vs_5
3922,15,16,f5v0to1to2t05_e2_ckpt291,1,easy_bots,5_vs_5
3923,4,4,f5v0to1to2t05_e2_ckpt291,0,easy_bots,5_vs_5
3924,15,15,f5v0to1to2t05_e2_ckpt291,0,easy_bots,5_vs_5
3925,6,6,f5v0to1to2t05_e2_ckpt291,0,easy_bots,5_vs_5
3926,9,9,f5v0to1to2t05_e2_ckpt291,0,easy_bots,5_vs_5
3927,10,10,f5v0to1to2t05_e2_ckpt291,0,easy_bots,5_vs_5
3928,18,18,f5v0to1to2t05_e2_ckpt291,0,easy_bots,5_vs_5
3929,16,17,f5v0to1to2t05_e2_ckpt291,1,easy_bots,5_vs_5
3930,7,7,f5v0to1to2t05_e2_ckpt291,0,medium_bots,5_vs_5_medium
3931,8,8,f5v0to1to2t05_e2_ckpt291,0,medium_bots,5_vs_5_medium
3932,7,8,f5v0to1to2t05_e2_ckpt291,1,medium_bots,5_vs_5_medium
3933,5,5,f5v0to1to2t05_e2_ckpt291,0,medium_bots,5_vs_5_medium
3934,7,7,f5v0to1to2t05_e2_ckpt291,0,medium_bots,5_vs_5_medium
3935,6,7,f5v0to1to2t05_e2_ckpt291,1,medium_bots,5_vs_5_medium
3936,7,8,f5v0to1to2t05_e2_ckpt291,1,medium_bots,5_vs_5_medium
3937,7,10,f5v0to1to2t05_e2_ckpt291,3,medium_bots,5_vs_5_medium
3938,3,4,f5v0to1to2t05_e2_ckpt291,1,medium_bots,5_vs_5_medium
3939,10,11,f5v0to1to2t05_e2_ckpt291,1,medium_bots,5_vs_5_medium
3940,7,7,f5v0to1to2t05_e2_ckpt291,0,medium_bots,5_vs_5_medium
3941,7,8,f5v0to1to2t05_e2_ckpt291,1,medium_bots,5_vs_5_medium
3942,8,8,f5v0to1to2t05_e2_ckpt291,0,medium_bots,5_vs_5_medium
3943,10,12,f5v0to1to2t05_e2_ckpt291,2,medium_bots,5_vs_5_medium
3944,9,10,f5v0to1to2t05_e2_ckpt291,1,medium_bots,5_vs_5_medium
3945,5,6,f5v0to1to2t05_e2_ckpt291,1,medium_bots,5_vs_5_medium
3946,4,7,f5v0to1to2t05_e2_ckpt291,3,medium_bots,5_vs_5_medium
3947,5,8,f5v0to1to2t05_e2_ckpt291,3,medium_bots,5_vs_5_medium
3948,10,11,f5v0to1to2t05_e2_ckpt291,1,medium_bots,5_vs_5_medium
3949,9,9,f5v0to1to2t05_e2_ckpt291,0,medium_bots,5_vs_5_medium
3950,11,11,f5v0to1to2t05_e2_ckpt291,0,hard_bots,5_vs_5_hard
3951,4,6,f5v0to1to2t05_e2_ckpt291,2,hard_bots,5_vs_5_hard
3952,7,8,f5v0to1to2t05_e2_ckpt291,1,hard_bots,5_vs_5_hard
3953,7,7,f5v0to1to2t05_e2_ckpt291,0,hard_bots,5_vs_5_hard
3954,8,11,f5v0to1to2t05_e2_ckpt291,3,hard_bots,5_vs_5_hard
3955,4,5,f5v0to1to2t05_e2_ckpt291,1,hard_bots,5_vs_5_hard
3956,5,6,f5v0to1to2t05_e2_ckpt291,1,hard_bots,5_vs_5_hard
3957,8,10,f5v0to1to2t05_e2_ckpt291,2,hard_bots,5_vs_5_hard
3958,6,6,f5v0to1to2t05_e2_ckpt291,0,hard_bots,5_vs_5_hard
3959,2,6,f5v0to1to2t05_e2_ckpt291,4,hard_bots,5_vs_5_hard
3960,8,8,f5v0to1to2t05_e2_ckpt291,0,hard_bots,5_vs_5_hard
3961,4,7,f5v0to1to2t05_e2_ckpt291,3,hard_bots,5_vs_5_hard
3962,9,10,f5v0to1to2t05_e2_ckpt291,1,hard_bots,5_vs_5_hard
3963,10,11,f5v0to1to2t05_e2_ckpt291,1,hard_bots,5_vs_5_hard
3964,7,8,f5v0to1to2t05_e2_ckpt291,1,hard_bots,5_vs_5_hard
3965,5,7,f5v0to1to2t05_e2_ckpt291,2,hard_bots,5_vs_5_hard
3966,2,6,f5v0to1to2t05_e2_ckpt291,4,hard_bots,5_vs_5_hard
3967,2,3,f5v0to1to2t05_e2_ckpt291,1,hard_bots,5_vs_5_hard
3968,5,7,f5v0to1to2t05_e2_ckpt291,2,hard_bots,5_vs_5_hard
3969,7,7,f5v0to1to2t05_e2_ckpt291,0,hard_bots,5_vs_5_hard
3970,-1,5,f5v0to1to2t05_e2_ckpt291,6,f5v0to1to2t05_e2_ckpt291,5_vs_5
3971,-2,2,f5v0to1to2t05_e2_ckpt291,4,f5v0to1to2t05_e2_ckpt291,5_vs_5
3972,0,2,f5v0to1to2t05_e2_ckpt291,2,f5v0to1to2t05_e2_ckpt291,5_vs_5
3973,1,4,f5v0to1to2t05_e2_ckpt291,3,f5v0to1to2t05_e2_ckpt291,5_vs_5
3974,4,4,f5v0to1to2t05_e2_ckpt291,0,f5v0to1to2t05_e2_ckpt291,5_vs_5
3975,0,4,f5v0to1to2t05_e2_ckpt291,4,f5v0to1to2t05_e2_ckpt291,5_vs_5
3976,-3,0,f5v0to1to2t05_e2_ckpt291,3,f5v0to1to2t05_e2_ckpt291,5_vs_5
3977,5,6,f5v0to1to2t05_e2_ckpt291,1,f5v0to1to2t05_e2_ckpt291,5_vs_5
3978,-2,2,f5v0to1to2t05_e2_ckpt291,4,f5v0to1to2t05_e2_ckpt291,5_vs_5
3979,-6,1,f5v0to1to2t05_e2_ckpt291,7,f5v0to1to2t05_e2_ckpt291,5_vs_5
3980,2,5,f5v0to1to2t05_e2_ckpt291,3,f5v0to1to5_e2_ckpt252,5_vs_5
3981,-6,1,f5v0to1to2t05_e2_ckpt291,7,f5v0to1to5_e2_ckpt252,5_vs_5
3982,-9,2,f5v0to1to2t05_e2_ckpt291,11,f5v0to1to5_e2_ckpt252,5_vs_5
3983,-1,2,f5v0to1to2t05_e2_ckpt291,3,f5v0to1to5_e2_ckpt252,5_vs_5
3984,0,5,f5v0to1to2t05_e2_ckpt291,5,f5v0to1to5_e2_ckpt252,5_vs_5
3985,1,3,f5v0to1to2t05_e2_ckpt291,2,f5v0to1to5_e2_ckpt252,5_vs_5
3986,2,5,f5v0to1to2t05_e2_ckpt291,3,f5v0to1to5_e2_ckpt252,5_vs_5
3987,-1,3,f5v0to1to2t05_e2_ckpt291,4,f5v0to1to5_e2_ckpt252,5_vs_5
3988,0,4,f5v0to1to2t05_e2_ckpt291,4,f5v0to1to5_e2_ckpt252,5_vs_5
3989,0,3,f5v0to1to2t05_e2_ckpt291,3,f5v0to1to5_e2_ckpt252,5_vs_5
3990,5,5,f5v0to1to2t05_e2_ckpt291,0,scon_e3_p2_hard_ckpt840,5_vs_5
3991,4,5,f5v0to1to2t05_e2_ckpt291,1,scon_e3_p2_hard_ckpt840,5_vs_5
3992,2,4,f5v0to1to2t05_e2_ckpt291,2,scon_e3_p2_hard_ckpt840,5_vs_5
3993,0,1,f5v0to1to2t05_e2_ckpt291,1,scon_e3_p2_hard_ckpt840,5_vs_5
3994,2,6,f5v0to1to2t05_e2_ckpt291,4,scon_e3_p2_hard_ckpt840,5_vs_5
3995,4,4,f5v0to1to2t05_e2_ckpt291,0,scon_e3_p2_hard_ckpt840,5_vs_5
3996,2,3,f5v0to1to2t05_e2_ckpt291,1,scon_e3_p2_hard_ckpt840,5_vs_5
3997,-1,2,f5v0to1to2t05_e2_ckpt291,3,scon_e3_p2_hard_ckpt840,5_vs_5
3998,2,4,f5v0to1to2t05_e2_ckpt291,2,scon_e3_p2_hard_ckpt840,5_vs_5
3999,6,6,f5v0to1to2t05_e2_ckpt291,0,scon_e3_p2_hard_ckpt840,5_vs_5
4000,0,5,f5v0to1to2t05_e2_ckpt291,5,less_then_partially_randomized_checkpoints_bots_4_heads_38_ckpt108,5_vs_5
4001,1,5,f5v0to1to2t05_e2_ckpt291,4,less_then_partially_randomized_checkpoints_bots_4_heads_38_ckpt108,5_vs_5
4002,1,5,f5v0to1to2t05_e2_ckpt291,4,less_then_partially_randomized_checkpoints_bots_4_heads_38_ckpt108,5_vs_5
4003,2,7,f5v0to1to2t05_e2_ckpt291,5,less_then_partially_randomized_checkpoints_bots_4_heads_38_ckpt108,5_vs_5
4004,1,4,f5v0to1to2t05_e2_ckpt291,3,less_then_partially_randomized_checkpoints_bots_4_heads_38_ckpt108,5_vs_5
4005,1,4,f5v0to1to2t05_e2_ckpt291,3,less_then_partially_randomized_checkpoints_bots_4_heads_38_ckpt108,5_vs_5
4006,4,6,f5v0to1to2t05_e2_ckpt291,2,less_then_partially_randomized_checkpoints_bots_4_heads_38_ckpt108,5_vs_5
4007,1,4,f5v0to1to2t05_e2_ckpt291,3,less_then_partially_randomized_checkpoints_bots_4_heads_38_ckpt108,5_vs_5
4008,1,4,f5v0to1to2t05_e2_ckpt291,3,less_then_partially_randomized_checkpoints_bots_4_heads_38_ckpt108,5_vs_5
4009,3,4,f5v0to1to2t05_e2_ckpt291,1,less_then_partially_randomized_checkpoints_bots_4_heads_38_ckpt108,5_vs_5
4010,2,4,f5v0to1to2t05_e2_ckpt291,2,less_then_partially_randomized_entropy_checkpoints_bots_4_heads_39_ckpt109,5_vs_5
4011,-3,3,f5v0to1to2t05_e2_ckpt291,6,less_then_partially_randomized_entropy_checkpoints_bots_4_heads_39_ckpt109,5_vs_5
4012,0,6,f5v0to1to2t05_e2_ckpt291,6,less_then_partially_randomized_entropy_checkpoints_bots_4_heads_39_ckpt109,5_vs_5
4013,-1,3,f5v0to1to2t05_e2_ckpt291,4,less_then_partially_randomized_entropy_checkpoints_bots_4_heads_39_ckpt109,5_vs_5
4014,-3,1,f5v0to1to2t05_e2_ckpt291,4,less_then_partially_randomized_entropy_checkpoints_bots_4_heads_39_ckpt109,5_vs_5
4015,5,7,f5v0to1to2t05_e2_ckpt291,2,less_then_partially_randomized_entropy_checkpoints_bots_4_heads_39_ckpt109,5_vs_5
4016,2,5,f5v0to1to2t05_e2_ckpt291,3,less_then_partially_randomized_entropy_checkpoints_bots_4_heads_39_ckpt109,5_vs_5
4017,-2,6,f5v0to1to2t05_e2_ckpt291,8,less_then_partially_randomized_entropy_checkpoints_bots_4_heads_39_ckpt109,5_vs_5
4018,2,7,f5v0to1to2t05_e2_ckpt291,5,less_then_partially_randomized_entropy_checkpoints_bots_4_heads_39_ckpt109,5_vs_5
4019,1,4,f5v0to1to2t05_e2_ckpt291,3,less_then_partially_randomized_entropy_checkpoints_bots_4_heads_39_ckpt109,5_vs_5
4020,1,4,f5v0to1to2t05_e2_ckpt291,3,reward_shaping_checkpoints_bots_4_heads_1_ckpt360,5_vs_5
4021,4,6,f5v0to1to2t05_e2_ckpt291,2,reward_shaping_checkpoints_bots_4_heads_1_ckpt360,5_vs_5
4022,2,4,f5v0to1to2t05_e2_ckpt291,2,reward_shaping_checkpoints_bots_4_heads_1_ckpt360,5_vs_5
4023,3,5,f5v0to1to2t05_e2_ckpt291,2,reward_shaping_checkpoints_bots_4_heads_1_ckpt360,5_vs_5
4024,1,3,f5v0to1to2t05_e2_ckpt291,2,reward_shaping_checkpoints_bots_4_heads_1_ckpt360,5_vs_5
4025,4,4,f5v0to1to2t05_e2_ckpt291,0,reward_shaping_checkpoints_bots_4_heads_1_ckpt360,5_vs_5
4026,5,6,f5v0to1to2t05_e2_ckpt291,1,reward_shaping_checkpoints_bots_4_heads_1_ckpt360,5_vs_5
4027,6,6,f5v0to1to2t05_e2_ckpt291,0,reward_shaping_checkpoints_bots_4_heads_1_ckpt360,5_vs_5
4028,4,5,f5v0to1to2t05_e2_ckpt291,1,reward_shaping_checkpoints_bots_4_heads_1_ckpt360,5_vs_5
4029,7,7,f5v0to1to2t05_e2_ckpt291,0,reward_shaping_checkpoints_bots_4_heads_1_ckpt360,5_vs_5
4030,-5,3,f5v0to1to2t05_e2_ckpt291,8,checkpoints_selfplay_e9_sp_ckpt274,5_vs_5
4031,-8,4,f5v0to1to2t05_e2_ckpt291,12,checkpoints_selfplay_e9_sp_ckpt274,5_vs_5
4032,-6,3,f5v0to1to2t05_e2_ckpt291,9,checkpoints_selfplay_e9_sp_ckpt274,5_vs_5
4033,-7,2,f5v0to1to2t05_e2_ckpt291,9,checkpoints_selfplay_e9_sp_ckpt274,5_vs_5
4034,-10,1,f5v0to1to2t05_e2_ckpt291,11,checkpoints_selfplay_e9_sp_ckpt274,5_vs_5
4035,-3,3,f5v0to1to2t05_e2_ckpt291,6,checkpoints_selfplay_e9_sp_ckpt274,5_vs_5
4036,-5,1,f5v0to1to2t05_e2_ckpt291,6,checkpoints_selfplay_e9_sp_ckpt274,5_vs_5
4037,-7,3,f5v0to1to2t05_e2_ckpt291,10,checkpoints_selfplay_e9_sp_ckpt274,5_vs_5
4038,-8,1,f5v0to1to2t05_e2_ckpt291,9,checkpoints_selfplay_e9_sp_ckpt274,5_vs_5
4039,-4,2,f5v0to1to2t05_e2_ckpt291,6,checkpoints_selfplay_e9_sp_ckpt274,5_vs_5
4040,-6,1,f5v0to1to2t05_e2_ckpt291,7,checkpoints_sp_c_nb_e2_ckpt667,5_vs_5
4041,-2,2,f5v0to1to2t05_e2_ckpt291,4,checkpoints_sp_c_nb_e2_ckpt667,5_vs_5
4042,-4,0,f5v0to1to2t05_e2_ckpt291,4,checkpoints_sp_c_nb_e2_ckpt667,5_vs_5
4043,-7,0,f5v0to1to2t05_e2_ckpt291,7,checkpoints_sp_c_nb_e2_ckpt667,5_vs_5
4044,-5,1,f5v0to1to2t05_e2_ckpt291,6,checkpoints_sp_c_nb_e2_ckpt667,5_vs_5
4045,-6,0,f5v0to1to2t05_e2_ckpt291,6,checkpoints_sp_c_nb_e2_ckpt667,5_vs_5
4046,-7,2,f5v0to1to2t05_e2_ckpt291,9,checkpoints_sp_c_nb_e2_ckpt667,5_vs_5
4047,-5,2,f5v0to1to2t05_e2_ckpt291,7,checkpoints_sp_c_nb_e2_ckpt667,5_vs_5
4048,-9,1,f5v0to1to2t05_e2_ckpt291,10,checkpoints_sp_c_nb_e2_ckpt667,5_vs_5
4049,-2,2,f5v0to1to2t05_e2_ckpt291,4,checkpoints_sp_c_nb_e2_ckpt667,5_vs_5
4050,0,0,f5v0to1to2t05_e2_ckpt291,0,scenario_curriculum_ckpt830,5_vs_5
4051,0,0,f5v0to1to2t05_e2_ckpt291,0,scenario_curriculum_ckpt830,5_vs_5
4052,0,0,f5v0to1to2t05_e2_ckpt291,0,scenario_curriculum_ckpt830,5_vs_5
4053,0,0,f5v0to1to2t05_e2_ckpt291,0,scenario_curriculum_ckpt830,5_vs_5
4054,1,1,f5v0to1to2t05_e2_ckpt291,0,scenario_curriculum_ckpt830,5_vs_5
4055,1,1,f5v0to1to2t05_e2_ckpt291,0,scenario_curriculum_ckpt830,5_vs_5
4056,4,4,f5v0to1to2t05_e2_ckpt291,0,scenario_curriculum_ckpt830,5_vs_5
4057,0,0,f5v0to1to2t05_e2_ckpt291,0,scenario_curriculum_ckpt830,5_vs_5
4058,1,1,f5v0to1to2t05_e2_ckpt291,0,scenario_curriculum_ckpt830,5_vs_5
4059,4,4,f5v0to1to2t05_e2_ckpt291,0,scenario_curriculum_ckpt830,5_vs_5
4060,-1,2,f5v0to1to2t05_e2_ckpt291,3,m_sp_arch_medium_heads_conv16_0_bt_32_r313_m335,5_vs_5
4061,-1,2,f5v0to1to2t05_e2_ckpt291,3,m_sp_arch_medium_heads_conv16_0_bt_32_r313_m335,5_vs_5
4062,2,3,f5v0to1to2t05_e2_ckpt291,1,m_sp_arch_medium_heads_conv16_0_bt_32_r313_m335,5_vs_5
4063,0,3,f5v0to1to2t05_e2_ckpt291,3,m_sp_arch_medium_heads_conv16_0_bt_32_r313_m335,5_vs_5
4064,-2,1,f5v0to1to2t05_e2_ckpt291,3,m_sp_arch_medium_heads_conv16_0_bt_32_r313_m335,5_vs_5
4065,-4,0,f5v0to1to2t05_e2_ckpt291,4,m_sp_arch_medium_heads_conv16_0_bt_32_r313_m335,5_vs_5
4066,-4,1,f5v0to1to2t05_e2_ckpt291,5,m_sp_arch_medium_heads_conv16_0_bt_32_r313_m335,5_vs_5
4067,-3,1,f5v0to1to2t05_e2_ckpt291,4,m_sp_arch_medium_heads_conv16_0_bt_32_r313_m335,5_vs_5
4068,-2,0,f5v0to1to2t05_e2_ckpt291,2,m_sp_arch_medium_heads_conv16_0_bt_32_r313_m335,5_vs_5
4069,-1,2,f5v0to1to2t05_e2_ckpt291,3,m_sp_arch_medium_heads_conv16_0_bt_32_r313_m335,5_vs_5
4070,-5,3,f5v0to1to2t05_e2_ckpt291,8,m_sp_arch_longer_heads_bt_32_r201_m335,5_vs_5
4071,-7,0,f5v0to1to2t05_e2_ckpt291,7,m_sp_arch_longer_heads_bt_32_r201_m335,5_vs_5
4072,-1,3,f5v0to1to2t05_e2_ckpt291,4,m_sp_arch_longer_heads_bt_32_r201_m335,5_vs_5
4073,-5,1,f5v0to1to2t05_e2_ckpt291,6,m_sp_arch_longer_heads_bt_32_r201_m335,5_vs_5
4074,-3,2,f5v0to1to2t05_e2_ckpt291,5,m_sp_arch_longer_heads_bt_32_r201_m335,5_vs_5
4075,-9,0,f5v0to1to2t05_e2_ckpt291,9,m_sp_arch_longer_heads_bt_32_r201_m335,5_vs_5
4076,-4,2,f5v0to1to2t05_e2_ckpt291,6,m_sp_arch_longer_heads_bt_32_r201_m335,5_vs_5
4077,-7,0,f5v0to1to2t05_e2_ckpt291,7,m_sp_arch_longer_heads_bt_32_r201_m335,5_vs_5
4078,-3,2,f5v0to1to2t05_e2_ckpt291,5,m_sp_arch_longer_heads_bt_32_r201_m335,5_vs_5
4079,-5,1,f5v0to1to2t05_e2_ckpt291,6,m_sp_arch_longer_heads_bt_32_r201_m335,5_vs_5
4080,-3,3,f5v0to1to2t05_e2_ckpt291,6,m_sp_arch_medium_heads_bt_32_r201_m335,5_vs_5
4081,-4,2,f5v0to1to2t05_e2_ckpt291,6,m_sp_arch_medium_heads_bt_32_r201_m335,5_vs_5
4082,-9,1,f5v0to1to2t05_e2_ckpt291,10,m_sp_arch_medium_heads_bt_32_r201_m335,5_vs_5
4083,-1,4,f5v0to1to2t05_e2_ckpt291,5,m_sp_arch_medium_heads_bt_32_r201_m335,5_vs_5
4084,-6,1,f5v0to1to2t05_e2_ckpt291,7,m_sp_arch_medium_heads_bt_32_r201_m335,5_vs_5
4085,-7,0,f5v0to1to2t05_e2_ckpt291,7,m_sp_arch_medium_heads_bt_32_r201_m335,5_vs_5
4086,-11,1,f5v0to1to2t05_e2_ckpt291,12,m_sp_arch_medium_heads_bt_32_r201_m335,5_vs_5
4087,-5,2,f5v0to1to2t05_e2_ckpt291,7,m_sp_arch_medium_heads_bt_32_r201_m335,5_vs_5
4088,-6,1,f5v0to1to2t05_e2_ckpt291,7,m_sp_arch_medium_heads_bt_32_r201_m335,5_vs_5
4089,-11,0,f5v0to1to2t05_e2_ckpt291,11,m_sp_arch_medium_heads_bt_32_r201_m335,5_vs_5
4090,-6,2,f5v0to1to2t05_e2_ckpt291,8,m_sp_arch_4x1_bt_32_r201_m335,5_vs_5
4091,-11,0,f5v0to1to2t05_e2_ckpt291,11,m_sp_arch_4x1_bt_32_r201_m335,5_vs_5
4092,-11,0,f5v0to1to2t05_e2_ckpt291,11,m_sp_arch_4x1_bt_32_r201_m335,5_vs_5
4093,-9,1,f5v0to1to2t05_e2_ckpt291,10,m_sp_arch_4x1_bt_32_r201_m335,5_vs_5
4094,-8,0,f5v0to1to2t05_e2_ckpt291,8,m_sp_arch_4x1_bt_32_r201_m335,5_vs_5
4095,-14,0,f5v0to1to2t05_e2_ckpt291,14,m_sp_arch_4x1_bt_32_r201_m335,5_vs_5
4096,-6,2,f5v0to1to2t05_e2_ckpt291,8,m_sp_arch_4x1_bt_32_r201_m335,5_vs_5
4097,-10,0,f5v0to1to2t05_e2_ckpt291,10,m_sp_arch_4x1_bt_32_r201_m335,5_vs_5
4098,-8,1,f5v0to1to2t05_e2_ckpt291,9,m_sp_arch_4x1_bt_32_r201_m335,5_vs_5
4099,-8,1,f5v0to1to2t05_e2_ckpt291,9,m_sp_arch_4x1_bt_32_r201_m335,5_vs_5
4100,-9,1,f5v0to1to2t05_e2_ckpt291,10,m_sp_arch_4x1_bt_32_r201_cont3_m650,5_vs_5
4101,-5,0,f5v0to1to2t05_e2_ckpt291,5,m_sp_arch_4x1_bt_32_r201_cont3_m650,5_vs_5
4102,-8,0,f5v0to1to2t05_e2_ckpt291,8,m_sp_arch_4x1_bt_32_r201_cont3_m650,5_vs_5
4103,-12,0,f5v0to1to2t05_e2_ckpt291,12,m_sp_arch_4x1_bt_32_r201_cont3_m650,5_vs_5
4104,-7,1,f5v0to1to2t05_e2_ckpt291,8,m_sp_arch_4x1_bt_32_r201_cont3_m650,5_vs_5
4105,-9,0,f5v0to1to2t05_e2_ckpt291,9,m_sp_arch_4x1_bt_32_r201_cont3_m650,5_vs_5
4106,-7,1,f5v0to1to2t05_e2_ckpt291,8,m_sp_arch_4x1_bt_32_r201_cont3_m650,5_vs_5
4107,-10,0,f5v0to1to2t05_e2_ckpt291,10,m_sp_arch_4x1_bt_32_r201_cont3_m650,5_vs_5
4108,-14,0,f5v0to1to2t05_e2_ckpt291,14,m_sp_arch_4x1_bt_32_r201_cont3_m650,5_vs_5
4109,-8,2,f5v0to1to2t05_e2_ckpt291,10,m_sp_arch_4x1_bt_32_r201_cont3_m650,5_vs_5
4110,-4,0,f5v0to1to2t05_e2_ckpt291,4,explt_v0_7_2_m54,5_vs_5
4111,-4,0,f5v0to1to2t05_e2_ckpt291,4,explt_v0_7_2_m54,5_vs_5
4112,1,1,f5v0to1to2t05_e2_ckpt291,0,explt_v0_7_2_m54,5_vs_5
4113,-2,0,f5v0to1to2t05_e2_ckpt291,2,explt_v0_7_2_m54,5_vs_5
4114,-3,0,f5v0to1to2t05_e2_ckpt291,3,explt_v0_7_2_m54,5_vs_5
4115,0,1,f5v0to1to2t05_e2_ckpt291,1,explt_v0_7_2_m54,5_vs_5
4116,-2,0,f5v0to1to2t05_e2_ckpt291,2,explt_v0_7_2_m54,5_vs_5
4117,-3,0,f5v0to1to2t05_e2_ckpt291,3,explt_v0_7_2_m54,5_vs_5
4118,-1,1,f5v0to1to2t05_e2_ckpt291,2,explt_v0_7_2_m54,5_vs_5
4119,-1,1,f5v0to1to2t05_e2_ckpt291,2,explt_v0_7_2_m54,5_vs_5
4120,-15,0,f5v0to1to2t05_e2_ckpt291,15,m_sp_sc3v3_arch_2x1_32_r500_cont4x1_m224,5_vs_5
4121,-13,0,f5v0to1to2t05_e2_ckpt291,13,m_sp_sc3v3_arch_2x1_32_r500_cont4x1_m224,5_vs_5
4122,-8,1,f5v0to1to2t05_e2_ckpt291,9,m_sp_sc3v3_arch_2x1_32_r500_cont4x1_m224,5_vs_5
4123,-9,1,f5v0to1to2t05_e2_ckpt291,10,m_sp_sc3v3_arch_2x1_32_r500_cont4x1_m224,5_vs_5
4124,-8,1,f5v0to1to2t05_e2_ckpt291,9,m_sp_sc3v3_arch_2x1_32_r500_cont4x1_m224,5_vs_5
4125,-8,0,f5v0to1to2t05_e2_ckpt291,8,m_sp_sc3v3_arch_2x1_32_r500_cont4x1_m224,5_vs_5
4126,-9,0,f5v0to1to2t05_e2_ckpt291,9,m_sp_sc3v3_arch_2x1_32_r500_cont4x1_m224,5_vs_5
4127,-11,0,f5v0to1to2t05_e2_ckpt291,11,m_sp_sc3v3_arch_2x1_32_r500_cont4x1_m224,5_vs_5
4128,-13,1,f5v0to1to2t05_e2_ckpt291,14,m_sp_sc3v3_arch_2x1_32_r500_cont4x1_m224,5_vs_5
4129,-9,2,f5v0to1to2t05_e2_ckpt291,11,m_sp_sc3v3_arch_2x1_32_r500_cont4x1_m224,5_vs_5
4130,-8,0,f5v0to1to2t05_e2_ckpt291,8,m_sp_arch_4x1_bt_32_roles_r500_m335,5_vs_5
4131,-11,0,f5v0to1to2t05_e2_ckpt291,11,m_sp_arch_4x1_bt_32_roles_r500_m335,5_vs_5
4132,-16,0,f5v0to1to2t05_e2_ckpt291,16,m_sp_arch_4x1_bt_32_roles_r500_m335,5_vs_5
4133,-14,0,f5v0to1to2t05_e2_ckpt291,14,m_sp_arch_4x1_bt_32_roles_r500_m335,5_vs_5
4134,-13,1,f5v0to1to2t05_e2_ckpt291,14,m_sp_arch_4x1_bt_32_roles_r500_m335,5_vs_5
4135,-11,0,f5v0to1to2t05_e2_ckpt291,11,m_sp_arch_4x1_bt_32_roles_r500_m335,5_vs_5
4136,-15,0,f5v0to1to2t05_e2_ckpt291,15,m_sp_arch_4x1_bt_32_roles_r500_m335,5_vs_5
4137,-12,0,f5v0to1to2t05_e2_ckpt291,12,m_sp_arch_4x1_bt_32_roles_r500_m335,5_vs_5
4138,-13,1,f5v0to1to2t05_e2_ckpt291,14,m_sp_arch_4x1_bt_32_roles_r500_m335,5_vs_5
4139,-7,1,f5v0to1to2t05_e2_ckpt291,8,m_sp_arch_4x1_bt_32_roles_r500_m335,5_vs_5
4140,3,3,m_sp_sc3v3_arch_2x1_32_r500_cont4x1_m224,0,easy_bots,5_vs_5
4141,1,2,m_sp_sc3v3_arch_2x1_32_r500_cont4x1_m224,1,easy_bots,5_vs_5
4142,0,1,m_sp_sc3v3_arch_2x1_32_r500_cont4x1_m224,1,easy_bots,5_vs_5
4143,2,2,m_sp_sc3v3_arch_2x1_32_r500_cont4x1_m224,0,easy_bots,5_vs_5
4144,1,2,m_sp_sc3v3_arch_2x1_32_r500_cont4x1_m224,1,easy_bots,5_vs_5
4145,-1,1,m_sp_sc3v3_arch_2x1_32_r500_cont4x1_m224,2,easy_bots,5_vs_5
4146,1,1,m_sp_sc3v3_arch_2x1_32_r500_cont4x1_m224,0,easy_bots,5_vs_5
4147,0,1,m_sp_sc3v3_arch_2x1_32_r500_cont4x1_m224,1,easy_bots,5_vs_5
4148,2,2,m_sp_sc3v3_arch_2x1_32_r500_cont4x1_m224,0,easy_bots,5_vs_5
4149,2,3,m_sp_sc3v3_arch_2x1_32_r500_cont4x1_m224,1,easy_bots,5_vs_5
4150,1,1,m_sp_sc3v3_arch_2x1_32_r500_cont4x1_m224,0,easy_bots,5_vs_5
4151,-1,1,m_sp_sc3v3_arch_2x1_32_r500_cont4x1_m224,2,easy_bots,5_vs_5
4152,3,3,m_sp_sc3v3_arch_2x1_32_r500_cont4x1_m224,0,easy_bots,5_vs_5
4153,0,2,m_sp_sc3v3_arch_2x1_32_r500_cont4x1_m224,2,easy_bots,5_vs_5
4154,5,5,m_sp_sc3v3_arch_2x1_32_r500_cont4x1_m224,0,easy_bots,5_vs_5
4155,0,0,m_sp_sc3v3_arch_2x1_32_r500_cont4x1_m224,0,easy_bots,5_vs_5
4156,4,4,m_sp_sc3v3_arch_2x1_32_r500_cont4x1_m224,0,easy_bots,5_vs_5
4157,0,1,m_sp_sc3v3_arch_2x1_32_r500_cont4x1_m224,1,easy_bots,5_vs_5
4158,3,3,m_sp_sc3v3_arch_2x1_32_r500_cont4x1_m224,0,easy_bots,5_vs_5
4159,2,3,m_sp_sc3v3_arch_2x1_32_r500_cont4x1_m224,1,easy_bots,5_vs_5
4160,1,2,m_sp_sc3v3_arch_2x1_32_r500_cont4x1_m224,1,medium_bots,5_vs_5_medium
4161,0,0,m_sp_sc3v3_arch_2x1_32_r500_cont4x1_m224,0,medium_bots,5_vs_5_medium
4162,2,2,m_sp_sc3v3_arch_2x1_32_r500_cont4x1_m224,0,medium_bots,5_vs_5_medium
4163,2,3,m_sp_sc3v3_arch_2x1_32_r500_cont4x1_m224,1,medium_bots,5_vs_5_medium
4164,-1,1,m_sp_sc3v3_arch_2x1_32_r500_cont4x1_m224,2,medium_bots,5_vs_5_medium
4165,-1,1,m_sp_sc3v3_arch_2x1_32_r500_cont4x1_m224,2,medium_bots,5_vs_5_medium
4166,1,2,m_sp_sc3v3_arch_2x1_32_r500_cont4x1_m224,1,medium_bots,5_vs_5_medium
4167,-1,0,m_sp_sc3v3_arch_2x1_32_r500_cont4x1_m224,1,medium_bots,5_vs_5_medium
4168,1,2,m_sp_sc3v3_arch_2x1_32_r500_cont4x1_m224,1,medium_bots,5_vs_5_medium
4169,1,1,m_sp_sc3v3_arch_2x1_32_r500_cont4x1_m224,0,medium_bots,5_vs_5_medium
4170,0,0,m_sp_sc3v3_arch_2x1_32_r500_cont4x1_m224,0,medium_bots,5_vs_5_medium
4171,-1,0,m_sp_sc3v3_arch_2x1_32_r500_cont4x1_m224,1,medium_bots,5_vs_5_medium
4172,0,1,m_sp_sc3v3_arch_2x1_32_r500_cont4x1_m224,1,medium_bots,5_vs_5_medium
4173,-1,1,m_sp_sc3v3_arch_2x1_32_r500_cont4x1_m224,2,medium_bots,5_vs_5_medium
4174,-1,1,m_sp_sc3v3_arch_2x1_32_r500_cont4x1_m224,2,medium_bots,5_vs_5_medium
4175,-2,0,m_sp_sc3v3_arch_2x1_32_r500_cont4x1_m224,2,medium_bots,5_vs_5_medium
4176,0,1,m_sp_sc3v3_arch_2x1_32_r500_cont4x1_m224,1,medium_bots,5_vs_5_medium
4177,1,1,m_sp_sc3v3_arch_2x1_32_r500_cont4x1_m224,0,medium_bots,5_vs_5_medium
4178,0,0,m_sp_sc3v3_arch_2x1_32_r500_cont4x1_m224,0,medium_bots,5_vs_5_medium
4179,0,0,m_sp_sc3v3_arch_2x1_32_r500_cont4x1_m224,0,medium_bots,5_vs_5_medium
4180,-1,0,m_sp_sc3v3_arch_2x1_32_r500_cont4x1_m224,1,hard_bots,5_vs_5_hard
4181,-1,1,m_sp_sc3v3_arch_2x1_32_r500_cont4x1_m224,2,hard_bots,5_vs_5_hard
4182,-2,0,m_sp_sc3v3_arch_2x1_32_r500_cont4x1_m224,2,hard_bots,5_vs_5_hard
4183,-3,0,m_sp_sc3v3_arch_2x1_32_r500_cont4x1_m224,3,hard_bots,5_vs_5_hard
4184,0,0,m_sp_sc3v3_arch_2x1_32_r500_cont4x1_m224,0,hard_bots,5_vs_5_hard
4185,-1,0,m_sp_sc3v3_arch_2x1_32_r500_cont4x1_m224,1,hard_bots,5_vs_5_hard
4186,-1,1,m_sp_sc3v3_arch_2x1_32_r500_cont4x1_m224,2,hard_bots,5_vs_5_hard
4187,0,1,m_sp_sc3v3_arch_2x1_32_r500_cont4x1_m224,1,hard_bots,5_vs_5_hard
4188,-2,0,m_sp_sc3v3_arch_2x1_32_r500_cont4x1_m224,2,hard_bots,5_vs_5_hard
4189,-2,0,m_sp_sc3v3_arch_2x1_32_r500_cont4x1_m224,2,hard_bots,5_vs_5_hard
4190,-1,1,m_sp_sc3v3_arch_2x1_32_r500_cont4x1_m224,2,hard_bots,5_vs_5_hard
4191,-3,2,m_sp_sc3v3_arch_2x1_32_r500_cont4x1_m224,5,hard_bots,5_vs_5_hard
4192,1,1,m_sp_sc3v3_arch_2x1_32_r500_cont4x1_m224,0,hard_bots,5_vs_5_hard
4193,-1,1,m_sp_sc3v3_arch_2x1_32_r500_cont4x1_m224,2,hard_bots,5_vs_5_hard
4194,-2,0,m_sp_sc3v3_arch_2x1_32_r500_cont4x1_m224,2,hard_bots,5_vs_5_hard
4195,-1,0,m_sp_sc3v3_arch_2x1_32_r500_cont4x1_m224,1,hard_bots,5_vs_5_hard
4196,-1,0,m_sp_sc3v3_arch_2x1_32_r500_cont4x1_m224,1,hard_bots,5_vs_5_hard
4197,-1,0,m_sp_sc3v3_arch_2x1_32_r500_cont4x1_m224,1,hard_bots,5_vs_5_hard
4198,-1,0,m_sp_sc3v3_arch_2x1_32_r500_cont4x1_m224,1,hard_bots,5_vs_5_hard
4199,-3,0,m_sp_sc3v3_arch_2x1_32_r500_cont4x1_m224,3,hard_bots,5_vs_5_hard
4200,10,10,m_sp_sc3v3_arch_2x1_32_r500_cont4x1_m224,0,f5v0to1to2t05_e2_ckpt291,5_vs_5
4201,8,8,m_sp_sc3v3_arch_2x1_32_r500_cont4x1_m224,0,f5v0to1to2t05_e2_ckpt291,5_vs_5
4202,11,12,m_sp_sc3v3_arch_2x1_32_r500_cont4x1_m224,1,f5v0to1to2t05_e2_ckpt291,5_vs_5
4203,10,12,m_sp_sc3v3_arch_2x1_32_r500_cont4x1_m224,2,f5v0to1to2t05_e2_ckpt291,5_vs_5
4204,12,12,m_sp_sc3v3_arch_2x1_32_r500_cont4x1_m224,0,f5v0to1to2t05_e2_ckpt291,5_vs_5
4205,9,9,m_sp_sc3v3_arch_2x1_32_r500_cont4x1_m224,0,f5v0to1to2t05_e2_ckpt291,5_vs_5
4206,10,10,m_sp_sc3v3_arch_2x1_32_r500_cont4x1_m224,0,f5v0to1to2t05_e2_ckpt291,5_vs_5
4207,11,11,m_sp_sc3v3_arch_2x1_32_r500_cont4x1_m224,0,f5v0to1to2t05_e2_ckpt291,5_vs_5
4208,9,9,m_sp_sc3v3_arch_2x1_32_r500_cont4x1_m224,0,f5v0to1to2t05_e2_ckpt291,5_vs_5
4209,11,12,m_sp_sc3v3_arch_2x1_32_r500_cont4x1_m224,1,f5v0to1to2t05_e2_ckpt291,5_vs_5
4210,12,12,m_sp_sc3v3_arch_2x1_32_r500_cont4x1_m224,0,f5v0to1to5_e2_ckpt252,5_vs_5
4211,8,9,m_sp_sc3v3_arch_2x1_32_r500_cont4x1_m224,1,f5v0to1to5_e2_ckpt252,5_vs_5
4212,9,10,m_sp_sc3v3_arch_2x1_32_r500_cont4x1_m224,1,f5v0to1to5_e2_ckpt252,5_vs_5
4213,10,10,m_sp_sc3v3_arch_2x1_32_r500_cont4x1_m224,0,f5v0to1to5_e2_ckpt252,5_vs_5
4214,11,12,m_sp_sc3v3_arch_2x1_32_r500_cont4x1_m224,1,f5v0to1to5_e2_ckpt252,5_vs_5
4215,11,11,m_sp_sc3v3_arch_2x1_32_r500_cont4x1_m224,0,f5v0to1to5_e2_ckpt252,5_vs_5
4216,11,12,m_sp_sc3v3_arch_2x1_32_r500_cont4x1_m224,1,f5v0to1to5_e2_ckpt252,5_vs_5
4217,7,8,m_sp_sc3v3_arch_2x1_32_r500_cont4x1_m224,1,f5v0to1to5_e2_ckpt252,5_vs_5
4218,6,7,m_sp_sc3v3_arch_2x1_32_r500_cont4x1_m224,1,f5v0to1to5_e2_ckpt252,5_vs_5
4219,7,7,m_sp_sc3v3_arch_2x1_32_r500_cont4x1_m224,0,f5v0to1to5_e2_ckpt252,5_vs_5
4220,14,14,m_sp_sc3v3_arch_2x1_32_r500_cont4x1_m224,0,scon_e3_p2_hard_ckpt840,5_vs_5
4221,11,11,m_sp_sc3v3_arch_2x1_32_r500_cont4x1_m224,0,scon_e3_p2_hard_ckpt840,5_vs_5
4222,14,14,m_sp_sc3v3_arch_2x1_32_r500_cont4x1_m224,0,scon_e3_p2_hard_ckpt840,5_vs_5
4223,8,8,m_sp_sc3v3_arch_2x1_32_r500_cont4x1_m224,0,scon_e3_p2_hard_ckpt840,5_vs_5
4224,12,12,m_sp_sc3v3_arch_2x1_32_r500_cont4x1_m224,0,scon_e3_p2_hard_ckpt840,5_vs_5
4225,12,12,m_sp_sc3v3_arch_2x1_32_r500_cont4x1_m224,0,scon_e3_p2_hard_ckpt840,5_vs_5
4226,14,14,m_sp_sc3v3_arch_2x1_32_r500_cont4x1_m224,0,scon_e3_p2_hard_ckpt840,5_vs_5
4227,9,9,m_sp_sc3v3_arch_2x1_32_r500_cont4x1_m224,0,scon_e3_p2_hard_ckpt840,5_vs_5
4228,11,11,m_sp_sc3v3_arch_2x1_32_r500_cont4x1_m224,0,scon_e3_p2_hard_ckpt840,5_vs_5
4229,10,10,m_sp_sc3v3_arch_2x1_32_r500_cont4x1_m224,0,scon_e3_p2_hard_ckpt840,5_vs_5
4230,15,15,m_sp_sc3v3_arch_2x1_32_r500_cont4x1_m224,0,less_then_partially_randomized_checkpoints_bots_4_heads_38_ckpt108,5_vs_5
4231,11,11,m_sp_sc3v3_arch_2x1_32_r500_cont4x1_m224,0,less_then_partially_randomized_checkpoints_bots_4_heads_38_ckpt108,5_vs_5
4232,8,9,m_sp_sc3v3_arch_2x1_32_r500_cont4x1_m224,1,less_then_partially_randomized_checkpoints_bots_4_heads_38_ckpt108,5_vs_5
4233,11,12,m_sp_sc3v3_arch_2x1_32_r500_cont4x1_m224,1,less_then_partially_randomized_checkpoints_bots_4_heads_38_ckpt108,5_vs_5
4234,13,13,m_sp_sc3v3_arch_2x1_32_r500_cont4x1_m224,0,less_then_partially_randomized_checkpoints_bots_4_heads_38_ckpt108,5_vs_5
4235,10,10,m_sp_sc3v3_arch_2x1_32_r500_cont4x1_m224,0,less_then_partially_randomized_checkpoints_bots_4_heads_38_ckpt108,5_vs_5
4236,10,10,m_sp_sc3v3_arch_2x1_32_r500_cont4x1_m224,0,less_then_partially_randomized_checkpoints_bots_4_heads_38_ckpt108,5_vs_5
4237,11,11,m_sp_sc3v3_arch_2x1_32_r500_cont4x1_m224,0,less_then_partially_randomized_checkpoints_bots_4_heads_38_ckpt108,5_vs_5
4238,10,12,m_sp_sc3v3_arch_2x1_32_r500_cont4x1_m224,2,less_then_partially_randomized_checkpoints_bots_4_heads_38_ckpt108,5_vs_5
4239,14,14,m_sp_sc3v3_arch_2x1_32_r500_cont4x1_m224,0,less_then_partially_randomized_checkpoints_bots_4_heads_38_ckpt108,5_vs_5
4240,15,15,m_sp_sc3v3_arch_2x1_32_r500_cont4x1_m224,0,less_then_partially_randomized_entropy_checkpoints_bots_4_heads_39_ckpt109,5_vs_5
4241,13,13,m_sp_sc3v3_arch_2x1_32_r500_cont4x1_m224,0,less_then_partially_randomized_entropy_checkpoints_bots_4_heads_39_ckpt109,5_vs_5
4242,10,10,m_sp_sc3v3_arch_2x1_32_r500_cont4x1_m224,0,less_then_partially_randomized_entropy_checkpoints_bots_4_heads_39_ckpt109,5_vs_5
4243,17,17,m_sp_sc3v3_arch_2x1_32_r500_cont4x1_m224,0,less_then_partially_randomized_entropy_checkpoints_bots_4_heads_39_ckpt109,5_vs_5
4244,13,13,m_sp_sc3v3_arch_2x1_32_r500_cont4x1_m224,0,less_then_partially_randomized_entropy_checkpoints_bots_4_heads_39_ckpt109,5_vs_5
4245,13,13,m_sp_sc3v3_arch_2x1_32_r500_cont4x1_m224,0,less_then_partially_randomized_entropy_checkpoints_bots_4_heads_39_ckpt109,5_vs_5
4246,11,12,m_sp_sc3v3_arch_2x1_32_r500_cont4x1_m224,1,less_then_partially_randomized_entropy_checkpoints_bots_4_heads_39_ckpt109,5_vs_5
4247,10,10,m_sp_sc3v3_arch_2x1_32_r500_cont4x1_m224,0,less_then_partially_randomized_entropy_checkpoints_bots_4_heads_39_ckpt109,5_vs_5
4248,16,16,m_sp_sc3v3_arch_2x1_32_r500_cont4x1_m224,0,less_then_partially_randomized_entropy_checkpoints_bots_4_heads_39_ckpt109,5_vs_5
4249,14,14,m_sp_sc3v3_arch_2x1_32_r500_cont4x1_m224,0,less_then_partially_randomized_entropy_checkpoints_bots_4_heads_39_ckpt109,5_vs_5
4250,12,12,m_sp_sc3v3_arch_2x1_32_r500_cont4x1_m224,0,reward_shaping_checkpoints_bots_4_heads_1_ckpt360,5_vs_5
4251,9,9,m_sp_sc3v3_arch_2x1_32_r500_cont4x1_m224,0,reward_shaping_checkpoints_bots_4_heads_1_ckpt360,5_vs_5
4252,11,11,m_sp_sc3v3_arch_2x1_32_r500_cont4x1_m224,0,reward_shaping_checkpoints_bots_4_heads_1_ckpt360,5_vs_5
4253,5,5,m_sp_sc3v3_arch_2x1_32_r500_cont4x1_m224,0,reward_shaping_checkpoints_bots_4_heads_1_ckpt360,5_vs_5
4254,6,6,m_sp_sc3v3_arch_2x1_32_r500_cont4x1_m224,0,reward_shaping_checkpoints_bots_4_heads_1_ckpt360,5_vs_5
4255,9,10,m_sp_sc3v3_arch_2x1_32_r500_cont4x1_m224,1,reward_shaping_checkpoints_bots_4_heads_1_ckpt360,5_vs_5
4256,10,10,m_sp_sc3v3_arch_2x1_32_r500_cont4x1_m224,0,reward_shaping_checkpoints_bots_4_heads_1_ckpt360,5_vs_5
4257,12,12,m_sp_sc3v3_arch_2x1_32_r500_cont4x1_m224,0,reward_shaping_checkpoints_bots_4_heads_1_ckpt360,5_vs_5
4258,10,10,m_sp_sc3v3_arch_2x1_32_r500_cont4x1_m224,0,reward_shaping_checkpoints_bots_4_heads_1_ckpt360,5_vs_5
4259,7,7,m_sp_sc3v3_arch_2x1_32_r500_cont4x1_m224,0,reward_shaping_checkpoints_bots_4_heads_1_ckpt360,5_vs_5
4260,7,7,m_sp_sc3v3_arch_2x1_32_r500_cont4x1_m224,0,checkpoints_selfplay_e9_sp_ckpt274,5_vs_5
4261,6,7,m_sp_sc3v3_arch_2x1_32_r500_cont4x1_m224,1,checkpoints_selfplay_e9_sp_ckpt274,5_vs_5
4262,3,3,m_sp_sc3v3_arch_2x1_32_r500_cont4x1_m224,0,checkpoints_selfplay_e9_sp_ckpt274,5_vs_5
4263,2,5,m_sp_sc3v3_arch_2x1_32_r500_cont4x1_m224,3,checkpoints_selfplay_e9_sp_ckpt274,5_vs_5
4264,9,9,m_sp_sc3v3_arch_2x1_32_r500_cont4x1_m224,0,checkpoints_selfplay_e9_sp_ckpt274,5_vs_5
4265,5,7,m_sp_sc3v3_arch_2x1_32_r500_cont4x1_m224,2,checkpoints_selfplay_e9_sp_ckpt274,5_vs_5
4266,6,7,m_sp_sc3v3_arch_2x1_32_r500_cont4x1_m224,1,checkpoints_selfplay_e9_sp_ckpt274,5_vs_5
4267,0,5,m_sp_sc3v3_arch_2x1_32_r500_cont4x1_m224,5,checkpoints_selfplay_e9_sp_ckpt274,5_vs_5
4268,7,9,m_sp_sc3v3_arch_2x1_32_r500_cont4x1_m224,2,checkpoints_selfplay_e9_sp_ckpt274,5_vs_5
4269,8,9,m_sp_sc3v3_arch_2x1_32_r500_cont4x1_m224,1,checkpoints_selfplay_e9_sp_ckpt274,5_vs_5
4270,-6,0,m_sp_sc3v3_arch_2x1_32_r500_cont4x1_m224,6,checkpoints_sp_c_nb_e2_ckpt667,5_vs_5
4271,2,5,m_sp_sc3v3_arch_2x1_32_r500_cont4x1_m224,3,checkpoints_sp_c_nb_e2_ckpt667,5_vs_5
4272,2,3,m_sp_sc3v3_arch_2x1_32_r500_cont4x1_m224,1,checkpoints_sp_c_nb_e2_ckpt667,5_vs_5
4273,3,6,m_sp_sc3v3_arch_2x1_32_r500_cont4x1_m224,3,checkpoints_sp_c_nb_e2_ckpt667,5_vs_5
4274,1,4,m_sp_sc3v3_arch_2x1_32_r500_cont4x1_m224,3,checkpoints_sp_c_nb_e2_ckpt667,5_vs_5
4275,-6,1,m_sp_sc3v3_arch_2x1_32_r500_cont4x1_m224,7,checkpoints_sp_c_nb_e2_ckpt667,5_vs_5
4276,1,4,m_sp_sc3v3_arch_2x1_32_r500_cont4x1_m224,3,checkpoints_sp_c_nb_e2_ckpt667,5_vs_5
4277,-2,2,m_sp_sc3v3_arch_2x1_32_r500_cont4x1_m224,4,checkpoints_sp_c_nb_e2_ckpt667,5_vs_5
4278,3,5,m_sp_sc3v3_arch_2x1_32_r500_cont4x1_m224,2,checkpoints_sp_c_nb_e2_ckpt667,5_vs_5
4279,2,5,m_sp_sc3v3_arch_2x1_32_r500_cont4x1_m224,3,checkpoints_sp_c_nb_e2_ckpt667,5_vs_5
4280,0,0,m_sp_sc3v3_arch_2x1_32_r500_cont4x1_m224,0,scenario_curriculum_ckpt830,5_vs_5
4281,12,12,m_sp_sc3v3_arch_2x1_32_r500_cont4x1_m224,0,scenario_curriculum_ckpt830,5_vs_5
4282,10,10,m_sp_sc3v3_arch_2x1_32_r500_cont4x1_m224,0,scenario_curriculum_ckpt830,5_vs_5
4283,20,20,m_sp_sc3v3_arch_2x1_32_r500_cont4x1_m224,0,scenario_curriculum_ckpt830,5_vs_5
4284,15,15,m_sp_sc3v3_arch_2x1_32_r500_cont4x1_m224,0,scenario_curriculum_ckpt830,5_vs_5
4285,13,13,m_sp_sc3v3_arch_2x1_32_r500_cont4x1_m224,0,scenario_curriculum_ckpt830,5_vs_5
4286,14,14,m_sp_sc3v3_arch_2x1_32_r500_cont4x1_m224,0,scenario_curriculum_ckpt830,5_vs_5
4287,2,2,m_sp_sc3v3_arch_2x1_32_r500_cont4x1_m224,0,scenario_curriculum_ckpt830,5_vs_5
4288,1,1,m_sp_sc3v3_arch_2x1_32_r500_cont4x1_m224,0,scenario_curriculum_ckpt830,5_vs_5
4289,2,2,m_sp_sc3v3_arch_2x1_32_r500_cont4x1_m224,0,scenario_curriculum_ckpt830,5_vs_5
4290,0,1,m_sp_sc3v3_arch_2x1_32_r500_cont4x1_m224,1,m_sp_arch_medium_heads_conv16_0_bt_32_r313_m335,5_vs_5
4291,7,7,m_sp_sc3v3_arch_2x1_32_r500_cont4x1_m224,0,m_sp_arch_medium_heads_conv16_0_bt_32_r313_m335,5_vs_5
4292,7,7,m_sp_sc3v3_arch_2x1_32_r500_cont4x1_m224,0,m_sp_arch_medium_heads_conv16_0_bt_32_r313_m335,5_vs_5
4293,2,4,m_sp_sc3v3_arch_2x1_32_r500_cont4x1_m224,2,m_sp_arch_medium_heads_conv16_0_bt_32_r313_m335,5_vs_5
4294,4,5,m_sp_sc3v3_arch_2x1_32_r500_cont4x1_m224,1,m_sp_arch_medium_heads_conv16_0_bt_32_r313_m335,5_vs_5
4295,0,3,m_sp_sc3v3_arch_2x1_32_r500_cont4x1_m224,3,m_sp_arch_medium_heads_conv16_0_bt_32_r313_m335,5_vs_5
4296,6,6,m_sp_sc3v3_arch_2x1_32_r500_cont4x1_m224,0,m_sp_arch_medium_heads_conv16_0_bt_32_r313_m335,5_vs_5
4297,1,5,m_sp_sc3v3_arch_2x1_32_r500_cont4x1_m224,4,m_sp_arch_medium_heads_conv16_0_bt_32_r313_m335,5_vs_5
4298,8,8,m_sp_sc3v3_arch_2x1_32_r500_cont4x1_m224,0,m_sp_arch_medium_heads_conv16_0_bt_32_r313_m335,5_vs_5
4299,1,2,m_sp_sc3v3_arch_2x1_32_r500_cont4x1_m224,1,m_sp_arch_medium_heads_conv16_0_bt_32_r313_m335,5_vs_5
4300,5,6,m_sp_sc3v3_arch_2x1_32_r500_cont4x1_m224,1,m_sp_arch_longer_heads_bt_32_r201_m335,5_vs_5
4301,8,8,m_sp_sc3v3_arch_2x1_32_r500_cont4x1_m224,0,m_sp_arch_longer_heads_bt_32_r201_m335,5_vs_5
4302,3,5,m_sp_sc3v3_arch_2x1_32_r500_cont4x1_m224,2,m_sp_arch_longer_heads_bt_32_r201_m335,5_vs_5
4303,1,4,m_sp_sc3v3_arch_2x1_32_r500_cont4x1_m224,3,m_sp_arch_longer_heads_bt_32_r201_m335,5_vs_5
4304,5,7,m_sp_sc3v3_arch_2x1_32_r500_cont4x1_m224,2,m_sp_arch_longer_heads_bt_32_r201_m335,5_vs_5
4305,4,4,m_sp_sc3v3_arch_2x1_32_r500_cont4x1_m224,0,m_sp_arch_longer_heads_bt_32_r201_m335,5_vs_5
4306,4,5,m_sp_sc3v3_arch_2x1_32_r500_cont4x1_m224,1,m_sp_arch_longer_heads_bt_32_r201_m335,5_vs_5
4307,3,4,m_sp_sc3v3_arch_2x1_32_r500_cont4x1_m224,1,m_sp_arch_longer_heads_bt_32_r201_m335,5_vs_5
4308,3,5,m_sp_sc3v3_arch_2x1_32_r500_cont4x1_m224,2,m_sp_arch_longer_heads_bt_32_r201_m335,5_vs_5
4309,4,5,m_sp_sc3v3_arch_2x1_32_r500_cont4x1_m224,1,m_sp_arch_longer_heads_bt_32_r201_m335,5_vs_5
4310,6,8,m_sp_sc3v3_arch_2x1_32_r500_cont4x1_m224,2,m_sp_arch_medium_heads_bt_32_r201_m335,5_vs_5
4311,6,7,m_sp_sc3v3_arch_2x1_32_r500_cont4x1_m224,1,m_sp_arch_medium_heads_bt_32_r201_m335,5_vs_5
4312,6,6,m_sp_sc3v3_arch_2x1_32_r500_cont4x1_m224,0,m_sp_arch_medium_heads_bt_32_r201_m335,5_vs_5
4313,5,6,m_sp_sc3v3_arch_2x1_32_r500_cont4x1_m224,1,m_sp_arch_medium_heads_bt_32_r201_m335,5_vs_5
4314,5,6,m_sp_sc3v3_arch_2x1_32_r500_cont4x1_m224,1,m_sp_arch_medium_heads_bt_32_r201_m335,5_vs_5
4315,5,5,m_sp_sc3v3_arch_2x1_32_r500_cont4x1_m224,0,m_sp_arch_medium_heads_bt_32_r201_m335,5_vs_5
4316,5,5,m_sp_sc3v3_arch_2x1_32_r500_cont4x1_m224,0,m_sp_arch_medium_heads_bt_32_r201_m335,5_vs_5
4317,5,5,m_sp_sc3v3_arch_2x1_32_r500_cont4x1_m224,0,m_sp_arch_medium_heads_bt_32_r201_m335,5_vs_5
4318,7,7,m_sp_sc3v3_arch_2x1_32_r500_cont4x1_m224,0,m_sp_arch_medium_heads_bt_32_r201_m335,5_vs_5
4319,0,5,m_sp_sc3v3_arch_2x1_32_r500_cont4x1_m224,5,m_sp_arch_medium_heads_bt_32_r201_m335,5_vs_5
4320,0,3,m_sp_sc3v3_arch_2x1_32_r500_cont4x1_m224,3,m_sp_arch_4x1_bt_32_r201_m335,5_vs_5
4321,-2,4,m_sp_sc3v3_arch_2x1_32_r500_cont4x1_m224,6,m_sp_arch_4x1_bt_32_r201_m335,5_vs_5
4322,0,5,m_sp_sc3v3_arch_2x1_32_r500_cont4x1_m224,5,m_sp_arch_4x1_bt_32_r201_m335,5_vs_5
4323,-1,3,m_sp_sc3v3_arch_2x1_32_r500_cont4x1_m224,4,m_sp_arch_4x1_bt_32_r201_m335,5_vs_5
4324,-7,0,m_sp_sc3v3_arch_2x1_32_r500_cont4x1_m224,7,m_sp_arch_4x1_bt_32_r201_m335,5_vs_5
4325,-6,2,m_sp_sc3v3_arch_2x1_32_r500_cont4x1_m224,8,m_sp_arch_4x1_bt_32_r201_m335,5_vs_5
4326,2,3,m_sp_sc3v3_arch_2x1_32_r500_cont4x1_m224,1,m_sp_arch_4x1_bt_32_r201_m335,5_vs_5
4327,-3,2,m_sp_sc3v3_arch_2x1_32_r500_cont4x1_m224,5,m_sp_arch_4x1_bt_32_r201_m335,5_vs_5
4328,-5,0,m_sp_sc3v3_arch_2x1_32_r500_cont4x1_m224,5,m_sp_arch_4x1_bt_32_r201_m335,5_vs_5
4329,-5,1,m_sp_sc3v3_arch_2x1_32_r500_cont4x1_m224,6,m_sp_arch_4x1_bt_32_r201_m335,5_vs_5
4330,-3,1,m_sp_sc3v3_arch_2x1_32_r500_cont4x1_m224,4,m_sp_arch_4x1_bt_32_r201_cont3_m650,5_vs_5
4331,1,4,m_sp_sc3v3_arch_2x1_32_r500_cont4x1_m224,3,m_sp_arch_4x1_bt_32_r201_cont3_m650,5_vs_5
4332,-2,1,m_sp_sc3v3_arch_2x1_32_r500_cont4x1_m224,3,m_sp_arch_4x1_bt_32_r201_cont3_m650,5_vs_5
4333,-3,0,m_sp_sc3v3_arch_2x1_32_r500_cont4x1_m224,3,m_sp_arch_4x1_bt_32_r201_cont3_m650,5_vs_5
4334,-4,0,m_sp_sc3v3_arch_2x1_32_r500_cont4x1_m224,4,m_sp_arch_4x1_bt_32_r201_cont3_m650,5_vs_5
4335,-7,1,m_sp_sc3v3_arch_2x1_32_r500_cont4x1_m224,8,m_sp_arch_4x1_bt_32_r201_cont3_m650,5_vs_5
4336,-5,1,m_sp_sc3v3_arch_2x1_32_r500_cont4x1_m224,6,m_sp_arch_4x1_bt_32_r201_cont3_m650,5_vs_5
4337,1,3,m_sp_sc3v3_arch_2x1_32_r500_cont4x1_m224,2,m_sp_arch_4x1_bt_32_r201_cont3_m650,5_vs_5
4338,-3,1,m_sp_sc3v3_arch_2x1_32_r500_cont4x1_m224,4,m_sp_arch_4x1_bt_32_r201_cont3_m650,5_vs_5
4339,-5,0,m_sp_sc3v3_arch_2x1_32_r500_cont4x1_m224,5,m_sp_arch_4x1_bt_32_r201_cont3_m650,5_vs_5
4340,0,2,m_sp_sc3v3_arch_2x1_32_r500_cont4x1_m224,2,explt_v0_7_2_m54,5_vs_5
4341,-3,1,m_sp_sc3v3_arch_2x1_32_r500_cont4x1_m224,4,explt_v0_7_2_m54,5_vs_5
4342,-2,0,m_sp_sc3v3_arch_2x1_32_r500_cont4x1_m224,2,explt_v0_7_2_m54,5_vs_5
4343,-1,0,m_sp_sc3v3_arch_2x1_32_r500_cont4x1_m224,1,explt_v0_7_2_m54,5_vs_5
4344,2,3,m_sp_sc3v3_arch_2x1_32_r500_cont4x1_m224,1,explt_v0_7_2_m54,5_vs_5
4345,-1,2,m_sp_sc3v3_arch_2x1_32_r500_cont4x1_m224,3,explt_v0_7_2_m54,5_vs_5
4346,3,4,m_sp_sc3v3_arch_2x1_32_r500_cont4x1_m224,1,explt_v0_7_2_m54,5_vs_5
4347,-4,0,m_sp_sc3v3_arch_2x1_32_r500_cont4x1_m224,4,explt_v0_7_2_m54,5_vs_5
4348,-3,0,m_sp_sc3v3_arch_2x1_32_r500_cont4x1_m224,3,explt_v0_7_2_m54,5_vs_5
4349,2,2,m_sp_sc3v3_arch_2x1_32_r500_cont4x1_m224,0,explt_v0_7_2_m54,5_vs_5
4350,1,2,m_sp_sc3v3_arch_2x1_32_r500_cont4x1_m224,1,m_sp_sc3v3_arch_2x1_32_r500_cont4x1_m224,5_vs_5
4351,2,2,m_sp_sc3v3_arch_2x1_32_r500_cont4x1_m224,0,m_sp_sc3v3_arch_2x1_32_r500_cont4x1_m224,5_vs_5
4352,0,1,m_sp_sc3v3_arch_2x1_32_r500_cont4x1_m224,1,m_sp_sc3v3_arch_2x1_32_r500_cont4x1_m224,5_vs_5
4353,1,1,m_sp_sc3v3_arch_2x1_32_r500_cont4x1_m224,0,m_sp_sc3v3_arch_2x1_32_r500_cont4x1_m224,5_vs_5
4354,-3,0,m_sp_sc3v3_arch_2x1_32_r500_cont4x1_m224,3,m_sp_sc3v3_arch_2x1_32_r500_cont4x1_m224,5_vs_5
4355,0,1,m_sp_sc3v3_arch_2x1_32_r500_cont4x1_m224,1,m_sp_sc3v3_arch_2x1_32_r500_cont4x1_m224,5_vs_5
4356,0,1,m_sp_sc3v3_arch_2x1_32_r500_cont4x1_m224,1,m_sp_sc3v3_arch_2x1_32_r500_cont4x1_m224,5_vs_5
4357,-1,2,m_sp_sc3v3_arch_2x1_32_r500_cont4x1_m224,3,m_sp_sc3v3_arch_2x1_32_r500_cont4x1_m224,5_vs_5
4358,2,2,m_sp_sc3v3_arch_2x1_32_r500_cont4x1_m224,0,m_sp_sc3v3_arch_2x1_32_r500_cont4x1_m224,5_vs_5
4359,-1,0,m_sp_sc3v3_arch_2x1_32_r500_cont4x1_m224,1,m_sp_sc3v3_arch_2x1_32_r500_cont4x1_m224,5_vs_5
4360,0,3,m_sp_sc3v3_arch_2x1_32_r500_cont4x1_m224,3,m_sp_arch_4x1_bt_32_roles_r500_m335,5_vs_5
4361,-4,2,m_sp_sc3v3_arch_2x1_32_r500_cont4x1_m224,6,m_sp_arch_4x1_bt_32_roles_r500_m335,5_vs_5
4362,0,1,m_sp_sc3v3_arch_2x1_32_r500_cont4x1_m224,1,m_sp_arch_4x1_bt_32_roles_r500_m335,5_vs_5
4363,-1,4,m_sp_sc3v3_arch_2x1_32_r500_cont4x1_m224,5,m_sp_arch_4x1_bt_32_roles_r500_m335,5_vs_5
4364,-5,1,m_sp_sc3v3_arch_2x1_32_r500_cont4x1_m224,6,m_sp_arch_4x1_bt_32_roles_r500_m335,5_vs_5
4365,-2,0,m_sp_sc3v3_arch_2x1_32_r500_cont4x1_m224,2,m_sp_arch_4x1_bt_32_roles_r500_m335,5_vs_5
4366,0,2,m_sp_sc3v3_arch_2x1_32_r500_cont4x1_m224,2,m_sp_arch_4x1_bt_32_roles_r500_m335,5_vs_5
4367,-6,2,m_sp_sc3v3_arch_2x1_32_r500_cont4x1_m224,8,m_sp_arch_4x1_bt_32_roles_r500_m335,5_vs_5
4368,1,2,m_sp_sc3v3_arch_2x1_32_r500_cont4x1_m224,1,m_sp_arch_4x1_bt_32_roles_r500_m335,5_vs_5
4369,-5,1,m_sp_sc3v3_arch_2x1_32_r500_cont4x1_m224,6,m_sp_arch_4x1_bt_32_roles_r500_m335,5_vs_5
4370,11,11,reward_shaping_checkpoints_bots_4_heads_1_ckpt360,0,easy_bots,5_vs_5
4371,7,8,reward_shaping_checkpoints_bots_4_heads_1_ckpt360,1,easy_bots,5_vs_5
4372,9,10,reward_shaping_checkpoints_bots_4_heads_1_ckpt360,1,easy_bots,5_vs_5
4373,8,8,reward_shaping_checkpoints_bots_4_heads_1_ckpt360,0,easy_bots,5_vs_5
4374,9,10,reward_shaping_checkpoints_bots_4_heads_1_ckpt360,1,easy_bots,5_vs_5
4375,12,12,reward_shaping_checkpoints_bots_4_heads_1_ckpt360,0,easy_bots,5_vs_5
4376,7,8,reward_shaping_checkpoints_bots_4_heads_1_ckpt360,1,easy_bots,5_vs_5
4377,4,6,reward_shaping_checkpoints_bots_4_heads_1_ckpt360,2,easy_bots,5_vs_5
4378,11,12,reward_shaping_checkpoints_bots_4_heads_1_ckpt360,1,easy_bots,5_vs_5
4379,3,6,reward_shaping_checkpoints_bots_4_heads_1_ckpt360,3,easy_bots,5_vs_5
4380,15,15,reward_shaping_checkpoints_bots_4_heads_1_ckpt360,0,easy_bots,5_vs_5
4381,3,5,reward_shaping_checkpoints_bots_4_heads_1_ckpt360,2,easy_bots,5_vs_5
4382,9,10,reward_shaping_checkpoints_bots_4_heads_1_ckpt360,1,easy_bots,5_vs_5
4383,10,10,reward_shaping_checkpoints_bots_4_heads_1_ckpt360,0,easy_bots,5_vs_5
4384,1,2,reward_shaping_checkpoints_bots_4_heads_1_ckpt360,1,easy_bots,5_vs_5
4385,9,11,reward_shaping_checkpoints_bots_4_heads_1_ckpt360,2,easy_bots,5_vs_5
4386,7,7,reward_shaping_checkpoints_bots_4_heads_1_ckpt360,0,easy_bots,5_vs_5
4387,6,6,reward_shaping_checkpoints_bots_4_heads_1_ckpt360,0,easy_bots,5_vs_5
4388,7,9,reward_shaping_checkpoints_bots_4_heads_1_ckpt360,2,easy_bots,5_vs_5
4389,12,12,reward_shaping_checkpoints_bots_4_heads_1_ckpt360,0,easy_bots,5_vs_5
4390,5,6,reward_shaping_checkpoints_bots_4_heads_1_ckpt360,1,medium_bots,5_vs_5_medium
4391,11,13,reward_shaping_checkpoints_bots_4_heads_1_ckpt360,2,medium_bots,5_vs_5_medium
4392,6,6,reward_shaping_checkpoints_bots_4_heads_1_ckpt360,0,medium_bots,5_vs_5_medium
4393,4,4,reward_shaping_checkpoints_bots_4_heads_1_ckpt360,0,medium_bots,5_vs_5_medium
4394,5,7,reward_shaping_checkpoints_bots_4_heads_1_ckpt360,2,medium_bots,5_vs_5_medium
4395,2,3,reward_shaping_checkpoints_bots_4_heads_1_ckpt360,1,medium_bots,5_vs_5_medium
4396,3,5,reward_shaping_checkpoints_bots_4_heads_1_ckpt360,2,medium_bots,5_vs_5_medium
4397,6,6,reward_shaping_checkpoints_bots_4_heads_1_ckpt360,0,medium_bots,5_vs_5_medium
4398,4,5,reward_shaping_checkpoints_bots_4_heads_1_ckpt360,1,medium_bots,5_vs_5_medium
4399,4,6,reward_shaping_checkpoints_bots_4_heads_1_ckpt360,2,medium_bots,5_vs_5_medium
4400,10,11,reward_shaping_checkpoints_bots_4_heads_1_ckpt360,1,medium_bots,5_vs_5_medium
4401,8,10,reward_shaping_checkpoints_bots_4_heads_1_ckpt360,2,medium_bots,5_vs_5_medium
4402,5,7,reward_shaping_checkpoints_bots_4_heads_1_ckpt360,2,medium_bots,5_vs_5_medium
4403,5,6,reward_shaping_checkpoints_bots_4_heads_1_ckpt360,1,medium_bots,5_vs_5_medium
4404,9,9,reward_shaping_checkpoints_bots_4_heads_1_ckpt360,0,medium_bots,5_vs_5_medium
4405,3,6,reward_shaping_checkpoints_bots_4_heads_1_ckpt360,3,medium_bots,5_vs_5_medium
4406,3,5,reward_shaping_checkpoints_bots_4_heads_1_ckpt360,2,medium_bots,5_vs_5_medium
4407,5,5,reward_shaping_checkpoints_bots_4_heads_1_ckpt360,0,medium_bots,5_vs_5_medium
4408,7,9,reward_shaping_checkpoints_bots_4_heads_1_ckpt360,2,medium_bots,5_vs_5_medium
4409,1,4,reward_shaping_checkpoints_bots_4_heads_1_ckpt360,3,medium_bots,5_vs_5_medium
4410,3,5,reward_shaping_checkpoints_bots_4_heads_1_ckpt360,2,hard_bots,5_vs_5_hard
4411,1,3,reward_shaping_checkpoints_bots_4_heads_1_ckpt360,2,hard_bots,5_vs_5_hard
4412,1,3,reward_shaping_checkpoints_bots_4_heads_1_ckpt360,2,hard_bots,5_vs_5_hard
4413,4,6,reward_shaping_checkpoints_bots_4_heads_1_ckpt360,2,hard_bots,5_vs_5_hard
4414,5,6,reward_shaping_checkpoints_bots_4_heads_1_ckpt360,1,hard_bots,5_vs_5_hard
4415,3,6,reward_shaping_checkpoints_bots_4_heads_1_ckpt360,3,hard_bots,5_vs_5_hard
4416,4,5,reward_shaping_checkpoints_bots_4_heads_1_ckpt360,1,hard_bots,5_vs_5_hard
4417,2,5,reward_shaping_checkpoints_bots_4_heads_1_ckpt360,3,hard_bots,5_vs_5_hard
4418,0,1,reward_shaping_checkpoints_bots_4_heads_1_ckpt360,1,hard_bots,5_vs_5_hard
4419,0,6,reward_shaping_checkpoints_bots_4_heads_1_ckpt360,6,hard_bots,5_vs_5_hard
4420,4,5,reward_shaping_checkpoints_bots_4_heads_1_ckpt360,1,hard_bots,5_vs_5_hard
4421,1,2,reward_shaping_checkpoints_bots_4_heads_1_ckpt360,1,hard_bots,5_vs_5_hard
4422,2,4,reward_shaping_checkpoints_bots_4_heads_1_ckpt360,2,hard_bots,5_vs_5_hard
4423,3,6,reward_shaping_checkpoints_bots_4_heads_1_ckpt360,3,hard_bots,5_vs_5_hard
4424,5,7,reward_shaping_checkpoints_bots_4_heads_1_ckpt360,2,hard_bots,5_vs_5_hard
4425,1,3,reward_shaping_checkpoints_bots_4_heads_1_ckpt360,2,hard_bots,5_vs_5_hard
4426,1,5,reward_shaping_checkpoints_bots_4_heads_1_ckpt360,4,hard_bots,5_vs_5_hard
4427,2,3,reward_shaping_checkpoints_bots_4_heads_1_ckpt360,1,hard_bots,5_vs_5_hard
4428,6,8,reward_shaping_checkpoints_bots_4_heads_1_ckpt360,2,hard_bots,5_vs_5_hard
4429,3,6,reward_shaping_checkpoints_bots_4_heads_1_ckpt360,3,hard_bots,5_vs_5_hard
4430,-6,3,reward_shaping_checkpoints_bots_4_heads_1_ckpt360,9,f5v0to1to2t05_e2_ckpt291,5_vs_5
4431,-8,0,reward_shaping_checkpoints_bots_4_heads_1_ckpt360,8,f5v0to1to2t05_e2_ckpt291,5_vs_5
4432,-4,0,reward_shaping_checkpoints_bots_4_heads_1_ckpt360,4,f5v0to1to2t05_e2_ckpt291,5_vs_5
4433,-1,2,reward_shaping_checkpoints_bots_4_heads_1_ckpt360,3,f5v0to1to2t05_e2_ckpt291,5_vs_5
4434,0,3,reward_shaping_checkpoints_bots_4_heads_1_ckpt360,3,f5v0to1to2t05_e2_ckpt291,5_vs_5
4435,-5,2,reward_shaping_checkpoints_bots_4_heads_1_ckpt360,7,f5v0to1to2t05_e2_ckpt291,5_vs_5
4436,-5,1,reward_shaping_checkpoints_bots_4_heads_1_ckpt360,6,f5v0to1to2t05_e2_ckpt291,5_vs_5
4437,-2,5,reward_shaping_checkpoints_bots_4_heads_1_ckpt360,7,f5v0to1to2t05_e2_ckpt291,5_vs_5
4438,1,4,reward_shaping_checkpoints_bots_4_heads_1_ckpt360,3,f5v0to1to2t05_e2_ckpt291,5_vs_5
4439,-4,1,reward_shaping_checkpoints_bots_4_heads_1_ckpt360,5,f5v0to1to2t05_e2_ckpt291,5_vs_5
4440,-4,2,reward_shaping_checkpoints_bots_4_heads_1_ckpt360,6,f5v0to1to5_e2_ckpt252,5_vs_5
4441,-4,0,reward_shaping_checkpoints_bots_4_heads_1_ckpt360,4,f5v0to1to5_e2_ckpt252,5_vs_5
4442,1,5,reward_shaping_checkpoints_bots_4_heads_1_ckpt360,4,f5v0to1to5_e2_ckpt252,5_vs_5
4443,1,4,reward_shaping_checkpoints_bots_4_heads_1_ckpt360,3,f5v0to1to5_e2_ckpt252,5_vs_5
4444,-2,3,reward_shaping_checkpoints_bots_4_heads_1_ckpt360,5,f5v0to1to5_e2_ckpt252,5_vs_5
4445,-1,3,reward_shaping_checkpoints_bots_4_heads_1_ckpt360,4,f5v0to1to5_e2_ckpt252,5_vs_5
4446,-2,2,reward_shaping_checkpoints_bots_4_heads_1_ckpt360,4,f5v0to1to5_e2_ckpt252,5_vs_5
4447,-5,0,reward_shaping_checkpoints_bots_4_heads_1_ckpt360,5,f5v0to1to5_e2_ckpt252,5_vs_5
4448,-3,3,reward_shaping_checkpoints_bots_4_heads_1_ckpt360,6,f5v0to1to5_e2_ckpt252,5_vs_5
4449,-2,3,reward_shaping_checkpoints_bots_4_heads_1_ckpt360,5,f5v0to1to5_e2_ckpt252,5_vs_5
4450,-1,2,reward_shaping_checkpoints_bots_4_heads_1_ckpt360,3,scon_e3_p2_hard_ckpt840,5_vs_5
4451,-2,1,reward_shaping_checkpoints_bots_4_heads_1_ckpt360,3,scon_e3_p2_hard_ckpt840,5_vs_5
4452,-1,3,reward_shaping_checkpoints_bots_4_heads_1_ckpt360,4,scon_e3_p2_hard_ckpt840,5_vs_5
4453,0,1,reward_shaping_checkpoints_bots_4_heads_1_ckpt360,1,scon_e3_p2_hard_ckpt840,5_vs_5
4454,2,2,reward_shaping_checkpoints_bots_4_heads_1_ckpt360,0,scon_e3_p2_hard_ckpt840,5_vs_5
4455,0,2,reward_shaping_checkpoints_bots_4_heads_1_ckpt360,2,scon_e3_p2_hard_ckpt840,5_vs_5
4456,-1,2,reward_shaping_checkpoints_bots_4_heads_1_ckpt360,3,scon_e3_p2_hard_ckpt840,5_vs_5
4457,-1,3,reward_shaping_checkpoints_bots_4_heads_1_ckpt360,4,scon_e3_p2_hard_ckpt840,5_vs_5
4458,-2,1,reward_shaping_checkpoints_bots_4_heads_1_ckpt360,3,scon_e3_p2_hard_ckpt840,5_vs_5
4459,-3,2,reward_shaping_checkpoints_bots_4_heads_1_ckpt360,5,scon_e3_p2_hard_ckpt840,5_vs_5
4460,-6,1,reward_shaping_checkpoints_bots_4_heads_1_ckpt360,7,less_then_partially_randomized_checkpoints_bots_4_heads_38_ckpt108,5_vs_5
4461,0,3,reward_shaping_checkpoints_bots_4_heads_1_ckpt360,3,less_then_partially_randomized_checkpoints_bots_4_heads_38_ckpt108,5_vs_5
4462,0,3,reward_shaping_checkpoints_bots_4_heads_1_ckpt360,3,less_then_partially_randomized_checkpoints_bots_4_heads_38_ckpt108,5_vs_5
4463,4,7,reward_shaping_checkpoints_bots_4_heads_1_ckpt360,3,less_then_partially_randomized_checkpoints_bots_4_heads_38_ckpt108,5_vs_5
4464,-3,2,reward_shaping_checkpoints_bots_4_heads_1_ckpt360,5,less_then_partially_randomized_checkpoints_bots_4_heads_38_ckpt108,5_vs_5
4465,-3,2,reward_shaping_checkpoints_bots_4_heads_1_ckpt360,5,less_then_partially_randomized_checkpoints_bots_4_heads_38_ckpt108,5_vs_5
4466,0,3,reward_shaping_checkpoints_bots_4_heads_1_ckpt360,3,less_then_partially_randomized_checkpoints_bots_4_heads_38_ckpt108,5_vs_5
4467,-1,2,reward_shaping_checkpoints_bots_4_heads_1_ckpt360,3,less_then_partially_randomized_checkpoints_bots_4_heads_38_ckpt108,5_vs_5
4468,2,6,reward_shaping_checkpoints_bots_4_heads_1_ckpt360,4,less_then_partially_randomized_checkpoints_bots_4_heads_38_ckpt108,5_vs_5
4469,-5,0,reward_shaping_checkpoints_bots_4_heads_1_ckpt360,5,less_then_partially_randomized_checkpoints_bots_4_heads_38_ckpt108,5_vs_5
4470,-5,1,reward_shaping_checkpoints_bots_4_heads_1_ckpt360,6,less_then_partially_randomized_entropy_checkpoints_bots_4_heads_39_ckpt109,5_vs_5
4471,-2,3,reward_shaping_checkpoints_bots_4_heads_1_ckpt360,5,less_then_partially_randomized_entropy_checkpoints_bots_4_heads_39_ckpt109,5_vs_5
4472,1,4,reward_shaping_checkpoints_bots_4_heads_1_ckpt360,3,less_then_partially_randomized_entropy_checkpoints_bots_4_heads_39_ckpt109,5_vs_5
4473,-6,0,reward_shaping_checkpoints_bots_4_heads_1_ckpt360,6,less_then_partially_randomized_entropy_checkpoints_bots_4_heads_39_ckpt109,5_vs_5
4474,-4,1,reward_shaping_checkpoints_bots_4_heads_1_ckpt360,5,less_then_partially_randomized_entropy_checkpoints_bots_4_heads_39_ckpt109,5_vs_5
4475,-1,5,reward_shaping_checkpoints_bots_4_heads_1_ckpt360,6,less_then_partially_randomized_entropy_checkpoints_bots_4_heads_39_ckpt109,5_vs_5
4476,0,3,reward_shaping_checkpoints_bots_4_heads_1_ckpt360,3,less_then_partially_randomized_entropy_checkpoints_bots_4_heads_39_ckpt109,5_vs_5
4477,0,2,reward_shaping_checkpoints_bots_4_heads_1_ckpt360,2,less_then_partially_randomized_entropy_checkpoints_bots_4_heads_39_ckpt109,5_vs_5
4478,-2,3,reward_shaping_checkpoints_bots_4_heads_1_ckpt360,5,less_then_partially_randomized_entropy_checkpoints_bots_4_heads_39_ckpt109,5_vs_5
4479,-2,3,reward_shaping_checkpoints_bots_4_heads_1_ckpt360,5,less_then_partially_randomized_entropy_checkpoints_bots_4_heads_39_ckpt109,5_vs_5
4480,-1,3,reward_shaping_checkpoints_bots_4_heads_1_ckpt360,4,reward_shaping_checkpoints_bots_4_heads_1_ckpt360,5_vs_5
4481,-1,3,reward_shaping_checkpoints_bots_4_heads_1_ckpt360,4,reward_shaping_checkpoints_bots_4_heads_1_ckpt360,5_vs_5
4482,-1,1,reward_shaping_checkpoints_bots_4_heads_1_ckpt360,2,reward_shaping_checkpoints_bots_4_heads_1_ckpt360,5_vs_5
4483,1,3,reward_shaping_checkpoints_bots_4_heads_1_ckpt360,2,reward_shaping_checkpoints_bots_4_heads_1_ckpt360,5_vs_5
4484,0,3,reward_shaping_checkpoints_bots_4_heads_1_ckpt360,3,reward_shaping_checkpoints_bots_4_heads_1_ckpt360,5_vs_5
4485,1,3,reward_shaping_checkpoints_bots_4_heads_1_ckpt360,2,reward_shaping_checkpoints_bots_4_heads_1_ckpt360,5_vs_5
4486,1,4,reward_shaping_checkpoints_bots_4_heads_1_ckpt360,3,reward_shaping_checkpoints_bots_4_heads_1_ckpt360,5_vs_5
4487,0,3,reward_shaping_checkpoints_bots_4_heads_1_ckpt360,3,reward_shaping_checkpoints_bots_4_heads_1_ckpt360,5_vs_5
4488,-6,1,reward_shaping_checkpoints_bots_4_heads_1_ckpt360,7,reward_shaping_checkpoints_bots_4_heads_1_ckpt360,5_vs_5
4489,1,3,reward_shaping_checkpoints_bots_4_heads_1_ckpt360,2,reward_shaping_checkpoints_bots_4_heads_1_ckpt360,5_vs_5
4490,-8,1,reward_shaping_checkpoints_bots_4_heads_1_ckpt360,9,checkpoints_selfplay_e9_sp_ckpt274,5_vs_5
4491,-11,2,reward_shaping_checkpoints_bots_4_heads_1_ckpt360,13,checkpoints_selfplay_e9_sp_ckpt274,5_vs_5
4492,-10,0,reward_shaping_checkpoints_bots_4_heads_1_ckpt360,10,checkpoints_selfplay_e9_sp_ckpt274,5_vs_5
4493,-7,3,reward_shaping_checkpoints_bots_4_heads_1_ckpt360,10,checkpoints_selfplay_e9_sp_ckpt274,5_vs_5
4494,-13,0,reward_shaping_checkpoints_bots_4_heads_1_ckpt360,13,checkpoints_selfplay_e9_sp_ckpt274,5_vs_5
4495,-8,2,reward_shaping_checkpoints_bots_4_heads_1_ckpt360,10,checkpoints_selfplay_e9_sp_ckpt274,5_vs_5
4496,-9,0,reward_shaping_checkpoints_bots_4_heads_1_ckpt360,9,checkpoints_selfplay_e9_sp_ckpt274,5_vs_5
4497,-9,1,reward_shaping_checkpoints_bots_4_heads_1_ckpt360,10,checkpoints_selfplay_e9_sp_ckpt274,5_vs_5
4498,-5,1,reward_shaping_checkpoints_bots_4_heads_1_ckpt360,6,checkpoints_selfplay_e9_sp_ckpt274,5_vs_5
4499,-5,2,reward_shaping_checkpoints_bots_4_heads_1_ckpt360,7,checkpoints_selfplay_e9_sp_ckpt274,5_vs_5
4500,-12,0,reward_shaping_checkpoints_bots_4_heads_1_ckpt360,12,checkpoints_sp_c_nb_e2_ckpt667,5_vs_5
4501,-6,0,reward_shaping_checkpoints_bots_4_heads_1_ckpt360,6,checkpoints_sp_c_nb_e2_ckpt667,5_vs_5
4502,-6,1,reward_shaping_checkpoints_bots_4_heads_1_ckpt360,7,checkpoints_sp_c_nb_e2_ckpt667,5_vs_5
4503,-4,0,reward_shaping_checkpoints_bots_4_heads_1_ckpt360,4,checkpoints_sp_c_nb_e2_ckpt667,5_vs_5
4504,-5,1,reward_shaping_checkpoints_bots_4_heads_1_ckpt360,6,checkpoints_sp_c_nb_e2_ckpt667,5_vs_5
4505,-5,0,reward_shaping_checkpoints_bots_4_heads_1_ckpt360,5,checkpoints_sp_c_nb_e2_ckpt667,5_vs_5
4506,-5,1,reward_shaping_checkpoints_bots_4_heads_1_ckpt360,6,checkpoints_sp_c_nb_e2_ckpt667,5_vs_5
4507,-9,1,reward_shaping_checkpoints_bots_4_heads_1_ckpt360,10,checkpoints_sp_c_nb_e2_ckpt667,5_vs_5
4508,-5,0,reward_shaping_checkpoints_bots_4_heads_1_ckpt360,5,checkpoints_sp_c_nb_e2_ckpt667,5_vs_5
4509,-9,0,reward_shaping_checkpoints_bots_4_heads_1_ckpt360,9,checkpoints_sp_c_nb_e2_ckpt667,5_vs_5
4510,0,0,reward_shaping_checkpoints_bots_4_heads_1_ckpt360,0,scenario_curriculum_ckpt830,5_vs_5
4511,0,0,reward_shaping_checkpoints_bots_4_heads_1_ckpt360,0,scenario_curriculum_ckpt830,5_vs_5
4512,1,1,reward_shaping_checkpoints_bots_4_heads_1_ckpt360,0,scenario_curriculum_ckpt830,5_vs_5
4513,0,0,reward_shaping_checkpoints_bots_4_heads_1_ckpt360,0,scenario_curriculum_ckpt830,5_vs_5
4514,1,1,reward_shaping_checkpoints_bots_4_heads_1_ckpt360,0,scenario_curriculum_ckpt830,5_vs_5
4515,0,0,reward_shaping_checkpoints_bots_4_heads_1_ckpt360,0,scenario_curriculum_ckpt830,5_vs_5
4516,2,2,reward_shaping_checkpoints_bots_4_heads_1_ckpt360,0,scenario_curriculum_ckpt830,5_vs_5
4517,0,0,reward_shaping_checkpoints_bots_4_heads_1_ckpt360,0,scenario_curriculum_ckpt830,5_vs_5
4518,0,0,reward_shaping_checkpoints_bots_4_heads_1_ckpt360,0,scenario_curriculum_ckpt830,5_vs_5
4519,0,0,reward_shaping_checkpoints_bots_4_heads_1_ckpt360,0,scenario_curriculum_ckpt830,5_vs_5
4520,-1,3,reward_shaping_checkpoints_bots_4_heads_1_ckpt360,4,m_sp_arch_medium_heads_conv16_0_bt_32_r313_m335,5_vs_5
4521,-1,3,reward_shaping_checkpoints_bots_4_heads_1_ckpt360,4,m_sp_arch_medium_heads_conv16_0_bt_32_r313_m335,5_vs_5
4522,-2,2,reward_shaping_checkpoints_bots_4_heads_1_ckpt360,4,m_sp_arch_medium_heads_conv16_0_bt_32_r313_m335,5_vs_5
4523,-2,1,reward_shaping_checkpoints_bots_4_heads_1_ckpt360,3,m_sp_arch_medium_heads_conv16_0_bt_32_r313_m335,5_vs_5
4524,-3,1,reward_shaping_checkpoints_bots_4_heads_1_ckpt360,4,m_sp_arch_medium_heads_conv16_0_bt_32_r313_m335,5_vs_5
4525,-3,2,reward_shaping_checkpoints_bots_4_heads_1_ckpt360,5,m_sp_arch_medium_heads_conv16_0_bt_32_r313_m335,5_vs_5
4526,-4,2,reward_shaping_checkpoints_bots_4_heads_1_ckpt360,6,m_sp_arch_medium_heads_conv16_0_bt_32_r313_m335,5_vs_5
4527,-4,3,reward_shaping_checkpoints_bots_4_heads_1_ckpt360,7,m_sp_arch_medium_heads_conv16_0_bt_32_r313_m335,5_vs_5
4528,-2,2,reward_shaping_checkpoints_bots_4_heads_1_ckpt360,4,m_sp_arch_medium_heads_conv16_0_bt_32_r313_m335,5_vs_5
4529,-3,1,reward_shaping_checkpoints_bots_4_heads_1_ckpt360,4,m_sp_arch_medium_heads_conv16_0_bt_32_r313_m335,5_vs_5
4530,-4,1,reward_shaping_checkpoints_bots_4_heads_1_ckpt360,5,m_sp_arch_longer_heads_bt_32_r201_m335,5_vs_5
4531,-3,0,reward_shaping_checkpoints_bots_4_heads_1_ckpt360,3,m_sp_arch_longer_heads_bt_32_r201_m335,5_vs_5
4532,-2,2,reward_shaping_checkpoints_bots_4_heads_1_ckpt360,4,m_sp_arch_longer_heads_bt_32_r201_m335,5_vs_5
4533,-3,2,reward_shaping_checkpoints_bots_4_heads_1_ckpt360,5,m_sp_arch_longer_heads_bt_32_r201_m335,5_vs_5
4534,-6,1,reward_shaping_checkpoints_bots_4_heads_1_ckpt360,7,m_sp_arch_longer_heads_bt_32_r201_m335,5_vs_5
4535,-3,0,reward_shaping_checkpoints_bots_4_heads_1_ckpt360,3,m_sp_arch_longer_heads_bt_32_r201_m335,5_vs_5
4536,-10,0,reward_shaping_checkpoints_bots_4_heads_1_ckpt360,10,m_sp_arch_longer_heads_bt_32_r201_m335,5_vs_5
4537,-7,0,reward_shaping_checkpoints_bots_4_heads_1_ckpt360,7,m_sp_arch_longer_heads_bt_32_r201_m335,5_vs_5
4538,-3,0,reward_shaping_checkpoints_bots_4_heads_1_ckpt360,3,m_sp_arch_longer_heads_bt_32_r201_m335,5_vs_5
4539,-5,1,reward_shaping_checkpoints_bots_4_heads_1_ckpt360,6,m_sp_arch_longer_heads_bt_32_r201_m335,5_vs_5
4540,-7,1,reward_shaping_checkpoints_bots_4_heads_1_ckpt360,8,m_sp_arch_medium_heads_bt_32_r201_m335,5_vs_5
4541,-8,2,reward_shaping_checkpoints_bots_4_heads_1_ckpt360,10,m_sp_arch_medium_heads_bt_32_r201_m335,5_vs_5
4542,-5,1,reward_shaping_checkpoints_bots_4_heads_1_ckpt360,6,m_sp_arch_medium_heads_bt_32_r201_m335,5_vs_5
4543,-7,1,reward_shaping_checkpoints_bots_4_heads_1_ckpt360,8,m_sp_arch_medium_heads_bt_32_r201_m335,5_vs_5
4544,-8,1,reward_shaping_checkpoints_bots_4_heads_1_ckpt360,9,m_sp_arch_medium_heads_bt_32_r201_m335,5_vs_5
4545,-8,0,reward_shaping_checkpoints_bots_4_heads_1_ckpt360,8,m_sp_arch_medium_heads_bt_32_r201_m335,5_vs_5
4546,-10,0,reward_shaping_checkpoints_bots_4_heads_1_ckpt360,10,m_sp_arch_medium_heads_bt_32_r201_m335,5_vs_5
4547,-7,1,reward_shaping_checkpoints_bots_4_heads_1_ckpt360,8,m_sp_arch_medium_heads_bt_32_r201_m335,5_vs_5
4548,-3,1,reward_shaping_checkpoints_bots_4_heads_1_ckpt360,4,m_sp_arch_medium_heads_bt_32_r201_m335,5_vs_5
4549,-9,0,reward_shaping_checkpoints_bots_4_heads_1_ckpt360,9,m_sp_arch_medium_heads_bt_32_r201_m335,5_vs_5
4550,-11,0,reward_shaping_checkpoints_bots_4_heads_1_ckpt360,11,m_sp_arch_4x1_bt_32_r201_m335,5_vs_5
4551,-10,0,reward_shaping_checkpoints_bots_4_heads_1_ckpt360,10,m_sp_arch_4x1_bt_32_r201_m335,5_vs_5
4552,-10,1,reward_shaping_checkpoints_bots_4_heads_1_ckpt360,11,m_sp_arch_4x1_bt_32_r201_m335,5_vs_5
4553,-6,1,reward_shaping_checkpoints_bots_4_heads_1_ckpt360,7,m_sp_arch_4x1_bt_32_r201_m335,5_vs_5
4554,-14,0,reward_shaping_checkpoints_bots_4_heads_1_ckpt360,14,m_sp_arch_4x1_bt_32_r201_m335,5_vs_5
4555,-12,0,reward_shaping_checkpoints_bots_4_heads_1_ckpt360,12,m_sp_arch_4x1_bt_32_r201_m335,5_vs_5
4556,-10,0,reward_shaping_checkpoints_bots_4_heads_1_ckpt360,10,m_sp_arch_4x1_bt_32_r201_m335,5_vs_5
4557,-14,0,reward_shaping_checkpoints_bots_4_heads_1_ckpt360,14,m_sp_arch_4x1_bt_32_r201_m335,5_vs_5
4558,-9,0,reward_shaping_checkpoints_bots_4_heads_1_ckpt360,9,m_sp_arch_4x1_bt_32_r201_m335,5_vs_5
4559,-11,0,reward_shaping_checkpoints_bots_4_heads_1_ckpt360,11,m_sp_arch_4x1_bt_32_r201_m335,5_vs_5
4560,-8,0,reward_shaping_checkpoints_bots_4_heads_1_ckpt360,8,m_sp_arch_4x1_bt_32_r201_cont3_m650,5_vs_5
4561,-10,0,reward_shaping_checkpoints_bots_4_heads_1_ckpt360,10,m_sp_arch_4x1_bt_32_r201_cont3_m650,5_vs_5
4562,-8,0,reward_shaping_checkpoints_bots_4_heads_1_ckpt360,8,m_sp_arch_4x1_bt_32_r201_cont3_m650,5_vs_5
4563,-8,1,reward_shaping_checkpoints_bots_4_heads_1_ckpt360,9,m_sp_arch_4x1_bt_32_r201_cont3_m650,5_vs_5
4564,-11,0,reward_shaping_checkpoints_bots_4_heads_1_ckpt360,11,m_sp_arch_4x1_bt_32_r201_cont3_m650,5_vs_5
4565,-9,0,reward_shaping_checkpoints_bots_4_heads_1_ckpt360,9,m_sp_arch_4x1_bt_32_r201_cont3_m650,5_vs_5
4566,-10,0,reward_shaping_checkpoints_bots_4_heads_1_ckpt360,10,m_sp_arch_4x1_bt_32_r201_cont3_m650,5_vs_5
4567,-6,1,reward_shaping_checkpoints_bots_4_heads_1_ckpt360,7,m_sp_arch_4x1_bt_32_r201_cont3_m650,5_vs_5
4568,-9,0,reward_shaping_checkpoints_bots_4_heads_1_ckpt360,9,m_sp_arch_4x1_bt_32_r201_cont3_m650,5_vs_5
4569,-10,0,reward_shaping_checkpoints_bots_4_heads_1_ckpt360,10,m_sp_arch_4x1_bt_32_r201_cont3_m650,5_vs_5
4570,-3,0,reward_shaping_checkpoints_bots_4_heads_1_ckpt360,3,explt_v0_7_2_m54,5_vs_5
4571,-1,0,reward_shaping_checkpoints_bots_4_heads_1_ckpt360,1,explt_v0_7_2_m54,5_vs_5
4572,-1,2,reward_shaping_checkpoints_bots_4_heads_1_ckpt360,3,explt_v0_7_2_m54,5_vs_5
4573,-1,0,reward_shaping_checkpoints_bots_4_heads_1_ckpt360,1,explt_v0_7_2_m54,5_vs_5
4574,-1,0,reward_shaping_checkpoints_bots_4_heads_1_ckpt360,1,explt_v0_7_2_m54,5_vs_5
4575,-4,0,reward_shaping_checkpoints_bots_4_heads_1_ckpt360,4,explt_v0_7_2_m54,5_vs_5
4576,-3,0,reward_shaping_checkpoints_bots_4_heads_1_ckpt360,3,explt_v0_7_2_m54,5_vs_5
4577,-2,2,reward_shaping_checkpoints_bots_4_heads_1_ckpt360,4,explt_v0_7_2_m54,5_vs_5
4578,-4,0,reward_shaping_checkpoints_bots_4_heads_1_ckpt360,4,explt_v0_7_2_m54,5_vs_5
4579,-5,0,reward_shaping_checkpoints_bots_4_heads_1_ckpt360,5,explt_v0_7_2_m54,5_vs_5
4580,-9,0,reward_shaping_checkpoints_bots_4_heads_1_ckpt360,9,m_sp_sc3v3_arch_2x1_32_r500_cont4x1_m224,5_vs_5
4581,-14,0,reward_shaping_checkpoints_bots_4_heads_1_ckpt360,14,m_sp_sc3v3_arch_2x1_32_r500_cont4x1_m224,5_vs_5
4582,-12,0,reward_shaping_checkpoints_bots_4_heads_1_ckpt360,12,m_sp_sc3v3_arch_2x1_32_r500_cont4x1_m224,5_vs_5
4583,-7,0,reward_shaping_checkpoints_bots_4_heads_1_ckpt360,7,m_sp_sc3v3_arch_2x1_32_r500_cont4x1_m224,5_vs_5
4584,-9,0,reward_shaping_checkpoints_bots_4_heads_1_ckpt360,9,m_sp_sc3v3_arch_2x1_32_r500_cont4x1_m224,5_vs_5
4585,-10,0,reward_shaping_checkpoints_bots_4_heads_1_ckpt360,10,m_sp_sc3v3_arch_2x1_32_r500_cont4x1_m224,5_vs_5
4586,-14,0,reward_shaping_checkpoints_bots_4_heads_1_ckpt360,14,m_sp_sc3v3_arch_2x1_32_r500_cont4x1_m224,5_vs_5
4587,-8,1,reward_shaping_checkpoints_bots_4_heads_1_ckpt360,9,m_sp_sc3v3_arch_2x1_32_r500_cont4x1_m224,5_vs_5
4588,-10,0,reward_shaping_checkpoints_bots_4_heads_1_ckpt360,10,m_sp_sc3v3_arch_2x1_32_r500_cont4x1_m224,5_vs_5
4589,-10,0,reward_shaping_checkpoints_bots_4_heads_1_ckpt360,10,m_sp_sc3v3_arch_2x1_32_r500_cont4x1_m224,5_vs_5
4590,-13,0,reward_shaping_checkpoints_bots_4_heads_1_ckpt360,13,m_sp_arch_4x1_bt_32_roles_r500_m335,5_vs_5
4591,-12,0,reward_shaping_checkpoints_bots_4_heads_1_ckpt360,12,m_sp_arch_4x1_bt_32_roles_r500_m335,5_vs_5
4592,-11,0,reward_shaping_checkpoints_bots_4_heads_1_ckpt360,11,m_sp_arch_4x1_bt_32_roles_r500_m335,5_vs_5
4593,-13,1,reward_shaping_checkpoints_bots_4_heads_1_ckpt360,14,m_sp_arch_4x1_bt_32_roles_r500_m335,5_vs_5
4594,-13,0,reward_shaping_checkpoints_bots_4_heads_1_ckpt360,13,m_sp_arch_4x1_bt_32_roles_r500_m335,5_vs_5
4595,-13,1,reward_shaping_checkpoints_bots_4_heads_1_ckpt360,14,m_sp_arch_4x1_bt_32_roles_r500_m335,5_vs_5
4596,-11,0,reward_shaping_checkpoints_bots_4_heads_1_ckpt360,11,m_sp_arch_4x1_bt_32_roles_r500_m335,5_vs_5
4597,-11,0,reward_shaping_checkpoints_bots_4_heads_1_ckpt360,11,m_sp_arch_4x1_bt_32_roles_r500_m335,5_vs_5
4598,-11,0,reward_shaping_checkpoints_bots_4_heads_1_ckpt360,11,m_sp_arch_4x1_bt_32_roles_r500_m335,5_vs_5
4599,-15,1,reward_shaping_checkpoints_bots_4_heads_1_ckpt360,16,m_sp_arch_4x1_bt_32_roles_r500_m335,5_vs_5
4600,-1,0,m_sp_arch_4x1_bt_32_r201_m335,1,easy_bots,5_vs_5
4601,1,3,m_sp_arch_4x1_bt_32_r201_m335,2,easy_bots,5_vs_5
4602,1,1,m_sp_arch_4x1_bt_32_r201_m335,0,easy_bots,5_vs_5
4603,2,2,m_sp_arch_4x1_bt_32_r201_m335,0,easy_bots,5_vs_5
4604,2,2,m_sp_arch_4x1_bt_32_r201_m335,0,easy_bots,5_vs_5
4605,4,4,m_sp_arch_4x1_bt_32_r201_m335,0,easy_bots,5_vs_5
4606,0,0,m_sp_arch_4x1_bt_32_r201_m335,0,easy_bots,5_vs_5
4607,0,0,m_sp_arch_4x1_bt_32_r201_m335,0,easy_bots,5_vs_5
4608,3,3,m_sp_arch_4x1_bt_32_r201_m335,0,easy_bots,5_vs_5
4609,1,1,m_sp_arch_4x1_bt_32_r201_m335,0,easy_bots,5_vs_5
4610,0,2,m_sp_arch_4x1_bt_32_r201_m335,2,easy_bots,5_vs_5
4611,1,1,m_sp_arch_4x1_bt_32_r201_m335,0,easy_bots,5_vs_5
4612,-1,1,m_sp_arch_4x1_bt_32_r201_m335,2,easy_bots,5_vs_5
4613,-2,0,m_sp_arch_4x1_bt_32_r201_m335,2,easy_bots,5_vs_5
4614,0,1,m_sp_arch_4x1_bt_32_r201_m335,1,easy_bots,5_vs_5
4615,3,3,m_sp_arch_4x1_bt_32_r201_m335,0,easy_bots,5_vs_5
4616,0,0,m_sp_arch_4x1_bt_32_r201_m335,0,easy_bots,5_vs_5
4617,2,2,m_sp_arch_4x1_bt_32_r201_m335,0,easy_bots,5_vs_5
4618,2,3,m_sp_arch_4x1_bt_32_r201_m335,1,easy_bots,5_vs_5
4619,3,3,m_sp_arch_4x1_bt_32_r201_m335,0,easy_bots,5_vs_5
4620,0,0,m_sp_arch_4x1_bt_32_r201_m335,0,medium_bots,5_vs_5_medium
4621,0,2,m_sp_arch_4x1_bt_32_r201_m335,2,medium_bots,5_vs_5_medium
4622,0,0,m_sp_arch_4x1_bt_32_r201_m335,0,medium_bots,5_vs_5_medium
4623,-1,1,m_sp_arch_4x1_bt_32_r201_m335,2,medium_bots,5_vs_5_medium
4624,1,1,m_sp_arch_4x1_bt_32_r201_m335,0,medium_bots,5_vs_5_medium
4625,0,2,m_sp_arch_4x1_bt_32_r201_m335,2,medium_bots,5_vs_5_medium
4626,0,1,m_sp_arch_4x1_bt_32_r201_m335,1,medium_bots,5_vs_5_medium
4627,-1,1,m_sp_arch_4x1_bt_32_r201_m335,2,medium_bots,5_vs_5_medium
4628,-1,1,m_sp_arch_4x1_bt_32_r201_m335,2,medium_bots,5_vs_5_medium
4629,1,1,m_sp_arch_4x1_bt_32_r201_m335,0,medium_bots,5_vs_5_medium
4630,-1,1,m_sp_arch_4x1_bt_32_r201_m335,2,medium_bots,5_vs_5_medium
4631,-1,0,m_sp_arch_4x1_bt_32_r201_m335,1,medium_bots,5_vs_5_medium
4632,-1,0,m_sp_arch_4x1_bt_32_r201_m335,1,medium_bots,5_vs_5_medium
4633,-1,1,m_sp_arch_4x1_bt_32_r201_m335,2,medium_bots,5_vs_5_medium
4634,1,2,m_sp_arch_4x1_bt_32_r201_m335,1,medium_bots,5_vs_5_medium
4635,-1,0,m_sp_arch_4x1_bt_32_r201_m335,1,medium_bots,5_vs_5_medium
4636,1,2,m_sp_arch_4x1_bt_32_r201_m335,1,medium_bots,5_vs_5_medium
4637,-1,1,m_sp_arch_4x1_bt_32_r201_m335,2,medium_bots,5_vs_5_medium
4638,0,2,m_sp_arch_4x1_bt_32_r201_m335,2,medium_bots,5_vs_5_medium
4639,2,2,m_sp_arch_4x1_bt_32_r201_m335,0,medium_bots,5_vs_5_medium
4640,-1,1,m_sp_arch_4x1_bt_32_r201_m335,2,hard_bots,5_vs_5_hard
4641,-2,0,m_sp_arch_4x1_bt_32_r201_m335,2,hard_bots,5_vs_5_hard
4642,1,1,m_sp_arch_4x1_bt_32_r201_m335,0,hard_bots,5_vs_5_hard
4643,-2,0,m_sp_arch_4x1_bt_32_r201_m335,2,hard_bots,5_vs_5_hard
4644,-1,0,m_sp_arch_4x1_bt_32_r201_m335,1,hard_bots,5_vs_5_hard
4645,-1,1,m_sp_arch_4x1_bt_32_r201_m335,2,hard_bots,5_vs_5_hard
4646,1,1,m_sp_arch_4x1_bt_32_r201_m335,0,hard_bots,5_vs_5_hard
4647,0,2,m_sp_arch_4x1_bt_32_r201_m335,2,hard_bots,5_vs_5_hard
4648,-1,1,m_sp_arch_4x1_bt_32_r201_m335,2,hard_bots,5_vs_5_hard
4649,0,1,m_sp_arch_4x1_bt_32_r201_m335,1,hard_bots,5_vs_5_hard
4650,1,1,m_sp_arch_4x1_bt_32_r201_m335,0,hard_bots,5_vs_5_hard
4651,-1,0,m_sp_arch_4x1_bt_32_r201_m335,1,hard_bots,5_vs_5_hard
4652,0,0,m_sp_arch_4x1_bt_32_r201_m335,0,hard_bots,5_vs_5_hard
4653,-1,0,m_sp_arch_4x1_bt_32_r201_m335,1,hard_bots,5_vs_5_hard
4654,-3,0,m_sp_arch_4x1_bt_32_r201_m335,3,hard_bots,5_vs_5_hard
4655,-2,1,m_sp_arch_4x1_bt_32_r201_m335,3,hard_bots,5_vs_5_hard
4656,0,0,m_sp_arch_4x1_bt_32_r201_m335,0,hard_bots,5_vs_5_hard
4657,-1,0,m_sp_arch_4x1_bt_32_r201_m335,1,hard_bots,5_vs_5_hard
4658,-1,1,m_sp_arch_4x1_bt_32_r201_m335,2,hard_bots,5_vs_5_hard
4659,1,1,m_sp_arch_4x1_bt_32_r201_m335,0,hard_bots,5_vs_5_hard
4660,7,9,m_sp_arch_4x1_bt_32_r201_m335,2,f5v0to1to2t05_e2_ckpt291,5_vs_5
4661,9,10,m_sp_arch_4x1_bt_32_r201_m335,1,f5v0to1to2t05_e2_ckpt291,5_vs_5
4662,10,11,m_sp_arch_4x1_bt_32_r201_m335,1,f5v0to1to2t05_e2_ckpt291,5_vs_5
4663,11,12,m_sp_arch_4x1_bt_32_r201_m335,1,f5v0to1to2t05_e2_ckpt291,5_vs_5
4664,10,11,m_sp_arch_4x1_bt_32_r201_m335,1,f5v0to1to2t05_e2_ckpt291,5_vs_5
4665,8,8,m_sp_arch_4x1_bt_32_r201_m335,0,f5v0to1to2t05_e2_ckpt291,5_vs_5
4666,9,9,m_sp_arch_4x1_bt_32_r201_m335,0,f5v0to1to2t05_e2_ckpt291,5_vs_5
4667,11,11,m_sp_arch_4x1_bt_32_r201_m335,0,f5v0to1to2t05_e2_ckpt291,5_vs_5
4668,6,8,m_sp_arch_4x1_bt_32_r201_m335,2,f5v0to1to2t05_e2_ckpt291,5_vs_5
4669,13,13,m_sp_arch_4x1_bt_32_r201_m335,0,f5v0to1to2t05_e2_ckpt291,5_vs_5
4670,4,5,m_sp_arch_4x1_bt_32_r201_m335,1,f5v0to1to5_e2_ckpt252,5_vs_5
4671,13,14,m_sp_arch_4x1_bt_32_r201_m335,1,f5v0to1to5_e2_ckpt252,5_vs_5
4672,7,7,m_sp_arch_4x1_bt_32_r201_m335,0,f5v0to1to5_e2_ckpt252,5_vs_5
4673,6,7,m_sp_arch_4x1_bt_32_r201_m335,1,f5v0to1to5_e2_ckpt252,5_vs_5
4674,8,8,m_sp_arch_4x1_bt_32_r201_m335,0,f5v0to1to5_e2_ckpt252,5_vs_5
4675,14,14,m_sp_arch_4x1_bt_32_r201_m335,0,f5v0to1to5_e2_ckpt252,5_vs_5
4676,5,5,m_sp_arch_4x1_bt_32_r201_m335,0,f5v0to1to5_e2_ckpt252,5_vs_5
4677,7,7,m_sp_arch_4x1_bt_32_r201_m335,0,f5v0to1to5_e2_ckpt252,5_vs_5
4678,4,4,m_sp_arch_4x1_bt_32_r201_m335,0,f5v0to1to5_e2_ckpt252,5_vs_5
4679,2,3,m_sp_arch_4x1_bt_32_r201_m335,1,f5v0to1to5_e2_ckpt252,5_vs_5
4680,14,14,m_sp_arch_4x1_bt_32_r201_m335,0,scon_e3_p2_hard_ckpt840,5_vs_5
4681,11,12,m_sp_arch_4x1_bt_32_r201_m335,1,scon_e3_p2_hard_ckpt840,5_vs_5
4682,13,14,m_sp_arch_4x1_bt_32_r201_m335,1,scon_e3_p2_hard_ckpt840,5_vs_5
4683,11,12,m_sp_arch_4x1_bt_32_r201_m335,1,scon_e3_p2_hard_ckpt840,5_vs_5
4684,14,14,m_sp_arch_4x1_bt_32_r201_m335,0,scon_e3_p2_hard_ckpt840,5_vs_5
4685,8,8,m_sp_arch_4x1_bt_32_r201_m335,0,scon_e3_p2_hard_ckpt840,5_vs_5
4686,11,11,m_sp_arch_4x1_bt_32_r201_m335,0,scon_e3_p2_hard_ckpt840,5_vs_5
4687,12,12,m_sp_arch_4x1_bt_32_r201_m335,0,scon_e3_p2_hard_ckpt840,5_vs_5
4688,9,10,m_sp_arch_4x1_bt_32_r201_m335,1,scon_e3_p2_hard_ckpt840,5_vs_5
4689,13,13,m_sp_arch_4x1_bt_32_r201_m335,0,scon_e3_p2_hard_ckpt840,5_vs_5
4690,13,13,m_sp_arch_4x1_bt_32_r201_m335,0,less_then_partially_randomized_checkpoints_bots_4_heads_38_ckpt108,5_vs_5
4691,13,13,m_sp_arch_4x1_bt_32_r201_m335,0,less_then_partially_randomized_checkpoints_bots_4_heads_38_ckpt108,5_vs_5
4692,11,11,m_sp_arch_4x1_bt_32_r201_m335,0,less_then_partially_randomized_checkpoints_bots_4_heads_38_ckpt108,5_vs_5
4693,15,15,m_sp_arch_4x1_bt_32_r201_m335,0,less_then_partially_randomized_checkpoints_bots_4_heads_38_ckpt108,5_vs_5
4694,10,10,m_sp_arch_4x1_bt_32_r201_m335,0,less_then_partially_randomized_checkpoints_bots_4_heads_38_ckpt108,5_vs_5
4695,10,10,m_sp_arch_4x1_bt_32_r201_m335,0,less_then_partially_randomized_checkpoints_bots_4_heads_38_ckpt108,5_vs_5
4696,12,12,m_sp_arch_4x1_bt_32_r201_m335,0,less_then_partially_randomized_checkpoints_bots_4_heads_38_ckpt108,5_vs_5
4697,12,12,m_sp_arch_4x1_bt_32_r201_m335,0,less_then_partially_randomized_checkpoints_bots_4_heads_38_ckpt108,5_vs_5
4698,11,12,m_sp_arch_4x1_bt_32_r201_m335,1,less_then_partially_randomized_checkpoints_bots_4_heads_38_ckpt108,5_vs_5
4699,10,10,m_sp_arch_4x1_bt_32_r201_m335,0,less_then_partially_randomized_checkpoints_bots_4_heads_38_ckpt108,5_vs_5
4700,13,13,m_sp_arch_4x1_bt_32_r201_m335,0,less_then_partially_randomized_entropy_checkpoints_bots_4_heads_39_ckpt109,5_vs_5
4701,12,12,m_sp_arch_4x1_bt_32_r201_m335,0,less_then_partially_randomized_entropy_checkpoints_bots_4_heads_39_ckpt109,5_vs_5
4702,13,13,m_sp_arch_4x1_bt_32_r201_m335,0,less_then_partially_randomized_entropy_checkpoints_bots_4_heads_39_ckpt109,5_vs_5
4703,11,11,m_sp_arch_4x1_bt_32_r201_m335,0,less_then_partially_randomized_entropy_checkpoints_bots_4_heads_39_ckpt109,5_vs_5
4704,15,15,m_sp_arch_4x1_bt_32_r201_m335,0,less_then_partially_randomized_entropy_checkpoints_bots_4_heads_39_ckpt109,5_vs_5
4705,12,12,m_sp_arch_4x1_bt_32_r201_m335,0,less_then_partially_randomized_entropy_checkpoints_bots_4_heads_39_ckpt109,5_vs_5
4706,12,12,m_sp_arch_4x1_bt_32_r201_m335,0,less_then_partially_randomized_entropy_checkpoints_bots_4_heads_39_ckpt109,5_vs_5
4707,9,11,m_sp_arch_4x1_bt_32_r201_m335,2,less_then_partially_randomized_entropy_checkpoints_bots_4_heads_39_ckpt109,5_vs_5
4708,11,11,m_sp_arch_4x1_bt_32_r201_m335,0,less_then_partially_randomized_entropy_checkpoints_bots_4_heads_39_ckpt109,5_vs_5
4709,10,10,m_sp_arch_4x1_bt_32_r201_m335,0,less_then_partially_randomized_entropy_checkpoints_bots_4_heads_39_ckpt109,5_vs_5
4710,7,8,m_sp_arch_4x1_bt_32_r201_m335,1,reward_shaping_checkpoints_bots_4_heads_1_ckpt360,5_vs_5
4711,7,8,m_sp_arch_4x1_bt_32_r201_m335,1,reward_shaping_checkpoints_bots_4_heads_1_ckpt360,5_vs_5
4712,10,10,m_sp_arch_4x1_bt_32_r201_m335,0,reward_shaping_checkpoints_bots_4_heads_1_ckpt360,5_vs_5
4713,10,10,m_sp_arch_4x1_bt_32_r201_m335,0,reward_shaping_checkpoints_bots_4_heads_1_ckpt360,5_vs_5
4714,10,10,m_sp_arch_4x1_bt_32_r201_m335,0,reward_shaping_checkpoints_bots_4_heads_1_ckpt360,5_vs_5
4715,11,11,m_sp_arch_4x1_bt_32_r201_m335,0,reward_shaping_checkpoints_bots_4_heads_1_ckpt360,5_vs_5
4716,12,12,m_sp_arch_4x1_bt_32_r201_m335,0,reward_shaping_checkpoints_bots_4_heads_1_ckpt360,5_vs_5
4717,9,9,m_sp_arch_4x1_bt_32_r201_m335,0,reward_shaping_checkpoints_bots_4_heads_1_ckpt360,5_vs_5
4718,8,8,m_sp_arch_4x1_bt_32_r201_m335,0,reward_shaping_checkpoints_bots_4_heads_1_ckpt360,5_vs_5
4719,11,11,m_sp_arch_4x1_bt_32_r201_m335,0,reward_shaping_checkpoints_bots_4_heads_1_ckpt360,5_vs_5
4720,5,5,m_sp_arch_4x1_bt_32_r201_m335,0,checkpoints_selfplay_e9_sp_ckpt274,5_vs_5
4721,8,8,m_sp_arch_4x1_bt_32_r201_m335,0,checkpoints_selfplay_e9_sp_ckpt274,5_vs_5
4722,5,5,m_sp_arch_4x1_bt_32_r201_m335,0,checkpoints_selfplay_e9_sp_ckpt274,5_vs_5
4723,7,8,m_sp_arch_4x1_bt_32_r201_m335,1,checkpoints_selfplay_e9_sp_ckpt274,5_vs_5
4724,7,9,m_sp_arch_4x1_bt_32_r201_m335,2,checkpoints_selfplay_e9_sp_ckpt274,5_vs_5
4725,3,4,m_sp_arch_4x1_bt_32_r201_m335,1,checkpoints_selfplay_e9_sp_ckpt274,5_vs_5
4726,9,10,m_sp_arch_4x1_bt_32_r201_m335,1,checkpoints_selfplay_e9_sp_ckpt274,5_vs_5
4727,8,9,m_sp_arch_4x1_bt_32_r201_m335,1,checkpoints_selfplay_e9_sp_ckpt274,5_vs_5
4728,6,7,m_sp_arch_4x1_bt_32_r201_m335,1,checkpoints_selfplay_e9_sp_ckpt274,5_vs_5
4729,3,5,m_sp_arch_4x1_bt_32_r201_m335,2,checkpoints_selfplay_e9_sp_ckpt274,5_vs_5
4730,3,4,m_sp_arch_4x1_bt_32_r201_m335,1,checkpoints_sp_c_nb_e2_ckpt667,5_vs_5
4731,1,2,m_sp_arch_4x1_bt_32_r201_m335,1,checkpoints_sp_c_nb_e2_ckpt667,5_vs_5
4732,1,2,m_sp_arch_4x1_bt_32_r201_m335,1,checkpoints_sp_c_nb_e2_ckpt667,5_vs_5
4733,4,4,m_sp_arch_4x1_bt_32_r201_m335,0,checkpoints_sp_c_nb_e2_ckpt667,5_vs_5
4734,3,3,m_sp_arch_4x1_bt_32_r201_m335,0,checkpoints_sp_c_nb_e2_ckpt667,5_vs_5
4735,-2,1,m_sp_arch_4x1_bt_32_r201_m335,3,checkpoints_sp_c_nb_e2_ckpt667,5_vs_5
4736,0,2,m_sp_arch_4x1_bt_32_r201_m335,2,checkpoints_sp_c_nb_e2_ckpt667,5_vs_5
4737,2,3,m_sp_arch_4x1_bt_32_r201_m335,1,checkpoints_sp_c_nb_e2_ckpt667,5_vs_5
4738,0,3,m_sp_arch_4x1_bt_32_r201_m335,3,checkpoints_sp_c_nb_e2_ckpt667,5_vs_5
4739,2,2,m_sp_arch_4x1_bt_32_r201_m335,0,checkpoints_sp_c_nb_e2_ckpt667,5_vs_5
4740,17,17,m_sp_arch_4x1_bt_32_r201_m335,0,scenario_curriculum_ckpt830,5_vs_5
4741,9,9,m_sp_arch_4x1_bt_32_r201_m335,0,scenario_curriculum_ckpt830,5_vs_5
4742,0,0,m_sp_arch_4x1_bt_32_r201_m335,0,scenario_curriculum_ckpt830,5_vs_5
4743,16,16,m_sp_arch_4x1_bt_32_r201_m335,0,scenario_curriculum_ckpt830,5_vs_5
4744,14,14,m_sp_arch_4x1_bt_32_r201_m335,0,scenario_curriculum_ckpt830,5_vs_5
4745,18,18,m_sp_arch_4x1_bt_32_r201_m335,0,scenario_curriculum_ckpt830,5_vs_5
4746,12,12,m_sp_arch_4x1_bt_32_r201_m335,0,scenario_curriculum_ckpt830,5_vs_5
4747,16,16,m_sp_arch_4x1_bt_32_r201_m335,0,scenario_curriculum_ckpt830,5_vs_5
4748,0,0,m_sp_arch_4x1_bt_32_r201_m335,0,scenario_curriculum_ckpt830,5_vs_5
4749,7,7,m_sp_arch_4x1_bt_32_r201_m335,0,scenario_curriculum_ckpt830,5_vs_5
4750,3,4,m_sp_arch_4x1_bt_32_r201_m335,1,m_sp_arch_medium_heads_conv16_0_bt_32_r313_m335,5_vs_5
4751,4,5,m_sp_arch_4x1_bt_32_r201_m335,1,m_sp_arch_medium_heads_conv16_0_bt_32_r313_m335,5_vs_5
4752,5,6,m_sp_arch_4x1_bt_32_r201_m335,1,m_sp_arch_medium_heads_conv16_0_bt_32_r313_m335,5_vs_5
4753,6,6,m_sp_arch_4x1_bt_32_r201_m335,0,m_sp_arch_medium_heads_conv16_0_bt_32_r313_m335,5_vs_5
4754,6,6,m_sp_arch_4x1_bt_32_r201_m335,0,m_sp_arch_medium_heads_conv16_0_bt_32_r313_m335,5_vs_5
4755,1,2,m_sp_arch_4x1_bt_32_r201_m335,1,m_sp_arch_medium_heads_conv16_0_bt_32_r313_m335,5_vs_5
4756,7,8,m_sp_arch_4x1_bt_32_r201_m335,1,m_sp_arch_medium_heads_conv16_0_bt_32_r313_m335,5_vs_5
4757,6,7,m_sp_arch_4x1_bt_32_r201_m335,1,m_sp_arch_medium_heads_conv16_0_bt_32_r313_m335,5_vs_5
4758,11,12,m_sp_arch_4x1_bt_32_r201_m335,1,m_sp_arch_medium_heads_conv16_0_bt_32_r313_m335,5_vs_5
4759,4,4,m_sp_arch_4x1_bt_32_r201_m335,0,m_sp_arch_medium_heads_conv16_0_bt_32_r313_m335,5_vs_5
4760,5,5,m_sp_arch_4x1_bt_32_r201_m335,0,m_sp_arch_longer_heads_bt_32_r201_m335,5_vs_5
4761,3,4,m_sp_arch_4x1_bt_32_r201_m335,1,m_sp_arch_longer_heads_bt_32_r201_m335,5_vs_5
4762,6,7,m_sp_arch_4x1_bt_32_r201_m335,1,m_sp_arch_longer_heads_bt_32_r201_m335,5_vs_5
4763,10,11,m_sp_arch_4x1_bt_32_r201_m335,1,m_sp_arch_longer_heads_bt_32_r201_m335,5_vs_5
4764,7,8,m_sp_arch_4x1_bt_32_r201_m335,1,m_sp_arch_longer_heads_bt_32_r201_m335,5_vs_5
4765,4,7,m_sp_arch_4x1_bt_32_r201_m335,3,m_sp_arch_longer_heads_bt_32_r201_m335,5_vs_5
4766,8,8,m_sp_arch_4x1_bt_32_r201_m335,0,m_sp_arch_longer_heads_bt_32_r201_m335,5_vs_5
4767,3,5,m_sp_arch_4x1_bt_32_r201_m335,2,m_sp_arch_longer_heads_bt_32_r201_m335,5_vs_5
4768,3,6,m_sp_arch_4x1_bt_32_r201_m335,3,m_sp_arch_longer_heads_bt_32_r201_m335,5_vs_5
4769,2,3,m_sp_arch_4x1_bt_32_r201_m335,1,m_sp_arch_longer_heads_bt_32_r201_m335,5_vs_5
4770,10,10,m_sp_arch_4x1_bt_32_r201_m335,0,m_sp_arch_medium_heads_bt_32_r201_m335,5_vs_5
4771,3,4,m_sp_arch_4x1_bt_32_r201_m335,1,m_sp_arch_medium_heads_bt_32_r201_m335,5_vs_5
4772,8,9,m_sp_arch_4x1_bt_32_r201_m335,1,m_sp_arch_medium_heads_bt_32_r201_m335,5_vs_5
4773,4,4,m_sp_arch_4x1_bt_32_r201_m335,0,m_sp_arch_medium_heads_bt_32_r201_m335,5_vs_5
4774,3,4,m_sp_arch_4x1_bt_32_r201_m335,1,m_sp_arch_medium_heads_bt_32_r201_m335,5_vs_5
4775,5,6,m_sp_arch_4x1_bt_32_r201_m335,1,m_sp_arch_medium_heads_bt_32_r201_m335,5_vs_5
4776,4,5,m_sp_arch_4x1_bt_32_r201_m335,1,m_sp_arch_medium_heads_bt_32_r201_m335,5_vs_5
4777,6,7,m_sp_arch_4x1_bt_32_r201_m335,1,m_sp_arch_medium_heads_bt_32_r201_m335,5_vs_5
4778,4,5,m_sp_arch_4x1_bt_32_r201_m335,1,m_sp_arch_medium_heads_bt_32_r201_m335,5_vs_5
4779,7,7,m_sp_arch_4x1_bt_32_r201_m335,0,m_sp_arch_medium_heads_bt_32_r201_m335,5_vs_5
4780,1,3,m_sp_arch_4x1_bt_32_r201_m335,2,m_sp_arch_4x1_bt_32_r201_m335,5_vs_5
4781,2,5,m_sp_arch_4x1_bt_32_r201_m335,3,m_sp_arch_4x1_bt_32_r201_m335,5_vs_5
4782,1,2,m_sp_arch_4x1_bt_32_r201_m335,1,m_sp_arch_4x1_bt_32_r201_m335,5_vs_5
4783,0,2,m_sp_arch_4x1_bt_32_r201_m335,2,m_sp_arch_4x1_bt_32_r201_m335,5_vs_5
4784,-1,0,m_sp_arch_4x1_bt_32_r201_m335,1,m_sp_arch_4x1_bt_32_r201_m335,5_vs_5
4785,-4,0,m_sp_arch_4x1_bt_32_r201_m335,4,m_sp_arch_4x1_bt_32_r201_m335,5_vs_5
4786,1,1,m_sp_arch_4x1_bt_32_r201_m335,0,m_sp_arch_4x1_bt_32_r201_m335,5_vs_5
4787,2,3,m_sp_arch_4x1_bt_32_r201_m335,1,m_sp_arch_4x1_bt_32_r201_m335,5_vs_5
4788,1,2,m_sp_arch_4x1_bt_32_r201_m335,1,m_sp_arch_4x1_bt_32_r201_m335,5_vs_5
4789,0,1,m_sp_arch_4x1_bt_32_r201_m335,1,m_sp_arch_4x1_bt_32_r201_m335,5_vs_5
4790,2,3,m_sp_arch_4x1_bt_32_r201_m335,1,m_sp_arch_4x1_bt_32_r201_cont3_m650,5_vs_5
4791,1,1,m_sp_arch_4x1_bt_32_r201_m335,0,m_sp_arch_4x1_bt_32_r201_cont3_m650,5_vs_5
4792,0,2,m_sp_arch_4x1_bt_32_r201_m335,2,m_sp_arch_4x1_bt_32_r201_cont3_m650,5_vs_5
4793,-1,1,m_sp_arch_4x1_bt_32_r201_m335,2,m_sp_arch_4x1_bt_32_r201_cont3_m650,5_vs_5
4794,-2,1,m_sp_arch_4x1_bt_32_r201_m335,3,m_sp_arch_4x1_bt_32_r201_cont3_m650,5_vs_5
4795,-2,0,m_sp_arch_4x1_bt_32_r201_m335,2,m_sp_arch_4x1_bt_32_r201_cont3_m650,5_vs_5
4796,0,1,m_sp_arch_4x1_bt_32_r201_m335,1,m_sp_arch_4x1_bt_32_r201_cont3_m650,5_vs_5
4797,1,2,m_sp_arch_4x1_bt_32_r201_m335,1,m_sp_arch_4x1_bt_32_r201_cont3_m650,5_vs_5
4798,0,2,m_sp_arch_4x1_bt_32_r201_m335,2,m_sp_arch_4x1_bt_32_r201_cont3_m650,5_vs_5
4799,2,3,m_sp_arch_4x1_bt_32_r201_m335,1,m_sp_arch_4x1_bt_32_r201_cont3_m650,5_vs_5
4800,-1,2,m_sp_arch_4x1_bt_32_r201_m335,3,explt_v0_7_2_m54,5_vs_5
4801,-3,0,m_sp_arch_4x1_bt_32_r201_m335,3,explt_v0_7_2_m54,5_vs_5
4802,0,1,m_sp_arch_4x1_bt_32_r201_m335,1,explt_v0_7_2_m54,5_vs_5
4803,1,2,m_sp_arch_4x1_bt_32_r201_m335,1,explt_v0_7_2_m54,5_vs_5
4804,-3,1,m_sp_arch_4x1_bt_32_r201_m335,4,explt_v0_7_2_m54,5_vs_5
4805,-1,2,m_sp_arch_4x1_bt_32_r201_m335,3,explt_v0_7_2_m54,5_vs_5
4806,-3,1,m_sp_arch_4x1_bt_32_r201_m335,4,explt_v0_7_2_m54,5_vs_5
4807,-1,1,m_sp_arch_4x1_bt_32_r201_m335,2,explt_v0_7_2_m54,5_vs_5
4808,-2,0,m_sp_arch_4x1_bt_32_r201_m335,2,explt_v0_7_2_m54,5_vs_5
4809,-1,3,m_sp_arch_4x1_bt_32_r201_m335,4,explt_v0_7_2_m54,5_vs_5
4810,0,4,m_sp_arch_4x1_bt_32_r201_m335,4,m_sp_sc3v3_arch_2x1_32_r500_cont4x1_m224,5_vs_5
4811,2,3,m_sp_arch_4x1_bt_32_r201_m335,1,m_sp_sc3v3_arch_2x1_32_r500_cont4x1_m224,5_vs_5
4812,0,3,m_sp_arch_4x1_bt_32_r201_m335,3,m_sp_sc3v3_arch_2x1_32_r500_cont4x1_m224,5_vs_5
4813,2,5,m_sp_arch_4x1_bt_32_r201_m335,3,m_sp_sc3v3_arch_2x1_32_r500_cont4x1_m224,5_vs_5
4814,6,8,m_sp_arch_4x1_bt_32_r201_m335,2,m_sp_sc3v3_arch_2x1_32_r500_cont4x1_m224,5_vs_5
4815,3,3,m_sp_arch_4x1_bt_32_r201_m335,0,m_sp_sc3v3_arch_2x1_32_r500_cont4x1_m224,5_vs_5
4816,3,5,m_sp_arch_4x1_bt_32_r201_m335,2,m_sp_sc3v3_arch_2x1_32_r500_cont4x1_m224,5_vs_5
4817,3,6,m_sp_arch_4x1_bt_32_r201_m335,3,m_sp_sc3v3_arch_2x1_32_r500_cont4x1_m224,5_vs_5
4818,1,2,m_sp_arch_4x1_bt_32_r201_m335,1,m_sp_sc3v3_arch_2x1_32_r500_cont4x1_m224,5_vs_5
4819,1,4,m_sp_arch_4x1_bt_32_r201_m335,3,m_sp_sc3v3_arch_2x1_32_r500_cont4x1_m224,5_vs_5
4820,-1,2,m_sp_arch_4x1_bt_32_r201_m335,3,m_sp_arch_4x1_bt_32_roles_r500_m335,5_vs_5
4821,-1,3,m_sp_arch_4x1_bt_32_r201_m335,4,m_sp_arch_4x1_bt_32_roles_r500_m335,5_vs_5
4822,2,2,m_sp_arch_4x1_bt_32_r201_m335,0,m_sp_arch_4x1_bt_32_roles_r500_m335,5_vs_5
4823,0,2,m_sp_arch_4x1_bt_32_r201_m335,2,m_sp_arch_4x1_bt_32_roles_r500_m335,5_vs_5
4824,-1,2,m_sp_arch_4x1_bt_32_r201_m335,3,m_sp_arch_4x1_bt_32_roles_r500_m335,5_vs_5
4825,-3,1,m_sp_arch_4x1_bt_32_r201_m335,4,m_sp_arch_4x1_bt_32_roles_r500_m335,5_vs_5
4826,-1,2,m_sp_arch_4x1_bt_32_r201_m335,3,m_sp_arch_4x1_bt_32_roles_r500_m335,5_vs_5
4827,-2,0,m_sp_arch_4x1_bt_32_r201_m335,2,m_sp_arch_4x1_bt_32_roles_r500_m335,5_vs_5
4828,-1,0,m_sp_arch_4x1_bt_32_r201_m335,1,m_sp_arch_4x1_bt_32_roles_r500_m335,5_vs_5
4829,0,1,m_sp_arch_4x1_bt_32_r201_m335,1,m_sp_arch_4x1_bt_32_roles_r500_m335,5_vs_5
4830,2,4,scon_e3_p2_hard_ckpt840,2,easy_bots,5_vs_5
4831,4,7,scon_e3_p2_hard_ckpt840,3,easy_bots,5_vs_5
4832,10,10,scon_e3_p2_hard_ckpt840,0,easy_bots,5_vs_5
4833,8,10,scon_e3_p2_hard_ckpt840,2,easy_bots,5_vs_5
4834,12,12,scon_e3_p2_hard_ckpt840,0,easy_bots,5_vs_5
4835,7,9,scon_e3_p2_hard_ckpt840,2,easy_bots,5_vs_5
4836,7,7,scon_e3_p2_hard_ckpt840,0,easy_bots,5_vs_5
4837,10,10,scon_e3_p2_hard_ckpt840,0,easy_bots,5_vs_5
4838,5,7,scon_e3_p2_hard_ckpt840,2,easy_bots,5_vs_5
4839,8,9,scon_e3_p2_hard_ckpt840,1,easy_bots,5_vs_5
4840,12,12,scon_e3_p2_hard_ckpt840,0,easy_bots,5_vs_5
4841,9,10,scon_e3_p2_hard_ckpt840,1,easy_bots,5_vs_5
4842,11,12,scon_e3_p2_hard_ckpt840,1,easy_bots,5_vs_5
4843,12,12,scon_e3_p2_hard_ckpt840,0,easy_bots,5_vs_5
4844,7,8,scon_e3_p2_hard_ckpt840,1,easy_bots,5_vs_5
4845,6,9,scon_e3_p2_hard_ckpt840,3,easy_bots,5_vs_5
4846,5,6,scon_e3_p2_hard_ckpt840,1,easy_bots,5_vs_5
4847,9,9,scon_e3_p2_hard_ckpt840,0,easy_bots,5_vs_5
4848,8,10,scon_e3_p2_hard_ckpt840,2,easy_bots,5_vs_5
4849,6,8,scon_e3_p2_hard_ckpt840,2,easy_bots,5_vs_5
4850,7,8,scon_e3_p2_hard_ckpt840,1,medium_bots,5_vs_5_medium
4851,8,8,scon_e3_p2_hard_ckpt840,0,medium_bots,5_vs_5_medium
4852,7,9,scon_e3_p2_hard_ckpt840,2,medium_bots,5_vs_5_medium
4853,8,9,scon_e3_p2_hard_ckpt840,1,medium_bots,5_vs_5_medium
4854,10,10,scon_e3_p2_hard_ckpt840,0,medium_bots,5_vs_5_medium
4855,8,10,scon_e3_p2_hard_ckpt840,2,medium_bots,5_vs_5_medium
4856,9,10,scon_e3_p2_hard_ckpt840,1,medium_bots,5_vs_5_medium
4857,13,13,scon_e3_p2_hard_ckpt840,0,medium_bots,5_vs_5_medium
4858,9,11,scon_e3_p2_hard_ckpt840,2,medium_bots,5_vs_5_medium
4859,3,5,scon_e3_p2_hard_ckpt840,2,medium_bots,5_vs_5_medium
4860,9,11,scon_e3_p2_hard_ckpt840,2,medium_bots,5_vs_5_medium
4861,10,10,scon_e3_p2_hard_ckpt840,0,medium_bots,5_vs_5_medium
4862,7,9,scon_e3_p2_hard_ckpt840,2,medium_bots,5_vs_5_medium
4863,12,13,scon_e3_p2_hard_ckpt840,1,medium_bots,5_vs_5_medium
4864,9,10,scon_e3_p2_hard_ckpt840,1,medium_bots,5_vs_5_medium
4865,8,9,scon_e3_p2_hard_ckpt840,1,medium_bots,5_vs_5_medium
4866,3,5,scon_e3_p2_hard_ckpt840,2,medium_bots,5_vs_5_medium
4867,7,9,scon_e3_p2_hard_ckpt840,2,medium_bots,5_vs_5_medium
4868,9,10,scon_e3_p2_hard_ckpt840,1,medium_bots,5_vs_5_medium
4869,13,14,scon_e3_p2_hard_ckpt840,1,medium_bots,5_vs_5_medium
4870,6,9,scon_e3_p2_hard_ckpt840,3,hard_bots,5_vs_5_hard
4871,8,9,scon_e3_p2_hard_ckpt840,1,hard_bots,5_vs_5_hard
4872,2,6,scon_e3_p2_hard_ckpt840,4,hard_bots,5_vs_5_hard
4873,4,4,scon_e3_p2_hard_ckpt840,0,hard_bots,5_vs_5_hard
4874,6,6,scon_e3_p2_hard_ckpt840,0,hard_bots,5_vs_5_hard
4875,3,6,scon_e3_p2_hard_ckpt840,3,hard_bots,5_vs_5_hard
4876,3,5,scon_e3_p2_hard_ckpt840,2,hard_bots,5_vs_5_hard
4877,2,5,scon_e3_p2_hard_ckpt840,3,hard_bots,5_vs_5_hard
4878,8,10,scon_e3_p2_hard_ckpt840,2,hard_bots,5_vs_5_hard
4879,7,8,scon_e3_p2_hard_ckpt840,1,hard_bots,5_vs_5_hard
4880,7,9,scon_e3_p2_hard_ckpt840,2,hard_bots,5_vs_5_hard
4881,7,9,scon_e3_p2_hard_ckpt840,2,hard_bots,5_vs_5_hard
4882,4,6,scon_e3_p2_hard_ckpt840,2,hard_bots,5_vs_5_hard
4883,11,12,scon_e3_p2_hard_ckpt840,1,hard_bots,5_vs_5_hard
4884,7,9,scon_e3_p2_hard_ckpt840,2,hard_bots,5_vs_5_hard
4885,7,9,scon_e3_p2_hard_ckpt840,2,hard_bots,5_vs_5_hard
4886,11,13,scon_e3_p2_hard_ckpt840,2,hard_bots,5_vs_5_hard
4887,13,13,scon_e3_p2_hard_ckpt840,0,hard_bots,5_vs_5_hard
4888,2,3,scon_e3_p2_hard_ckpt840,1,hard_bots,5_vs_5_hard
4889,9,10,scon_e3_p2_hard_ckpt840,1,hard_bots,5_vs_5_hard
4890,-3,1,scon_e3_p2_hard_ckpt840,4,f5v0to1to2t05_e2_ckpt291,5_vs_5
4891,-2,2,scon_e3_p2_hard_ckpt840,4,f5v0to1to2t05_e2_ckpt291,5_vs_5
4892,-1,1,scon_e3_p2_hard_ckpt840,2,f5v0to1to2t05_e2_ckpt291,5_vs_5
4893,-7,1,scon_e3_p2_hard_ckpt840,8,f5v0to1to2t05_e2_ckpt291,5_vs_5
4894,-2,0,scon_e3_p2_hard_ckpt840,2,f5v0to1to2t05_e2_ckpt291,5_vs_5
4895,-3,0,scon_e3_p2_hard_ckpt840,3,f5v0to1to2t05_e2_ckpt291,5_vs_5
4896,-1,0,scon_e3_p2_hard_ckpt840,1,f5v0to1to2t05_e2_ckpt291,5_vs_5
4897,-8,0,scon_e3_p2_hard_ckpt840,8,f5v0to1to2t05_e2_ckpt291,5_vs_5
4898,-7,0,scon_e3_p2_hard_ckpt840,7,f5v0to1to2t05_e2_ckpt291,5_vs_5
4899,1,4,scon_e3_p2_hard_ckpt840,3,f5v0to1to2t05_e2_ckpt291,5_vs_5
4900,-3,2,scon_e3_p2_hard_ckpt840,5,f5v0to1to5_e2_ckpt252,5_vs_5
4901,-3,2,scon_e3_p2_hard_ckpt840,5,f5v0to1to5_e2_ckpt252,5_vs_5
4902,-2,1,scon_e3_p2_hard_ckpt840,3,f5v0to1to5_e2_ckpt252,5_vs_5
4903,-2,2,scon_e3_p2_hard_ckpt840,4,f5v0to1to5_e2_ckpt252,5_vs_5
4904,-4,1,scon_e3_p2_hard_ckpt840,5,f5v0to1to5_e2_ckpt252,5_vs_5
4905,-1,1,scon_e3_p2_hard_ckpt840,2,f5v0to1to5_e2_ckpt252,5_vs_5
4906,0,3,scon_e3_p2_hard_ckpt840,3,f5v0to1to5_e2_ckpt252,5_vs_5
4907,0,5,scon_e3_p2_hard_ckpt840,5,f5v0to1to5_e2_ckpt252,5_vs_5
4908,-4,2,scon_e3_p2_hard_ckpt840,6,f5v0to1to5_e2_ckpt252,5_vs_5
4909,-2,3,scon_e3_p2_hard_ckpt840,5,f5v0to1to5_e2_ckpt252,5_vs_5
4910,-1,1,scon_e3_p2_hard_ckpt840,2,scon_e3_p2_hard_ckpt840,5_vs_5
4911,1,3,scon_e3_p2_hard_ckpt840,2,scon_e3_p2_hard_ckpt840,5_vs_5
4912,-3,0,scon_e3_p2_hard_ckpt840,3,scon_e3_p2_hard_ckpt840,5_vs_5
4913,2,3,scon_e3_p2_hard_ckpt840,1,scon_e3_p2_hard_ckpt840,5_vs_5
4914,-3,0,scon_e3_p2_hard_ckpt840,3,scon_e3_p2_hard_ckpt840,5_vs_5
4915,4,5,scon_e3_p2_hard_ckpt840,1,scon_e3_p2_hard_ckpt840,5_vs_5
4916,-2,2,scon_e3_p2_hard_ckpt840,4,scon_e3_p2_hard_ckpt840,5_vs_5
4917,-3,2,scon_e3_p2_hard_ckpt840,5,scon_e3_p2_hard_ckpt840,5_vs_5
4918,0,2,scon_e3_p2_hard_ckpt840,2,scon_e3_p2_hard_ckpt840,5_vs_5
4919,1,2,scon_e3_p2_hard_ckpt840,1,scon_e3_p2_hard_ckpt840,5_vs_5
4920,1,3,scon_e3_p2_hard_ckpt840,2,less_then_partially_randomized_checkpoints_bots_4_heads_38_ckpt108,5_vs_5
4921,-1,1,scon_e3_p2_hard_ckpt840,2,less_then_partially_randomized_checkpoints_bots_4_heads_38_ckpt108,5_vs_5
4922,1,4,scon_e3_p2_hard_ckpt840,3,less_then_partially_randomized_checkpoints_bots_4_heads_38_ckpt108,5_vs_5
4923,0,4,scon_e3_p2_hard_ckpt840,4,less_then_partially_randomized_checkpoints_bots_4_heads_38_ckpt108,5_vs_5
4924,5,6,scon_e3_p2_hard_ckpt840,1,less_then_partially_randomized_checkpoints_bots_4_heads_38_ckpt108,5_vs_5
4925,3,6,scon_e3_p2_hard_ckpt840,3,less_then_partially_randomized_checkpoints_bots_4_heads_38_ckpt108,5_vs_5
4926,-3,1,scon_e3_p2_hard_ckpt840,4,less_then_partially_randomized_checkpoints_bots_4_heads_38_ckpt108,5_vs_5
4927,-3,0,scon_e3_p2_hard_ckpt840,3,less_then_partially_randomized_checkpoints_bots_4_heads_38_ckpt108,5_vs_5
4928,-2,0,scon_e3_p2_hard_ckpt840,2,less_then_partially_randomized_checkpoints_bots_4_heads_38_ckpt108,5_vs_5
4929,1,3,scon_e3_p2_hard_ckpt840,2,less_then_partially_randomized_checkpoints_bots_4_heads_38_ckpt108,5_vs_5
4930,0,3,scon_e3_p2_hard_ckpt840,3,less_then_partially_randomized_entropy_checkpoints_bots_4_heads_39_ckpt109,5_vs_5
4931,-3,3,scon_e3_p2_hard_ckpt840,6,less_then_partially_randomized_entropy_checkpoints_bots_4_heads_39_ckpt109,5_vs_5
4932,1,3,scon_e3_p2_hard_ckpt840,2,less_then_partially_randomized_entropy_checkpoints_bots_4_heads_39_ckpt109,5_vs_5
4933,2,4,scon_e3_p2_hard_ckpt840,2,less_then_partially_randomized_entropy_checkpoints_bots_4_heads_39_ckpt109,5_vs_5
4934,-1,3,scon_e3_p2_hard_ckpt840,4,less_then_partially_randomized_entropy_checkpoints_bots_4_heads_39_ckpt109,5_vs_5
4935,1,3,scon_e3_p2_hard_ckpt840,2,less_then_partially_randomized_entropy_checkpoints_bots_4_heads_39_ckpt109,5_vs_5
4936,1,3,scon_e3_p2_hard_ckpt840,2,less_then_partially_randomized_entropy_checkpoints_bots_4_heads_39_ckpt109,5_vs_5
4937,2,5,scon_e3_p2_hard_ckpt840,3,less_then_partially_randomized_entropy_checkpoints_bots_4_heads_39_ckpt109,5_vs_5
4938,-4,1,scon_e3_p2_hard_ckpt840,5,less_then_partially_randomized_entropy_checkpoints_bots_4_heads_39_ckpt109,5_vs_5
4939,2,4,scon_e3_p2_hard_ckpt840,2,less_then_partially_randomized_entropy_checkpoints_bots_4_heads_39_ckpt109,5_vs_5
4940,3,3,scon_e3_p2_hard_ckpt840,0,reward_shaping_checkpoints_bots_4_heads_1_ckpt360,5_vs_5
4941,1,2,scon_e3_p2_hard_ckpt840,1,reward_shaping_checkpoints_bots_4_heads_1_ckpt360,5_vs_5
4942,2,3,scon_e3_p2_hard_ckpt840,1,reward_shaping_checkpoints_bots_4_heads_1_ckpt360,5_vs_5
4943,3,5,scon_e3_p2_hard_ckpt840,2,reward_shaping_checkpoints_bots_4_heads_1_ckpt360,5_vs_5
4944,0,1,scon_e3_p2_hard_ckpt840,1,reward_shaping_checkpoints_bots_4_heads_1_ckpt360,5_vs_5
4945,1,2,scon_e3_p2_hard_ckpt840,1,reward_shaping_checkpoints_bots_4_heads_1_ckpt360,5_vs_5
4946,-1,2,scon_e3_p2_hard_ckpt840,3,reward_shaping_checkpoints_bots_4_heads_1_ckpt360,5_vs_5
4947,0,1,scon_e3_p2_hard_ckpt840,1,reward_shaping_checkpoints_bots_4_heads_1_ckpt360,5_vs_5
4948,1,2,scon_e3_p2_hard_ckpt840,1,reward_shaping_checkpoints_bots_4_heads_1_ckpt360,5_vs_5
4949,0,2,scon_e3_p2_hard_ckpt840,2,reward_shaping_checkpoints_bots_4_heads_1_ckpt360,5_vs_5
4950,-9,1,scon_e3_p2_hard_ckpt840,10,checkpoints_selfplay_e9_sp_ckpt274,5_vs_5
4951,-8,2,scon_e3_p2_hard_ckpt840,10,checkpoints_selfplay_e9_sp_ckpt274,5_vs_5
4952,-7,0,scon_e3_p2_hard_ckpt840,7,checkpoints_selfplay_e9_sp_ckpt274,5_vs_5
4953,-6,1,scon_e3_p2_hard_ckpt840,7,checkpoints_selfplay_e9_sp_ckpt274,5_vs_5
4954,-8,1,scon_e3_p2_hard_ckpt840,9,checkpoints_selfplay_e9_sp_ckpt274,5_vs_5
4955,-6,0,scon_e3_p2_hard_ckpt840,6,checkpoints_selfplay_e9_sp_ckpt274,5_vs_5
4956,-7,1,scon_e3_p2_hard_ckpt840,8,checkpoints_selfplay_e9_sp_ckpt274,5_vs_5
4957,-12,0,scon_e3_p2_hard_ckpt840,12,checkpoints_selfplay_e9_sp_ckpt274,5_vs_5
4958,-7,0,scon_e3_p2_hard_ckpt840,7,checkpoints_selfplay_e9_sp_ckpt274,5_vs_5
4959,-7,1,scon_e3_p2_hard_ckpt840,8,checkpoints_selfplay_e9_sp_ckpt274,5_vs_5
4960,-4,0,scon_e3_p2_hard_ckpt840,4,checkpoints_sp_c_nb_e2_ckpt667,5_vs_5
4961,-6,0,scon_e3_p2_hard_ckpt840,6,checkpoints_sp_c_nb_e2_ckpt667,5_vs_5
4962,-2,0,scon_e3_p2_hard_ckpt840,2,checkpoints_sp_c_nb_e2_ckpt667,5_vs_5
4963,1,4,scon_e3_p2_hard_ckpt840,3,checkpoints_sp_c_nb_e2_ckpt667,5_vs_5
4964,-4,1,scon_e3_p2_hard_ckpt840,5,checkpoints_sp_c_nb_e2_ckpt667,5_vs_5
4965,-2,1,scon_e3_p2_hard_ckpt840,3,checkpoints_sp_c_nb_e2_ckpt667,5_vs_5
4966,-7,0,scon_e3_p2_hard_ckpt840,7,checkpoints_sp_c_nb_e2_ckpt667,5_vs_5
4967,-5,1,scon_e3_p2_hard_ckpt840,6,checkpoints_sp_c_nb_e2_ckpt667,5_vs_5
4968,-7,0,scon_e3_p2_hard_ckpt840,7,checkpoints_sp_c_nb_e2_ckpt667,5_vs_5
4969,-8,1,scon_e3_p2_hard_ckpt840,9,checkpoints_sp_c_nb_e2_ckpt667,5_vs_5
4970,2,2,scon_e3_p2_hard_ckpt840,0,scenario_curriculum_ckpt830,5_vs_5
4971,0,0,scon_e3_p2_hard_ckpt840,0,scenario_curriculum_ckpt830,5_vs_5
4972,4,4,scon_e3_p2_hard_ckpt840,0,scenario_curriculum_ckpt830,5_vs_5
4973,1,1,scon_e3_p2_hard_ckpt840,0,scenario_curriculum_ckpt830,5_vs_5
4974,2,2,scon_e3_p2_hard_ckpt840,0,scenario_curriculum_ckpt830,5_vs_5
4975,1,1,scon_e3_p2_hard_ckpt840,0,scenario_curriculum_ckpt830,5_vs_5
4976,3,3,scon_e3_p2_hard_ckpt840,0,scenario_curriculum_ckpt830,5_vs_5
4977,0,0,scon_e3_p2_hard_ckpt840,0,scenario_curriculum_ckpt830,5_vs_5
4978,1,1,scon_e3_p2_hard_ckpt840,0,scenario_curriculum_ckpt830,5_vs_5
4979,3,3,scon_e3_p2_hard_ckpt840,0,scenario_curriculum_ckpt830,5_vs_5
4980,-6,0,scon_e3_p2_hard_ckpt840,6,m_sp_arch_medium_heads_conv16_0_bt_32_r313_m335,5_vs_5
4981,-5,0,scon_e3_p2_hard_ckpt840,5,m_sp_arch_medium_heads_conv16_0_bt_32_r313_m335,5_vs_5
4982,-4,0,scon_e3_p2_hard_ckpt840,4,m_sp_arch_medium_heads_conv16_0_bt_32_r313_m335,5_vs_5
4983,-4,0,scon_e3_p2_hard_ckpt840,4,m_sp_arch_medium_heads_conv16_0_bt_32_r313_m335,5_vs_5
4984,-3,1,scon_e3_p2_hard_ckpt840,4,m_sp_arch_medium_heads_conv16_0_bt_32_r313_m335,5_vs_5
4985,-2,1,scon_e3_p2_hard_ckpt840,3,m_sp_arch_medium_heads_conv16_0_bt_32_r313_m335,5_vs_5
4986,0,0,scon_e3_p2_hard_ckpt840,0,m_sp_arch_medium_heads_conv16_0_bt_32_r313_m335,5_vs_5
4987,-6,0,scon_e3_p2_hard_ckpt840,6,m_sp_arch_medium_heads_conv16_0_bt_32_r313_m335,5_vs_5
4988,-2,2,scon_e3_p2_hard_ckpt840,4,m_sp_arch_medium_heads_conv16_0_bt_32_r313_m335,5_vs_5
4989,-1,3,scon_e3_p2_hard_ckpt840,4,m_sp_arch_medium_heads_conv16_0_bt_32_r313_m335,5_vs_5
4990,-6,0,scon_e3_p2_hard_ckpt840,6,m_sp_arch_longer_heads_bt_32_r201_m335,5_vs_5
4991,-5,1,scon_e3_p2_hard_ckpt840,6,m_sp_arch_longer_heads_bt_32_r201_m335,5_vs_5
4992,-8,0,scon_e3_p2_hard_ckpt840,8,m_sp_arch_longer_heads_bt_32_r201_m335,5_vs_5
4993,-6,1,scon_e3_p2_hard_ckpt840,7,m_sp_arch_longer_heads_bt_32_r201_m335,5_vs_5
4994,-4,1,scon_e3_p2_hard_ckpt840,5,m_sp_arch_longer_heads_bt_32_r201_m335,5_vs_5
4995,-6,0,scon_e3_p2_hard_ckpt840,6,m_sp_arch_longer_heads_bt_32_r201_m335,5_vs_5
4996,-5,1,scon_e3_p2_hard_ckpt840,6,m_sp_arch_longer_heads_bt_32_r201_m335,5_vs_5
4997,-5,0,scon_e3_p2_hard_ckpt840,5,m_sp_arch_longer_heads_bt_32_r201_m335,5_vs_5
4998,-9,0,scon_e3_p2_hard_ckpt840,9,m_sp_arch_longer_heads_bt_32_r201_m335,5_vs_5
4999,-5,0,scon_e3_p2_hard_ckpt840,5,m_sp_arch_longer_heads_bt_32_r201_m335,5_vs_5
5000,-7,0,scon_e3_p2_hard_ckpt840,7,m_sp_arch_medium_heads_bt_32_r201_m335,5_vs_5
5001,-3,1,scon_e3_p2_hard_ckpt840,4,m_sp_arch_medium_heads_bt_32_r201_m335,5_vs_5
5002,-6,0,scon_e3_p2_hard_ckpt840,6,m_sp_arch_medium_heads_bt_32_r201_m335,5_vs_5
5003,-4,0,scon_e3_p2_hard_ckpt840,4,m_sp_arch_medium_heads_bt_32_r201_m335,5_vs_5
5004,-4,1,scon_e3_p2_hard_ckpt840,5,m_sp_arch_medium_heads_bt_32_r201_m335,5_vs_5
5005,-4,1,scon_e3_p2_hard_ckpt840,5,m_sp_arch_medium_heads_bt_32_r201_m335,5_vs_5
5006,-4,0,scon_e3_p2_hard_ckpt840,4,m_sp_arch_medium_heads_bt_32_r201_m335,5_vs_5
5007,-7,0,scon_e3_p2_hard_ckpt840,7,m_sp_arch_medium_heads_bt_32_r201_m335,5_vs_5
5008,-3,1,scon_e3_p2_hard_ckpt840,4,m_sp_arch_medium_heads_bt_32_r201_m335,5_vs_5
5009,-10,0,scon_e3_p2_hard_ckpt840,10,m_sp_arch_medium_heads_bt_32_r201_m335,5_vs_5
5010,-14,0,scon_e3_p2_hard_ckpt840,14,m_sp_arch_4x1_bt_32_r201_m335,5_vs_5
5011,-13,0,scon_e3_p2_hard_ckpt840,13,m_sp_arch_4x1_bt_32_r201_m335,5_vs_5
5012,-7,0,scon_e3_p2_hard_ckpt840,7,m_sp_arch_4x1_bt_32_r201_m335,5_vs_5
5013,-10,0,scon_e3_p2_hard_ckpt840,10,m_sp_arch_4x1_bt_32_r201_m335,5_vs_5
5014,-16,1,scon_e3_p2_hard_ckpt840,17,m_sp_arch_4x1_bt_32_r201_m335,5_vs_5
5015,-12,0,scon_e3_p2_hard_ckpt840,12,m_sp_arch_4x1_bt_32_r201_m335,5_vs_5
5016,-11,0,scon_e3_p2_hard_ckpt840,11,m_sp_arch_4x1_bt_32_r201_m335,5_vs_5
5017,-11,0,scon_e3_p2_hard_ckpt840,11,m_sp_arch_4x1_bt_32_r201_m335,5_vs_5
5018,-10,0,scon_e3_p2_hard_ckpt840,10,m_sp_arch_4x1_bt_32_r201_m335,5_vs_5
5019,-9,0,scon_e3_p2_hard_ckpt840,9,m_sp_arch_4x1_bt_32_r201_m335,5_vs_5
5020,-12,0,scon_e3_p2_hard_ckpt840,12,m_sp_arch_4x1_bt_32_r201_cont3_m650,5_vs_5
5021,-8,0,scon_e3_p2_hard_ckpt840,8,m_sp_arch_4x1_bt_32_r201_cont3_m650,5_vs_5
5022,-9,1,scon_e3_p2_hard_ckpt840,10,m_sp_arch_4x1_bt_32_r201_cont3_m650,5_vs_5
5023,-9,0,scon_e3_p2_hard_ckpt840,9,m_sp_arch_4x1_bt_32_r201_cont3_m650,5_vs_5
5024,-7,0,scon_e3_p2_hard_ckpt840,7,m_sp_arch_4x1_bt_32_r201_cont3_m650,5_vs_5
5025,-9,0,scon_e3_p2_hard_ckpt840,9,m_sp_arch_4x1_bt_32_r201_cont3_m650,5_vs_5
5026,-14,0,scon_e3_p2_hard_ckpt840,14,m_sp_arch_4x1_bt_32_r201_cont3_m650,5_vs_5
5027,-13,0,scon_e3_p2_hard_ckpt840,13,m_sp_arch_4x1_bt_32_r201_cont3_m650,5_vs_5
5028,-10,0,scon_e3_p2_hard_ckpt840,10,m_sp_arch_4x1_bt_32_r201_cont3_m650,5_vs_5
5029,-16,0,scon_e3_p2_hard_ckpt840,16,m_sp_arch_4x1_bt_32_r201_cont3_m650,5_vs_5
5030,-1,0,scon_e3_p2_hard_ckpt840,1,explt_v0_7_2_m54,5_vs_5
5031,-2,0,scon_e3_p2_hard_ckpt840,2,explt_v0_7_2_m54,5_vs_5
5032,-3,0,scon_e3_p2_hard_ckpt840,3,explt_v0_7_2_m54,5_vs_5
5033,-3,0,scon_e3_p2_hard_ckpt840,3,explt_v0_7_2_m54,5_vs_5
5034,-4,0,scon_e3_p2_hard_ckpt840,4,explt_v0_7_2_m54,5_vs_5
5035,-1,0,scon_e3_p2_hard_ckpt840,1,explt_v0_7_2_m54,5_vs_5
5036,-4,0,scon_e3_p2_hard_ckpt840,4,explt_v0_7_2_m54,5_vs_5
5037,-1,0,scon_e3_p2_hard_ckpt840,1,explt_v0_7_2_m54,5_vs_5
5038,-3,0,scon_e3_p2_hard_ckpt840,3,explt_v0_7_2_m54,5_vs_5
5039,-2,0,scon_e3_p2_hard_ckpt840,2,explt_v0_7_2_m54,5_vs_5
5040,-12,1,scon_e3_p2_hard_ckpt840,13,m_sp_sc3v3_arch_2x1_32_r500_cont4x1_m224,5_vs_5
5041,-13,0,scon_e3_p2_hard_ckpt840,13,m_sp_sc3v3_arch_2x1_32_r500_cont4x1_m224,5_vs_5
5042,-8,0,scon_e3_p2_hard_ckpt840,8,m_sp_sc3v3_arch_2x1_32_r500_cont4x1_m224,5_vs_5
5043,-13,0,scon_e3_p2_hard_ckpt840,13,m_sp_sc3v3_arch_2x1_32_r500_cont4x1_m224,5_vs_5
5044,-9,0,scon_e3_p2_hard_ckpt840,9,m_sp_sc3v3_arch_2x1_32_r500_cont4x1_m224,5_vs_5
5045,-8,1,scon_e3_p2_hard_ckpt840,9,m_sp_sc3v3_arch_2x1_32_r500_cont4x1_m224,5_vs_5
5046,-6,0,scon_e3_p2_hard_ckpt840,6,m_sp_sc3v3_arch_2x1_32_r500_cont4x1_m224,5_vs_5
5047,-14,0,scon_e3_p2_hard_ckpt840,14,m_sp_sc3v3_arch_2x1_32_r500_cont4x1_m224,5_vs_5
5048,-11,0,scon_e3_p2_hard_ckpt840,11,m_sp_sc3v3_arch_2x1_32_r500_cont4x1_m224,5_vs_5
5049,-10,0,scon_e3_p2_hard_ckpt840,10,m_sp_sc3v3_arch_2x1_32_r500_cont4x1_m224,5_vs_5
5050,-11,0,scon_e3_p2_hard_ckpt840,11,m_sp_arch_4x1_bt_32_roles_r500_m335,5_vs_5
5051,-11,0,scon_e3_p2_hard_ckpt840,11,m_sp_arch_4x1_bt_32_roles_r500_m335,5_vs_5
5052,-12,0,scon_e3_p2_hard_ckpt840,12,m_sp_arch_4x1_bt_32_roles_r500_m335,5_vs_5
5053,-13,0,scon_e3_p2_hard_ckpt840,13,m_sp_arch_4x1_bt_32_roles_r500_m335,5_vs_5
5054,-10,1,scon_e3_p2_hard_ckpt840,11,m_sp_arch_4x1_bt_32_roles_r500_m335,5_vs_5
5055,-17,0,scon_e3_p2_hard_ckpt840,17,m_sp_arch_4x1_bt_32_roles_r500_m335,5_vs_5
5056,-14,0,scon_e3_p2_hard_ckpt840,14,m_sp_arch_4x1_bt_32_roles_r500_m335,5_vs_5
5057,-10,0,scon_e3_p2_hard_ckpt840,10,m_sp_arch_4x1_bt_32_roles_r500_m335,5_vs_5
5058,-14,1,scon_e3_p2_hard_ckpt840,15,m_sp_arch_4x1_bt_32_roles_r500_m335,5_vs_5
5059,-15,1,scon_e3_p2_hard_ckpt840,16,m_sp_arch_4x1_bt_32_roles_r500_m335,5_vs_5
5060,-2,1,m_sp_arch_medium_heads_conv16_0_bt_32_r313_m288_1370M,3,easy_bots,5_vs_5
5061,-1,1,m_sp_arch_medium_heads_conv16_0_bt_32_r313_m288_1370M,2,easy_bots,5_vs_5
5062,1,1,m_sp_arch_medium_heads_conv16_0_bt_32_r313_m288_1370M,0,easy_bots,5_vs_5
5063,-3,0,m_sp_arch_medium_heads_conv16_0_bt_32_r313_m288_1370M,3,easy_bots,5_vs_5
5064,0,2,m_sp_arch_medium_heads_conv16_0_bt_32_r313_m288_1370M,2,easy_bots,5_vs_5
5065,-1,1,m_sp_arch_medium_heads_conv16_0_bt_32_r313_m288_1370M,2,easy_bots,5_vs_5
5066,1,1,m_sp_arch_medium_heads_conv16_0_bt_32_r313_m288_1370M,0,easy_bots,5_vs_5
5067,1,1,m_sp_arch_medium_heads_conv16_0_bt_32_r313_m288_1370M,0,easy_bots,5_vs_5
5068,1,1,m_sp_arch_medium_heads_conv16_0_bt_32_r313_m288_1370M,0,easy_bots,5_vs_5
5069,-1,1,m_sp_arch_medium_heads_conv16_0_bt_32_r313_m288_1370M,2,easy_bots,5_vs_5
5070,0,1,m_sp_arch_medium_heads_conv16_0_bt_32_r313_m288_1370M,1,easy_bots,5_vs_5
5071,-5,1,m_sp_arch_medium_heads_conv16_0_bt_32_r313_m288_1370M,6,easy_bots,5_vs_5
5072,-2,1,m_sp_arch_medium_heads_conv16_0_bt_32_r313_m288_1370M,3,easy_bots,5_vs_5
5073,-3,0,m_sp_arch_medium_heads_conv16_0_bt_32_r313_m288_1370M,3,easy_bots,5_vs_5
5074,3,4,m_sp_arch_medium_heads_conv16_0_bt_32_r313_m288_1370M,1,easy_bots,5_vs_5
5075,0,0,m_sp_arch_medium_heads_conv16_0_bt_32_r313_m288_1370M,0,easy_bots,5_vs_5
5076,3,4,m_sp_arch_medium_heads_conv16_0_bt_32_r313_m288_1370M,1,easy_bots,5_vs_5
5077,0,0,m_sp_arch_medium_heads_conv16_0_bt_32_r313_m288_1370M,0,easy_bots,5_vs_5
5078,2,3,m_sp_arch_medium_heads_conv16_0_bt_32_r313_m288_1370M,1,easy_bots,5_vs_5
5079,0,0,m_sp_arch_medium_heads_conv16_0_bt_32_r313_m288_1370M,0,easy_bots,5_vs_5
5080,0,1,m_sp_arch_medium_heads_conv16_0_bt_32_r313_m288_1370M,1,medium_bots,5_vs_5_medium
5081,1,1,m_sp_arch_medium_heads_conv16_0_bt_32_r313_m288_1370M,0,medium_bots,5_vs_5_medium
5082,-1,1,m_sp_arch_medium_heads_conv16_0_bt_32_r313_m288_1370M,2,medium_bots,5_vs_5_medium
5083,-1,0,m_sp_arch_medium_heads_conv16_0_bt_32_r313_m288_1370M,1,medium_bots,5_vs_5_medium
5084,-3,1,m_sp_arch_medium_heads_conv16_0_bt_32_r313_m288_1370M,4,medium_bots,5_vs_5_medium
5085,-6,0,m_sp_arch_medium_heads_conv16_0_bt_32_r313_m288_1370M,6,medium_bots,5_vs_5_medium
5086,-3,0,m_sp_arch_medium_heads_conv16_0_bt_32_r313_m288_1370M,3,medium_bots,5_vs_5_medium
5087,-2,0,m_sp_arch_medium_heads_conv16_0_bt_32_r313_m288_1370M,2,medium_bots,5_vs_5_medium
5088,-1,1,m_sp_arch_medium_heads_conv16_0_bt_32_r313_m288_1370M,2,medium_bots,5_vs_5_medium
5089,-2,1,m_sp_arch_medium_heads_conv16_0_bt_32_r313_m288_1370M,3,medium_bots,5_vs_5_medium
5090,1,1,m_sp_arch_medium_heads_conv16_0_bt_32_r313_m288_1370M,0,medium_bots,5_vs_5_medium
5091,-1,0,m_sp_arch_medium_heads_conv16_0_bt_32_r313_m288_1370M,1,medium_bots,5_vs_5_medium
5092,-3,0,m_sp_arch_medium_heads_conv16_0_bt_32_r313_m288_1370M,3,medium_bots,5_vs_5_medium
5093,-2,0,m_sp_arch_medium_heads_conv16_0_bt_32_r313_m288_1370M,2,medium_bots,5_vs_5_medium
5094,-3,0,m_sp_arch_medium_heads_conv16_0_bt_32_r313_m288_1370M,3,medium_bots,5_vs_5_medium
5095,-4,0,m_sp_arch_medium_heads_conv16_0_bt_32_r313_m288_1370M,4,medium_bots,5_vs_5_medium
5096,-3,0,m_sp_arch_medium_heads_conv16_0_bt_32_r313_m288_1370M,3,medium_bots,5_vs_5_medium
5097,-2,0,m_sp_arch_medium_heads_conv16_0_bt_32_r313_m288_1370M,2,medium_bots,5_vs_5_medium
5098,-1,2,m_sp_arch_medium_heads_conv16_0_bt_32_r313_m288_1370M,3,medium_bots,5_vs_5_medium
5099,-2,1,m_sp_arch_medium_heads_conv16_0_bt_32_r313_m288_1370M,3,medium_bots,5_vs_5_medium
5100,-4,0,m_sp_arch_medium_heads_conv16_0_bt_32_r313_m288_1370M,4,hard_bots,5_vs_5_hard
5101,-4,0,m_sp_arch_medium_heads_conv16_0_bt_32_r313_m288_1370M,4,hard_bots,5_vs_5_hard
5102,-3,0,m_sp_arch_medium_heads_conv16_0_bt_32_r313_m288_1370M,3,hard_bots,5_vs_5_hard
5103,-3,0,m_sp_arch_medium_heads_conv16_0_bt_32_r313_m288_1370M,3,hard_bots,5_vs_5_hard
5104,-2,0,m_sp_arch_medium_heads_conv16_0_bt_32_r313_m288_1370M,2,hard_bots,5_vs_5_hard
5105,-4,1,m_sp_arch_medium_heads_conv16_0_bt_32_r313_m288_1370M,5,hard_bots,5_vs_5_hard
5106,-2,1,m_sp_arch_medium_heads_conv16_0_bt_32_r313_m288_1370M,3,hard_bots,5_vs_5_hard
5107,-2,0,m_sp_arch_medium_heads_conv16_0_bt_32_r313_m288_1370M,2,hard_bots,5_vs_5_hard
5108,1,3,m_sp_arch_medium_heads_conv16_0_bt_32_r313_m288_1370M,2,hard_bots,5_vs_5_hard
5109,0,1,m_sp_arch_medium_heads_conv16_0_bt_32_r313_m288_1370M,1,hard_bots,5_vs_5_hard
5110,-2,0,m_sp_arch_medium_heads_conv16_0_bt_32_r313_m288_1370M,2,hard_bots,5_vs_5_hard
5111,-2,0,m_sp_arch_medium_heads_conv16_0_bt_32_r313_m288_1370M,2,hard_bots,5_vs_5_hard
5112,0,1,m_sp_arch_medium_heads_conv16_0_bt_32_r313_m288_1370M,1,hard_bots,5_vs_5_hard
5113,0,0,m_sp_arch_medium_heads_conv16_0_bt_32_r313_m288_1370M,0,hard_bots,5_vs_5_hard
5114,-1,2,m_sp_arch_medium_heads_conv16_0_bt_32_r313_m288_1370M,3,hard_bots,5_vs_5_hard
5115,0,0,m_sp_arch_medium_heads_conv16_0_bt_32_r313_m288_1370M,0,hard_bots,5_vs_5_hard
5116,-3,0,m_sp_arch_medium_heads_conv16_0_bt_32_r313_m288_1370M,3,hard_bots,5_vs_5_hard
5117,-2,1,m_sp_arch_medium_heads_conv16_0_bt_32_r313_m288_1370M,3,hard_bots,5_vs_5_hard
5118,-4,0,m_sp_arch_medium_heads_conv16_0_bt_32_r313_m288_1370M,4,hard_bots,5_vs_5_hard
5119,-1,0,m_sp_arch_medium_heads_conv16_0_bt_32_r313_m288_1370M,1,hard_bots,5_vs_5_hard
5120,-1,2,m_sp_arch_medium_heads_conv16_0_bt_32_r313_m288_1370M,3,f5v0to1to2t05_e2_ckpt291,5_vs_5
5121,0,3,m_sp_arch_medium_heads_conv16_0_bt_32_r313_m288_1370M,3,f5v0to1to2t05_e2_ckpt291,5_vs_5
5122,2,6,m_sp_arch_medium_heads_conv16_0_bt_32_r313_m288_1370M,4,f5v0to1to2t05_e2_ckpt291,5_vs_5
5123,-2,1,m_sp_arch_medium_heads_conv16_0_bt_32_r313_m288_1370M,3,f5v0to1to2t05_e2_ckpt291,5_vs_5
5124,1,3,m_sp_arch_medium_heads_conv16_0_bt_32_r313_m288_1370M,2,f5v0to1to2t05_e2_ckpt291,5_vs_5
5125,1,2,m_sp_arch_medium_heads_conv16_0_bt_32_r313_m288_1370M,1,f5v0to1to2t05_e2_ckpt291,5_vs_5
5126,2,4,m_sp_arch_medium_heads_conv16_0_bt_32_r313_m288_1370M,2,f5v0to1to2t05_e2_ckpt291,5_vs_5
5127,2,4,m_sp_arch_medium_heads_conv16_0_bt_32_r313_m288_1370M,2,f5v0to1to2t05_e2_ckpt291,5_vs_5
5128,0,2,m_sp_arch_medium_heads_conv16_0_bt_32_r313_m288_1370M,2,f5v0to1to2t05_e2_ckpt291,5_vs_5
5129,3,4,m_sp_arch_medium_heads_conv16_0_bt_32_r313_m288_1370M,1,f5v0to1to2t05_e2_ckpt291,5_vs_5
5130,1,4,m_sp_arch_medium_heads_conv16_0_bt_32_r313_m288_1370M,3,f5v0to1to2t05_e2_ckpt291,5_vs_5
5131,4,5,m_sp_arch_medium_heads_conv16_0_bt_32_r313_m288_1370M,1,f5v0to1to2t05_e2_ckpt291,5_vs_5
5132,-1,1,m_sp_arch_medium_heads_conv16_0_bt_32_r313_m288_1370M,2,f5v0to1to2t05_e2_ckpt291,5_vs_5
5133,-2,2,m_sp_arch_medium_heads_conv16_0_bt_32_r313_m288_1370M,4,f5v0to1to2t05_e2_ckpt291,5_vs_5
5134,-1,1,m_sp_arch_medium_heads_conv16_0_bt_32_r313_m288_1370M,2,f5v0to1to2t05_e2_ckpt291,5_vs_5
5135,1,2,m_sp_arch_medium_heads_conv16_0_bt_32_r313_m288_1370M,1,f5v0to1to2t05_e2_ckpt291,5_vs_5
5136,2,3,m_sp_arch_medium_heads_conv16_0_bt_32_r313_m288_1370M,1,f5v0to1to2t05_e2_ckpt291,5_vs_5
5137,4,7,m_sp_arch_medium_heads_conv16_0_bt_32_r313_m288_1370M,3,f5v0to1to2t05_e2_ckpt291,5_vs_5
5138,0,4,m_sp_arch_medium_heads_conv16_0_bt_32_r313_m288_1370M,4,f5v0to1to2t05_e2_ckpt291,5_vs_5
5139,-2,1,m_sp_arch_medium_heads_conv16_0_bt_32_r313_m288_1370M,3,f5v0to1to2t05_e2_ckpt291,5_vs_5
5140,2,2,m_sp_arch_medium_heads_conv16_0_bt_32_r313_m288_1370M,0,f5v0to1to5_e2_ckpt252,5_vs_5
5141,1,4,m_sp_arch_medium_heads_conv16_0_bt_32_r313_m288_1370M,3,f5v0to1to5_e2_ckpt252,5_vs_5
5142,4,5,m_sp_arch_medium_heads_conv16_0_bt_32_r313_m288_1370M,1,f5v0to1to5_e2_ckpt252,5_vs_5
5143,4,4,m_sp_arch_medium_heads_conv16_0_bt_32_r313_m288_1370M,0,f5v0to1to5_e2_ckpt252,5_vs_5
5144,1,4,m_sp_arch_medium_heads_conv16_0_bt_32_r313_m288_1370M,3,f5v0to1to5_e2_ckpt252,5_vs_5
5145,-1,2,m_sp_arch_medium_heads_conv16_0_bt_32_r313_m288_1370M,3,f5v0to1to5_e2_ckpt252,5_vs_5
5146,1,2,m_sp_arch_medium_heads_conv16_0_bt_32_r313_m288_1370M,1,f5v0to1to5_e2_ckpt252,5_vs_5
5147,-1,2,m_sp_arch_medium_heads_conv16_0_bt_32_r313_m288_1370M,3,f5v0to1to5_e2_ckpt252,5_vs_5
5148,2,4,m_sp_arch_medium_heads_conv16_0_bt_32_r313_m288_1370M,2,f5v0to1to5_e2_ckpt252,5_vs_5
5149,2,4,m_sp_arch_medium_heads_conv16_0_bt_32_r313_m288_1370M,2,f5v0to1to5_e2_ckpt252,5_vs_5
5150,-2,1,m_sp_arch_medium_heads_conv16_0_bt_32_r313_m288_1370M,3,f5v0to1to5_e2_ckpt252,5_vs_5
5151,0,3,m_sp_arch_medium_heads_conv16_0_bt_32_r313_m288_1370M,3,f5v0to1to5_e2_ckpt252,5_vs_5
5152,0,2,m_sp_arch_medium_heads_conv16_0_bt_32_r313_m288_1370M,2,f5v0to1to5_e2_ckpt252,5_vs_5
5153,0,0,m_sp_arch_medium_heads_conv16_0_bt_32_r313_m288_1370M,0,f5v0to1to5_e2_ckpt252,5_vs_5
5154,0,3,m_sp_arch_medium_heads_conv16_0_bt_32_r313_m288_1370M,3,f5v0to1to5_e2_ckpt252,5_vs_5
5155,0,1,m_sp_arch_medium_heads_conv16_0_bt_32_r313_m288_1370M,1,f5v0to1to5_e2_ckpt252,5_vs_5
5156,4,5,m_sp_arch_medium_heads_conv16_0_bt_32_r313_m288_1370M,1,f5v0to1to5_e2_ckpt252,5_vs_5
5157,2,3,m_sp_arch_medium_heads_conv16_0_bt_32_r313_m288_1370M,1,f5v0to1to5_e2_ckpt252,5_vs_5
5158,-1,2,m_sp_arch_medium_heads_conv16_0_bt_32_r313_m288_1370M,3,f5v0to1to5_e2_ckpt252,5_vs_5
5159,-1,2,m_sp_arch_medium_heads_conv16_0_bt_32_r313_m288_1370M,3,f5v0to1to5_e2_ckpt252,5_vs_5
5160,1,2,m_sp_arch_medium_heads_conv16_0_bt_32_r313_m288_1370M,1,scon_e3_p2_hard_ckpt840,5_vs_5
5161,4,5,m_sp_arch_medium_heads_conv16_0_bt_32_r313_m288_1370M,1,scon_e3_p2_hard_ckpt840,5_vs_5
5162,4,5,m_sp_arch_medium_heads_conv16_0_bt_32_r313_m288_1370M,1,scon_e3_p2_hard_ckpt840,5_vs_5
5163,5,6,m_sp_arch_medium_heads_conv16_0_bt_32_r313_m288_1370M,1,scon_e3_p2_hard_ckpt840,5_vs_5
5164,2,3,m_sp_arch_medium_heads_conv16_0_bt_32_r313_m288_1370M,1,scon_e3_p2_hard_ckpt840,5_vs_5
5165,5,5,m_sp_arch_medium_heads_conv16_0_bt_32_r313_m288_1370M,0,scon_e3_p2_hard_ckpt840,5_vs_5
5166,4,6,m_sp_arch_medium_heads_conv16_0_bt_32_r313_m288_1370M,2,scon_e3_p2_hard_ckpt840,5_vs_5
5167,3,3,m_sp_arch_medium_heads_conv16_0_bt_32_r313_m288_1370M,0,scon_e3_p2_hard_ckpt840,5_vs_5
5168,5,5,m_sp_arch_medium_heads_conv16_0_bt_32_r313_m288_1370M,0,scon_e3_p2_hard_ckpt840,5_vs_5
5169,5,5,m_sp_arch_medium_heads_conv16_0_bt_32_r313_m288_1370M,0,scon_e3_p2_hard_ckpt840,5_vs_5
5170,4,5,m_sp_arch_medium_heads_conv16_0_bt_32_r313_m288_1370M,1,scon_e3_p2_hard_ckpt840,5_vs_5
5171,6,6,m_sp_arch_medium_heads_conv16_0_bt_32_r313_m288_1370M,0,scon_e3_p2_hard_ckpt840,5_vs_5
5172,0,1,m_sp_arch_medium_heads_conv16_0_bt_32_r313_m288_1370M,1,scon_e3_p2_hard_ckpt840,5_vs_5
5173,2,2,m_sp_arch_medium_heads_conv16_0_bt_32_r313_m288_1370M,0,scon_e3_p2_hard_ckpt840,5_vs_5
5174,9,10,m_sp_arch_medium_heads_conv16_0_bt_32_r313_m288_1370M,1,scon_e3_p2_hard_ckpt840,5_vs_5
5175,4,5,m_sp_arch_medium_heads_conv16_0_bt_32_r313_m288_1370M,1,scon_e3_p2_hard_ckpt840,5_vs_5
5176,4,4,m_sp_arch_medium_heads_conv16_0_bt_32_r313_m288_1370M,0,scon_e3_p2_hard_ckpt840,5_vs_5
5177,2,2,m_sp_arch_medium_heads_conv16_0_bt_32_r313_m288_1370M,0,scon_e3_p2_hard_ckpt840,5_vs_5
5178,6,6,m_sp_arch_medium_heads_conv16_0_bt_32_r313_m288_1370M,0,scon_e3_p2_hard_ckpt840,5_vs_5
5179,5,5,m_sp_arch_medium_heads_conv16_0_bt_32_r313_m288_1370M,0,scon_e3_p2_hard_ckpt840,5_vs_5
5180,4,5,m_sp_arch_medium_heads_conv16_0_bt_32_r313_m288_1370M,1,less_then_partially_randomized_checkpoints_bots_4_heads_38_ckpt108,5_vs_5
5181,4,6,m_sp_arch_medium_heads_conv16_0_bt_32_r313_m288_1370M,2,less_then_partially_randomized_checkpoints_bots_4_heads_38_ckpt108,5_vs_5
5182,2,4,m_sp_arch_medium_heads_conv16_0_bt_32_r313_m288_1370M,2,less_then_partially_randomized_checkpoints_bots_4_heads_38_ckpt108,5_vs_5
5183,2,4,m_sp_arch_medium_heads_conv16_0_bt_32_r313_m288_1370M,2,less_then_partially_randomized_checkpoints_bots_4_heads_38_ckpt108,5_vs_5
5184,2,5,m_sp_arch_medium_heads_conv16_0_bt_32_r313_m288_1370M,3,less_then_partially_randomized_checkpoints_bots_4_heads_38_ckpt108,5_vs_5
5185,5,5,m_sp_arch_medium_heads_conv16_0_bt_32_r313_m288_1370M,0,less_then_partially_randomized_checkpoints_bots_4_heads_38_ckpt108,5_vs_5
5186,4,5,m_sp_arch_medium_heads_conv16_0_bt_32_r313_m288_1370M,1,less_then_partially_randomized_checkpoints_bots_4_heads_38_ckpt108,5_vs_5
5187,2,2,m_sp_arch_medium_heads_conv16_0_bt_32_r313_m288_1370M,0,less_then_partially_randomized_checkpoints_bots_4_heads_38_ckpt108,5_vs_5
5188,3,5,m_sp_arch_medium_heads_conv16_0_bt_32_r313_m288_1370M,2,less_then_partially_randomized_checkpoints_bots_4_heads_38_ckpt108,5_vs_5
5189,0,3,m_sp_arch_medium_heads_conv16_0_bt_32_r313_m288_1370M,3,less_then_partially_randomized_checkpoints_bots_4_heads_38_ckpt108,5_vs_5
5190,3,4,m_sp_arch_medium_heads_conv16_0_bt_32_r313_m288_1370M,1,less_then_partially_randomized_checkpoints_bots_4_heads_38_ckpt108,5_vs_5
5191,4,5,m_sp_arch_medium_heads_conv16_0_bt_32_r313_m288_1370M,1,less_then_partially_randomized_checkpoints_bots_4_heads_38_ckpt108,5_vs_5
5192,3,5,m_sp_arch_medium_heads_conv16_0_bt_32_r313_m288_1370M,2,less_then_partially_randomized_checkpoints_bots_4_heads_38_ckpt108,5_vs_5
5193,2,3,m_sp_arch_medium_heads_conv16_0_bt_32_r313_m288_1370M,1,less_then_partially_randomized_checkpoints_bots_4_heads_38_ckpt108,5_vs_5
5194,1,4,m_sp_arch_medium_heads_conv16_0_bt_32_r313_m288_1370M,3,less_then_partially_randomized_checkpoints_bots_4_heads_38_ckpt108,5_vs_5
5195,2,4,m_sp_arch_medium_heads_conv16_0_bt_32_r313_m288_1370M,2,less_then_partially_randomized_checkpoints_bots_4_heads_38_ckpt108,5_vs_5
5196,0,3,m_sp_arch_medium_heads_conv16_0_bt_32_r313_m288_1370M,3,less_then_partially_randomized_checkpoints_bots_4_heads_38_ckpt108,5_vs_5
5197,3,4,m_sp_arch_medium_heads_conv16_0_bt_32_r313_m288_1370M,1,less_then_partially_randomized_checkpoints_bots_4_heads_38_ckpt108,5_vs_5
5198,3,4,m_sp_arch_medium_heads_conv16_0_bt_32_r313_m288_1370M,1,less_then_partially_randomized_checkpoints_bots_4_heads_38_ckpt108,5_vs_5
5199,4,5,m_sp_arch_medium_heads_conv16_0_bt_32_r313_m288_1370M,1,less_then_partially_randomized_checkpoints_bots_4_heads_38_ckpt108,5_vs_5
5200,1,2,m_sp_arch_medium_heads_conv16_0_bt_32_r313_m288_1370M,1,less_then_partially_randomized_entropy_checkpoints_bots_4_heads_39_ckpt109,5_vs_5
5201,1,3,m_sp_arch_medium_heads_conv16_0_bt_32_r313_m288_1370M,2,less_then_partially_randomized_entropy_checkpoints_bots_4_heads_39_ckpt109,5_vs_5
5202,2,5,m_sp_arch_medium_heads_conv16_0_bt_32_r313_m288_1370M,3,less_then_partially_randomized_entropy_checkpoints_bots_4_heads_39_ckpt109,5_vs_5
5203,1,4,m_sp_arch_medium_heads_conv16_0_bt_32_r313_m288_1370M,3,less_then_partially_randomized_entropy_checkpoints_bots_4_heads_39_ckpt109,5_vs_5
5204,-2,3,m_sp_arch_medium_heads_conv16_0_bt_32_r313_m288_1370M,5,less_then_partially_randomized_entropy_checkpoints_bots_4_heads_39_ckpt109,5_vs_5
5205,6,6,m_sp_arch_medium_heads_conv16_0_bt_32_r313_m288_1370M,0,less_then_partially_randomized_entropy_checkpoints_bots_4_heads_39_ckpt109,5_vs_5
5206,6,7,m_sp_arch_medium_heads_conv16_0_bt_32_r313_m288_1370M,1,less_then_partially_randomized_entropy_checkpoints_bots_4_heads_39_ckpt109,5_vs_5
5207,2,4,m_sp_arch_medium_heads_conv16_0_bt_32_r313_m288_1370M,2,less_then_partially_randomized_entropy_checkpoints_bots_4_heads_39_ckpt109,5_vs_5
5208,1,3,m_sp_arch_medium_heads_conv16_0_bt_32_r313_m288_1370M,2,less_then_partially_randomized_entropy_checkpoints_bots_4_heads_39_ckpt109,5_vs_5
5209,1,4,m_sp_arch_medium_heads_conv16_0_bt_32_r313_m288_1370M,3,less_then_partially_randomized_entropy_checkpoints_bots_4_heads_39_ckpt109,5_vs_5
5210,-2,2,m_sp_arch_medium_heads_conv16_0_bt_32_r313_m288_1370M,4,less_then_partially_randomized_entropy_checkpoints_bots_4_heads_39_ckpt109,5_vs_5
5211,3,4,m_sp_arch_medium_heads_conv16_0_bt_32_r313_m288_1370M,1,less_then_partially_randomized_entropy_checkpoints_bots_4_heads_39_ckpt109,5_vs_5
5212,1,3,m_sp_arch_medium_heads_conv16_0_bt_32_r313_m288_1370M,2,less_then_partially_randomized_entropy_checkpoints_bots_4_heads_39_ckpt109,5_vs_5
5213,1,3,m_sp_arch_medium_heads_conv16_0_bt_32_r313_m288_1370M,2,less_then_partially_randomized_entropy_checkpoints_bots_4_heads_39_ckpt109,5_vs_5
5214,3,6,m_sp_arch_medium_heads_conv16_0_bt_32_r313_m288_1370M,3,less_then_partially_randomized_entropy_checkpoints_bots_4_heads_39_ckpt109,5_vs_5
5215,0,1,m_sp_arch_medium_heads_conv16_0_bt_32_r313_m288_1370M,1,less_then_partially_randomized_entropy_checkpoints_bots_4_heads_39_ckpt109,5_vs_5
5216,2,3,m_sp_arch_medium_heads_conv16_0_bt_32_r313_m288_1370M,1,less_then_partially_randomized_entropy_checkpoints_bots_4_heads_39_ckpt109,5_vs_5
5217,1,4,m_sp_arch_medium_heads_conv16_0_bt_32_r313_m288_1370M,3,less_then_partially_randomized_entropy_checkpoints_bots_4_heads_39_ckpt109,5_vs_5
5218,3,4,m_sp_arch_medium_heads_conv16_0_bt_32_r313_m288_1370M,1,less_then_partially_randomized_entropy_checkpoints_bots_4_heads_39_ckpt109,5_vs_5
5219,5,6,m_sp_arch_medium_heads_conv16_0_bt_32_r313_m288_1370M,1,less_then_partially_randomized_entropy_checkpoints_bots_4_heads_39_ckpt109,5_vs_5
5220,1,3,m_sp_arch_medium_heads_conv16_0_bt_32_r313_m288_1370M,2,reward_shaping_checkpoints_bots_4_heads_1_ckpt360,5_vs_5
5221,-1,1,m_sp_arch_medium_heads_conv16_0_bt_32_r313_m288_1370M,2,reward_shaping_checkpoints_bots_4_heads_1_ckpt360,5_vs_5
5222,4,6,m_sp_arch_medium_heads_conv16_0_bt_32_r313_m288_1370M,2,reward_shaping_checkpoints_bots_4_heads_1_ckpt360,5_vs_5
5223,4,5,m_sp_arch_medium_heads_conv16_0_bt_32_r313_m288_1370M,1,reward_shaping_checkpoints_bots_4_heads_1_ckpt360,5_vs_5
5224,4,5,m_sp_arch_medium_heads_conv16_0_bt_32_r313_m288_1370M,1,reward_shaping_checkpoints_bots_4_heads_1_ckpt360,5_vs_5
5225,2,2,m_sp_arch_medium_heads_conv16_0_bt_32_r313_m288_1370M,0,reward_shaping_checkpoints_bots_4_heads_1_ckpt360,5_vs_5
5226,3,5,m_sp_arch_medium_heads_conv16_0_bt_32_r313_m288_1370M,2,reward_shaping_checkpoints_bots_4_heads_1_ckpt360,5_vs_5
5227,5,7,m_sp_arch_medium_heads_conv16_0_bt_32_r313_m288_1370M,2,reward_shaping_checkpoints_bots_4_heads_1_ckpt360,5_vs_5
5228,5,6,m_sp_arch_medium_heads_conv16_0_bt_32_r313_m288_1370M,1,reward_shaping_checkpoints_bots_4_heads_1_ckpt360,5_vs_5
5229,4,5,m_sp_arch_medium_heads_conv16_0_bt_32_r313_m288_1370M,1,reward_shaping_checkpoints_bots_4_heads_1_ckpt360,5_vs_5
5230,5,7,m_sp_arch_medium_heads_conv16_0_bt_32_r313_m288_1370M,2,reward_shaping_checkpoints_bots_4_heads_1_ckpt360,5_vs_5
5231,1,6,m_sp_arch_medium_heads_conv16_0_bt_32_r313_m288_1370M,5,reward_shaping_checkpoints_bots_4_heads_1_ckpt360,5_vs_5
5232,5,5,m_sp_arch_medium_heads_conv16_0_bt_32_r313_m288_1370M,0,reward_shaping_checkpoints_bots_4_heads_1_ckpt360,5_vs_5
5233,6,7,m_sp_arch_medium_heads_conv16_0_bt_32_r313_m288_1370M,1,reward_shaping_checkpoints_bots_4_heads_1_ckpt360,5_vs_5
5234,1,5,m_sp_arch_medium_heads_conv16_0_bt_32_r313_m288_1370M,4,reward_shaping_checkpoints_bots_4_heads_1_ckpt360,5_vs_5
5235,0,1,m_sp_arch_medium_heads_conv16_0_bt_32_r313_m288_1370M,1,reward_shaping_checkpoints_bots_4_heads_1_ckpt360,5_vs_5
5236,5,5,m_sp_arch_medium_heads_conv16_0_bt_32_r313_m288_1370M,0,reward_shaping_checkpoints_bots_4_heads_1_ckpt360,5_vs_5
5237,3,4,m_sp_arch_medium_heads_conv16_0_bt_32_r313_m288_1370M,1,reward_shaping_checkpoints_bots_4_heads_1_ckpt360,5_vs_5
5238,1,3,m_sp_arch_medium_heads_conv16_0_bt_32_r313_m288_1370M,2,reward_shaping_checkpoints_bots_4_heads_1_ckpt360,5_vs_5
5239,4,4,m_sp_arch_medium_heads_conv16_0_bt_32_r313_m288_1370M,0,reward_shaping_checkpoints_bots_4_heads_1_ckpt360,5_vs_5
5240,5,8,m_sp_arch_medium_heads_conv16_0_bt_32_r313_m288_1370M,3,checkpoints_selfplay_e9_sp_ckpt274,5_vs_5
5241,-4,2,m_sp_arch_medium_heads_conv16_0_bt_32_r313_m288_1370M,6,checkpoints_selfplay_e9_sp_ckpt274,5_vs_5
5242,-1,4,m_sp_arch_medium_heads_conv16_0_bt_32_r313_m288_1370M,5,checkpoints_selfplay_e9_sp_ckpt274,5_vs_5
5243,-1,2,m_sp_arch_medium_heads_conv16_0_bt_32_r313_m288_1370M,3,checkpoints_selfplay_e9_sp_ckpt274,5_vs_5
5244,1,5,m_sp_arch_medium_heads_conv16_0_bt_32_r313_m288_1370M,4,checkpoints_selfplay_e9_sp_ckpt274,5_vs_5
5245,2,6,m_sp_arch_medium_heads_conv16_0_bt_32_r313_m288_1370M,4,checkpoints_selfplay_e9_sp_ckpt274,5_vs_5
5246,-7,4,m_sp_arch_medium_heads_conv16_0_bt_32_r313_m288_1370M,11,checkpoints_selfplay_e9_sp_ckpt274,5_vs_5
5247,1,3,m_sp_arch_medium_heads_conv16_0_bt_32_r313_m288_1370M,2,checkpoints_selfplay_e9_sp_ckpt274,5_vs_5
5248,-2,2,m_sp_arch_medium_heads_conv16_0_bt_32_r313_m288_1370M,4,checkpoints_selfplay_e9_sp_ckpt274,5_vs_5
5249,-1,3,m_sp_arch_medium_heads_conv16_0_bt_32_r313_m288_1370M,4,checkpoints_selfplay_e9_sp_ckpt274,5_vs_5
5250,2,7,m_sp_arch_medium_heads_conv16_0_bt_32_r313_m288_1370M,5,checkpoints_selfplay_e9_sp_ckpt274,5_vs_5
5251,-1,2,m_sp_arch_medium_heads_conv16_0_bt_32_r313_m288_1370M,3,checkpoints_selfplay_e9_sp_ckpt274,5_vs_5
5252,-5,2,m_sp_arch_medium_heads_conv16_0_bt_32_r313_m288_1370M,7,checkpoints_selfplay_e9_sp_ckpt274,5_vs_5
5253,-2,3,m_sp_arch_medium_heads_conv16_0_bt_32_r313_m288_1370M,5,checkpoints_selfplay_e9_sp_ckpt274,5_vs_5
5254,-2,4,m_sp_arch_medium_heads_conv16_0_bt_32_r313_m288_1370M,6,checkpoints_selfplay_e9_sp_ckpt274,5_vs_5
5255,-3,0,m_sp_arch_medium_heads_conv16_0_bt_32_r313_m288_1370M,3,checkpoints_selfplay_e9_sp_ckpt274,5_vs_5
5256,-5,0,m_sp_arch_medium_heads_conv16_0_bt_32_r313_m288_1370M,5,checkpoints_selfplay_e9_sp_ckpt274,5_vs_5
5257,-5,1,m_sp_arch_medium_heads_conv16_0_bt_32_r313_m288_1370M,6,checkpoints_selfplay_e9_sp_ckpt274,5_vs_5
5258,-2,3,m_sp_arch_medium_heads_conv16_0_bt_32_r313_m288_1370M,5,checkpoints_selfplay_e9_sp_ckpt274,5_vs_5
5259,-3,2,m_sp_arch_medium_heads_conv16_0_bt_32_r313_m288_1370M,5,checkpoints_selfplay_e9_sp_ckpt274,5_vs_5
5260,0,3,m_sp_arch_medium_heads_conv16_0_bt_32_r313_m288_1370M,3,checkpoints_selfplay_e9_sp_ckpt335_1370M,5_vs_5
5261,-5,2,m_sp_arch_medium_heads_conv16_0_bt_32_r313_m288_1370M,7,checkpoints_selfplay_e9_sp_ckpt335_1370M,5_vs_5
5262,-1,2,m_sp_arch_medium_heads_conv16_0_bt_32_r313_m288_1370M,3,checkpoints_selfplay_e9_sp_ckpt335_1370M,5_vs_5
5263,-1,4,m_sp_arch_medium_heads_conv16_0_bt_32_r313_m288_1370M,5,checkpoints_selfplay_e9_sp_ckpt335_1370M,5_vs_5
5264,-6,2,m_sp_arch_medium_heads_conv16_0_bt_32_r313_m288_1370M,8,checkpoints_selfplay_e9_sp_ckpt335_1370M,5_vs_5
5265,-2,3,m_sp_arch_medium_heads_conv16_0_bt_32_r313_m288_1370M,5,checkpoints_selfplay_e9_sp_ckpt335_1370M,5_vs_5
5266,-1,4,m_sp_arch_medium_heads_conv16_0_bt_32_r313_m288_1370M,5,checkpoints_selfplay_e9_sp_ckpt335_1370M,5_vs_5
5267,-2,4,m_sp_arch_medium_heads_conv16_0_bt_32_r313_m288_1370M,6,checkpoints_selfplay_e9_sp_ckpt335_1370M,5_vs_5
5268,-2,1,m_sp_arch_medium_heads_conv16_0_bt_32_r313_m288_1370M,3,checkpoints_selfplay_e9_sp_ckpt335_1370M,5_vs_5
5269,-3,3,m_sp_arch_medium_heads_conv16_0_bt_32_r313_m288_1370M,6,checkpoints_selfplay_e9_sp_ckpt335_1370M,5_vs_5
5270,-1,3,m_sp_arch_medium_heads_conv16_0_bt_32_r313_m288_1370M,4,checkpoints_selfplay_e9_sp_ckpt335_1370M,5_vs_5
5271,-6,1,m_sp_arch_medium_heads_conv16_0_bt_32_r313_m288_1370M,7,checkpoints_selfplay_e9_sp_ckpt335_1370M,5_vs_5
5272,-6,1,m_sp_arch_medium_heads_conv16_0_bt_32_r313_m288_1370M,7,checkpoints_selfplay_e9_sp_ckpt335_1370M,5_vs_5
5273,-3,1,m_sp_arch_medium_heads_conv16_0_bt_32_r313_m288_1370M,4,checkpoints_selfplay_e9_sp_ckpt335_1370M,5_vs_5
5274,-1,2,m_sp_arch_medium_heads_conv16_0_bt_32_r313_m288_1370M,3,checkpoints_selfplay_e9_sp_ckpt335_1370M,5_vs_5
5275,-2,4,m_sp_arch_medium_heads_conv16_0_bt_32_r313_m288_1370M,6,checkpoints_selfplay_e9_sp_ckpt335_1370M,5_vs_5
5276,-3,1,m_sp_arch_medium_heads_conv16_0_bt_32_r313_m288_1370M,4,checkpoints_selfplay_e9_sp_ckpt335_1370M,5_vs_5
5277,-2,2,m_sp_arch_medium_heads_conv16_0_bt_32_r313_m288_1370M,4,checkpoints_selfplay_e9_sp_ckpt335_1370M,5_vs_5
5278,1,2,m_sp_arch_medium_heads_conv16_0_bt_32_r313_m288_1370M,1,checkpoints_selfplay_e9_sp_ckpt335_1370M,5_vs_5
5279,0,0,m_sp_arch_medium_heads_conv16_0_bt_32_r313_m288_1370M,0,checkpoints_selfplay_e9_sp_ckpt335_1370M,5_vs_5
5280,0,4,m_sp_arch_medium_heads_conv16_0_bt_32_r313_m288_1370M,4,checkpoints_sp_c_nb_e2_ckpt667,5_vs_5
5281,-1,2,m_sp_arch_medium_heads_conv16_0_bt_32_r313_m288_1370M,3,checkpoints_sp_c_nb_e2_ckpt667,5_vs_5
5282,-3,2,m_sp_arch_medium_heads_conv16_0_bt_32_r313_m288_1370M,5,checkpoints_sp_c_nb_e2_ckpt667,5_vs_5
5283,-2,5,m_sp_arch_medium_heads_conv16_0_bt_32_r313_m288_1370M,7,checkpoints_sp_c_nb_e2_ckpt667,5_vs_5
5284,-1,3,m_sp_arch_medium_heads_conv16_0_bt_32_r313_m288_1370M,4,checkpoints_sp_c_nb_e2_ckpt667,5_vs_5
5285,0,4,m_sp_arch_medium_heads_conv16_0_bt_32_r313_m288_1370M,4,checkpoints_sp_c_nb_e2_ckpt667,5_vs_5
5286,-5,2,m_sp_arch_medium_heads_conv16_0_bt_32_r313_m288_1370M,7,checkpoints_sp_c_nb_e2_ckpt667,5_vs_5
5287,-5,1,m_sp_arch_medium_heads_conv16_0_bt_32_r313_m288_1370M,6,checkpoints_sp_c_nb_e2_ckpt667,5_vs_5
5288,-3,2,m_sp_arch_medium_heads_conv16_0_bt_32_r313_m288_1370M,5,checkpoints_sp_c_nb_e2_ckpt667,5_vs_5
5289,-7,1,m_sp_arch_medium_heads_conv16_0_bt_32_r313_m288_1370M,8,checkpoints_sp_c_nb_e2_ckpt667,5_vs_5
5290,-2,0,m_sp_arch_medium_heads_conv16_0_bt_32_r313_m288_1370M,2,checkpoints_sp_c_nb_e2_ckpt667,5_vs_5
5291,1,2,m_sp_arch_medium_heads_conv16_0_bt_32_r313_m288_1370M,1,checkpoints_sp_c_nb_e2_ckpt667,5_vs_5
5292,-3,1,m_sp_arch_medium_heads_conv16_0_bt_32_r313_m288_1370M,4,checkpoints_sp_c_nb_e2_ckpt667,5_vs_5
5293,-6,1,m_sp_arch_medium_heads_conv16_0_bt_32_r313_m288_1370M,7,checkpoints_sp_c_nb_e2_ckpt667,5_vs_5
5294,-3,3,m_sp_arch_medium_heads_conv16_0_bt_32_r313_m288_1370M,6,checkpoints_sp_c_nb_e2_ckpt667,5_vs_5
5295,-4,1,m_sp_arch_medium_heads_conv16_0_bt_32_r313_m288_1370M,5,checkpoints_sp_c_nb_e2_ckpt667,5_vs_5
5296,-5,0,m_sp_arch_medium_heads_conv16_0_bt_32_r313_m288_1370M,5,checkpoints_sp_c_nb_e2_ckpt667,5_vs_5
5297,-5,0,m_sp_arch_medium_heads_conv16_0_bt_32_r313_m288_1370M,5,checkpoints_sp_c_nb_e2_ckpt667,5_vs_5
5298,-5,1,m_sp_arch_medium_heads_conv16_0_bt_32_r313_m288_1370M,6,checkpoints_sp_c_nb_e2_ckpt667,5_vs_5
5299,-12,0,m_sp_arch_medium_heads_conv16_0_bt_32_r313_m288_1370M,12,checkpoints_sp_c_nb_e2_ckpt667,5_vs_5
5300,0,0,m_sp_arch_medium_heads_conv16_0_bt_32_r313_m288_1370M,0,scenario_curriculum_ckpt830,5_vs_5
5301,2,2,m_sp_arch_medium_heads_conv16_0_bt_32_r313_m288_1370M,0,scenario_curriculum_ckpt830,5_vs_5
5302,1,1,m_sp_arch_medium_heads_conv16_0_bt_32_r313_m288_1370M,0,scenario_curriculum_ckpt830,5_vs_5
5303,0,1,m_sp_arch_medium_heads_conv16_0_bt_32_r313_m288_1370M,1,scenario_curriculum_ckpt830,5_vs_5
5304,6,6,m_sp_arch_medium_heads_conv16_0_bt_32_r313_m288_1370M,0,scenario_curriculum_ckpt830,5_vs_5
5305,1,1,m_sp_arch_medium_heads_conv16_0_bt_32_r313_m288_1370M,0,scenario_curriculum_ckpt830,5_vs_5
5306,2,2,m_sp_arch_medium_heads_conv16_0_bt_32_r313_m288_1370M,0,scenario_curriculum_ckpt830,5_vs_5
5307,1,1,m_sp_arch_medium_heads_conv16_0_bt_32_r313_m288_1370M,0,scenario_curriculum_ckpt830,5_vs_5
5308,1,1,m_sp_arch_medium_heads_conv16_0_bt_32_r313_m288_1370M,0,scenario_curriculum_ckpt830,5_vs_5
5309,0,0,m_sp_arch_medium_heads_conv16_0_bt_32_r313_m288_1370M,0,scenario_curriculum_ckpt830,5_vs_5
5310,1,1,m_sp_arch_medium_heads_conv16_0_bt_32_r313_m288_1370M,0,scenario_curriculum_ckpt830,5_vs_5
5311,0,0,m_sp_arch_medium_heads_conv16_0_bt_32_r313_m288_1370M,0,scenario_curriculum_ckpt830,5_vs_5
5312,2,2,m_sp_arch_medium_heads_conv16_0_bt_32_r313_m288_1370M,0,scenario_curriculum_ckpt830,5_vs_5
5313,-1,0,m_sp_arch_medium_heads_conv16_0_bt_32_r313_m288_1370M,1,scenario_curriculum_ckpt830,5_vs_5
5314,2,2,m_sp_arch_medium_heads_conv16_0_bt_32_r313_m288_1370M,0,scenario_curriculum_ckpt830,5_vs_5
5315,0,0,m_sp_arch_medium_heads_conv16_0_bt_32_r313_m288_1370M,0,scenario_curriculum_ckpt830,5_vs_5
5316,3,3,m_sp_arch_medium_heads_conv16_0_bt_32_r313_m288_1370M,0,scenario_curriculum_ckpt830,5_vs_5
5317,1,1,m_sp_arch_medium_heads_conv16_0_bt_32_r313_m288_1370M,0,scenario_curriculum_ckpt830,5_vs_5
5318,1,1,m_sp_arch_medium_heads_conv16_0_bt_32_r313_m288_1370M,0,scenario_curriculum_ckpt830,5_vs_5
5319,2,2,m_sp_arch_medium_heads_conv16_0_bt_32_r313_m288_1370M,0,scenario_curriculum_ckpt830,5_vs_5
5320,1,3,m_sp_arch_medium_heads_conv16_0_bt_32_r313_m288_1370M,2,m_sp_arch_medium_heads_conv16_0_bt_32_r313_m335,5_vs_5
5321,-1,0,m_sp_arch_medium_heads_conv16_0_bt_32_r313_m288_1370M,1,m_sp_arch_medium_heads_conv16_0_bt_32_r313_m335,5_vs_5
5322,-1,3,m_sp_arch_medium_heads_conv16_0_bt_32_r313_m288_1370M,4,m_sp_arch_medium_heads_conv16_0_bt_32_r313_m335,5_vs_5
5323,0,2,m_sp_arch_medium_heads_conv16_0_bt_32_r313_m288_1370M,2,m_sp_arch_medium_heads_conv16_0_bt_32_r313_m335,5_vs_5
5324,-2,2,m_sp_arch_medium_heads_conv16_0_bt_32_r313_m288_1370M,4,m_sp_arch_medium_heads_conv16_0_bt_32_r313_m335,5_vs_5
5325,-1,2,m_sp_arch_medium_heads_conv16_0_bt_32_r313_m288_1370M,3,m_sp_arch_medium_heads_conv16_0_bt_32_r313_m335,5_vs_5
5326,1,1,m_sp_arch_medium_heads_conv16_0_bt_32_r313_m288_1370M,0,m_sp_arch_medium_heads_conv16_0_bt_32_r313_m335,5_vs_5
5327,0,1,m_sp_arch_medium_heads_conv16_0_bt_32_r313_m288_1370M,1,m_sp_arch_medium_heads_conv16_0_bt_32_r313_m335,5_vs_5
5328,2,2,m_sp_arch_medium_heads_conv16_0_bt_32_r313_m288_1370M,0,m_sp_arch_medium_heads_conv16_0_bt_32_r313_m335,5_vs_5
5329,0,1,m_sp_arch_medium_heads_conv16_0_bt_32_r313_m288_1370M,1,m_sp_arch_medium_heads_conv16_0_bt_32_r313_m335,5_vs_5
5330,-3,2,m_sp_arch_medium_heads_conv16_0_bt_32_r313_m288_1370M,5,m_sp_arch_medium_heads_conv16_0_bt_32_r313_m335,5_vs_5
5331,0,2,m_sp_arch_medium_heads_conv16_0_bt_32_r313_m288_1370M,2,m_sp_arch_medium_heads_conv16_0_bt_32_r313_m335,5_vs_5
5332,1,2,m_sp_arch_medium_heads_conv16_0_bt_32_r313_m288_1370M,1,m_sp_arch_medium_heads_conv16_0_bt_32_r313_m335,5_vs_5
5333,0,2,m_sp_arch_medium_heads_conv16_0_bt_32_r313_m288_1370M,2,m_sp_arch_medium_heads_conv16_0_bt_32_r313_m335,5_vs_5
5334,-1,3,m_sp_arch_medium_heads_conv16_0_bt_32_r313_m288_1370M,4,m_sp_arch_medium_heads_conv16_0_bt_32_r313_m335,5_vs_5
5335,0,2,m_sp_arch_medium_heads_conv16_0_bt_32_r313_m288_1370M,2,m_sp_arch_medium_heads_conv16_0_bt_32_r313_m335,5_vs_5
5336,-2,2,m_sp_arch_medium_heads_conv16_0_bt_32_r313_m288_1370M,4,m_sp_arch_medium_heads_conv16_0_bt_32_r313_m335,5_vs_5
5337,-1,0,m_sp_arch_medium_heads_conv16_0_bt_32_r313_m288_1370M,1,m_sp_arch_medium_heads_conv16_0_bt_32_r313_m335,5_vs_5
5338,1,3,m_sp_arch_medium_heads_conv16_0_bt_32_r313_m288_1370M,2,m_sp_arch_medium_heads_conv16_0_bt_32_r313_m335,5_vs_5
5339,-1,0,m_sp_arch_medium_heads_conv16_0_bt_32_r313_m288_1370M,1,m_sp_arch_medium_heads_conv16_0_bt_32_r313_m335,5_vs_5
5340,-1,2,m_sp_arch_medium_heads_conv16_0_bt_32_r313_m288_1370M,3,m_sp_arch_medium_heads_conv16_0_bt_32_r313_m288_1370M,5_vs_5
5341,-3,2,m_sp_arch_medium_heads_conv16_0_bt_32_r313_m288_1370M,5,m_sp_arch_medium_heads_conv16_0_bt_32_r313_m288_1370M,5_vs_5
5342,0,3,m_sp_arch_medium_heads_conv16_0_bt_32_r313_m288_1370M,3,m_sp_arch_medium_heads_conv16_0_bt_32_r313_m288_1370M,5_vs_5
5343,-1,1,m_sp_arch_medium_heads_conv16_0_bt_32_r313_m288_1370M,2,m_sp_arch_medium_heads_conv16_0_bt_32_r313_m288_1370M,5_vs_5
5344,-1,0,m_sp_arch_medium_heads_conv16_0_bt_32_r313_m288_1370M,1,m_sp_arch_medium_heads_conv16_0_bt_32_r313_m288_1370M,5_vs_5
5345,0,1,m_sp_arch_medium_heads_conv16_0_bt_32_r313_m288_1370M,1,m_sp_arch_medium_heads_conv16_0_bt_32_r313_m288_1370M,5_vs_5
5346,0,1,m_sp_arch_medium_heads_conv16_0_bt_32_r313_m288_1370M,1,m_sp_arch_medium_heads_conv16_0_bt_32_r313_m288_1370M,5_vs_5
5347,0,3,m_sp_arch_medium_heads_conv16_0_bt_32_r313_m288_1370M,3,m_sp_arch_medium_heads_conv16_0_bt_32_r313_m288_1370M,5_vs_5
5348,2,3,m_sp_arch_medium_heads_conv16_0_bt_32_r313_m288_1370M,1,m_sp_arch_medium_heads_conv16_0_bt_32_r313_m288_1370M,5_vs_5
5349,-1,1,m_sp_arch_medium_heads_conv16_0_bt_32_r313_m288_1370M,2,m_sp_arch_medium_heads_conv16_0_bt_32_r313_m288_1370M,5_vs_5
5350,-2,1,m_sp_arch_medium_heads_conv16_0_bt_32_r313_m288_1370M,3,m_sp_arch_medium_heads_conv16_0_bt_32_r313_m288_1370M,5_vs_5
5351,1,2,m_sp_arch_medium_heads_conv16_0_bt_32_r313_m288_1370M,1,m_sp_arch_medium_heads_conv16_0_bt_32_r313_m288_1370M,5_vs_5
5352,-3,1,m_sp_arch_medium_heads_conv16_0_bt_32_r313_m288_1370M,4,m_sp_arch_medium_heads_conv16_0_bt_32_r313_m288_1370M,5_vs_5
5353,-1,2,m_sp_arch_medium_heads_conv16_0_bt_32_r313_m288_1370M,3,m_sp_arch_medium_heads_conv16_0_bt_32_r313_m288_1370M,5_vs_5
5354,-3,0,m_sp_arch_medium_heads_conv16_0_bt_32_r313_m288_1370M,3,m_sp_arch_medium_heads_conv16_0_bt_32_r313_m288_1370M,5_vs_5
5355,-1,0,m_sp_arch_medium_heads_conv16_0_bt_32_r313_m288_1370M,1,m_sp_arch_medium_heads_conv16_0_bt_32_r313_m288_1370M,5_vs_5
5356,0,2,m_sp_arch_medium_heads_conv16_0_bt_32_r313_m288_1370M,2,m_sp_arch_medium_heads_conv16_0_bt_32_r313_m288_1370M,5_vs_5
5357,0,1,m_sp_arch_medium_heads_conv16_0_bt_32_r313_m288_1370M,1,m_sp_arch_medium_heads_conv16_0_bt_32_r313_m288_1370M,5_vs_5
5358,0,3,m_sp_arch_medium_heads_conv16_0_bt_32_r313_m288_1370M,3,m_sp_arch_medium_heads_conv16_0_bt_32_r313_m288_1370M,5_vs_5
5359,0,3,m_sp_arch_medium_heads_conv16_0_bt_32_r313_m288_1370M,3,m_sp_arch_medium_heads_conv16_0_bt_32_r313_m288_1370M,5_vs_5
5360,-3,2,m_sp_arch_medium_heads_conv16_0_bt_32_r313_m288_1370M,5,m_sp_arch_longer_heads_bt_32_r201_m335,5_vs_5
5361,-2,0,m_sp_arch_medium_heads_conv16_0_bt_32_r313_m288_1370M,2,m_sp_arch_longer_heads_bt_32_r201_m335,5_vs_5
5362,1,2,m_sp_arch_medium_heads_conv16_0_bt_32_r313_m288_1370M,1,m_sp_arch_longer_heads_bt_32_r201_m335,5_vs_5
5363,-2,2,m_sp_arch_medium_heads_conv16_0_bt_32_r313_m288_1370M,4,m_sp_arch_longer_heads_bt_32_r201_m335,5_vs_5
5364,-1,0,m_sp_arch_medium_heads_conv16_0_bt_32_r313_m288_1370M,1,m_sp_arch_longer_heads_bt_32_r201_m335,5_vs_5
5365,0,1,m_sp_arch_medium_heads_conv16_0_bt_32_r313_m288_1370M,1,m_sp_arch_longer_heads_bt_32_r201_m335,5_vs_5
5366,-3,0,m_sp_arch_medium_heads_conv16_0_bt_32_r313_m288_1370M,3,m_sp_arch_longer_heads_bt_32_r201_m335,5_vs_5
5367,1,2,m_sp_arch_medium_heads_conv16_0_bt_32_r313_m288_1370M,1,m_sp_arch_longer_heads_bt_32_r201_m335,5_vs_5
5368,-1,1,m_sp_arch_medium_heads_conv16_0_bt_32_r313_m288_1370M,2,m_sp_arch_longer_heads_bt_32_r201_m335,5_vs_5
5369,-3,0,m_sp_arch_medium_heads_conv16_0_bt_32_r313_m288_1370M,3,m_sp_arch_longer_heads_bt_32_r201_m335,5_vs_5
5370,-1,1,m_sp_arch_medium_heads_conv16_0_bt_32_r313_m288_1370M,2,m_sp_arch_longer_heads_bt_32_r201_m335,5_vs_5
5371,0,2,m_sp_arch_medium_heads_conv16_0_bt_32_r313_m288_1370M,2,m_sp_arch_longer_heads_bt_32_r201_m335,5_vs_5
5372,-1,2,m_sp_arch_medium_heads_conv16_0_bt_32_r313_m288_1370M,3,m_sp_arch_longer_heads_bt_32_r201_m335,5_vs_5
5373,1,3,m_sp_arch_medium_heads_conv16_0_bt_32_r313_m288_1370M,2,m_sp_arch_longer_heads_bt_32_r201_m335,5_vs_5
5374,1,3,m_sp_arch_medium_heads_conv16_0_bt_32_r313_m288_1370M,2,m_sp_arch_longer_heads_bt_32_r201_m335,5_vs_5
5375,-2,0,m_sp_arch_medium_heads_conv16_0_bt_32_r313_m288_1370M,2,m_sp_arch_longer_heads_bt_32_r201_m335,5_vs_5
5376,-3,3,m_sp_arch_medium_heads_conv16_0_bt_32_r313_m288_1370M,6,m_sp_arch_longer_heads_bt_32_r201_m335,5_vs_5
5377,0,2,m_sp_arch_medium_heads_conv16_0_bt_32_r313_m288_1370M,2,m_sp_arch_longer_heads_bt_32_r201_m335,5_vs_5
5378,-2,1,m_sp_arch_medium_heads_conv16_0_bt_32_r313_m288_1370M,3,m_sp_arch_longer_heads_bt_32_r201_m335,5_vs_5
5379,3,4,m_sp_arch_medium_heads_conv16_0_bt_32_r313_m288_1370M,1,m_sp_arch_longer_heads_bt_32_r201_m335,5_vs_5
5380,2,2,m_sp_arch_medium_heads_conv16_0_bt_32_r313_m288_1370M,0,m_sp_arch_longer_heads_bt_32_r310_m277_1370M,5_vs_5
5381,2,4,m_sp_arch_medium_heads_conv16_0_bt_32_r313_m288_1370M,2,m_sp_arch_longer_heads_bt_32_r310_m277_1370M,5_vs_5
5382,1,4,m_sp_arch_medium_heads_conv16_0_bt_32_r313_m288_1370M,3,m_sp_arch_longer_heads_bt_32_r310_m277_1370M,5_vs_5
5383,-1,1,m_sp_arch_medium_heads_conv16_0_bt_32_r313_m288_1370M,2,m_sp_arch_longer_heads_bt_32_r310_m277_1370M,5_vs_5
5384,0,1,m_sp_arch_medium_heads_conv16_0_bt_32_r313_m288_1370M,1,m_sp_arch_longer_heads_bt_32_r310_m277_1370M,5_vs_5
5385,2,2,m_sp_arch_medium_heads_conv16_0_bt_32_r313_m288_1370M,0,m_sp_arch_longer_heads_bt_32_r310_m277_1370M,5_vs_5
5386,1,2,m_sp_arch_medium_heads_conv16_0_bt_32_r313_m288_1370M,1,m_sp_arch_longer_heads_bt_32_r310_m277_1370M,5_vs_5
5387,-1,4,m_sp_arch_medium_heads_conv16_0_bt_32_r313_m288_1370M,5,m_sp_arch_longer_heads_bt_32_r310_m277_1370M,5_vs_5
5388,1,3,m_sp_arch_medium_heads_conv16_0_bt_32_r313_m288_1370M,2,m_sp_arch_longer_heads_bt_32_r310_m277_1370M,5_vs_5
5389,-2,0,m_sp_arch_medium_heads_conv16_0_bt_32_r313_m288_1370M,2,m_sp_arch_longer_heads_bt_32_r310_m277_1370M,5_vs_5
5390,1,2,m_sp_arch_medium_heads_conv16_0_bt_32_r313_m288_1370M,1,m_sp_arch_longer_heads_bt_32_r310_m277_1370M,5_vs_5
5391,1,4,m_sp_arch_medium_heads_conv16_0_bt_32_r313_m288_1370M,3,m_sp_arch_longer_heads_bt_32_r310_m277_1370M,5_vs_5
5392,0,2,m_sp_arch_medium_heads_conv16_0_bt_32_r313_m288_1370M,2,m_sp_arch_longer_heads_bt_32_r310_m277_1370M,5_vs_5
5393,-3,0,m_sp_arch_medium_heads_conv16_0_bt_32_r313_m288_1370M,3,m_sp_arch_longer_heads_bt_32_r310_m277_1370M,5_vs_5
5394,3,4,m_sp_arch_medium_heads_conv16_0_bt_32_r313_m288_1370M,1,m_sp_arch_longer_heads_bt_32_r310_m277_1370M,5_vs_5
5395,1,2,m_sp_arch_medium_heads_conv16_0_bt_32_r313_m288_1370M,1,m_sp_arch_longer_heads_bt_32_r310_m277_1370M,5_vs_5
5396,0,2,m_sp_arch_medium_heads_conv16_0_bt_32_r313_m288_1370M,2,m_sp_arch_longer_heads_bt_32_r310_m277_1370M,5_vs_5
5397,-1,4,m_sp_arch_medium_heads_conv16_0_bt_32_r313_m288_1370M,5,m_sp_arch_longer_heads_bt_32_r310_m277_1370M,5_vs_5
5398,0,3,m_sp_arch_medium_heads_conv16_0_bt_32_r313_m288_1370M,3,m_sp_arch_longer_heads_bt_32_r310_m277_1370M,5_vs_5
5399,-2,0,m_sp_arch_medium_heads_conv16_0_bt_32_r313_m288_1370M,2,m_sp_arch_longer_heads_bt_32_r310_m277_1370M,5_vs_5
5400,1,3,m_sp_arch_medium_heads_conv16_0_bt_32_r313_m288_1370M,2,m_sp_arch_medium_heads_bt_32_r201_m335,5_vs_5
5401,2,2,m_sp_arch_medium_heads_conv16_0_bt_32_r313_m288_1370M,0,m_sp_arch_medium_heads_bt_32_r201_m335,5_vs_5
5402,3,3,m_sp_arch_medium_heads_conv16_0_bt_32_r313_m288_1370M,0,m_sp_arch_medium_heads_bt_32_r201_m335,5_vs_5
5403,-1,1,m_sp_arch_medium_heads_conv16_0_bt_32_r313_m288_1370M,2,m_sp_arch_medium_heads_bt_32_r201_m335,5_vs_5
5404,-2,2,m_sp_arch_medium_heads_conv16_0_bt_32_r313_m288_1370M,4,m_sp_arch_medium_heads_bt_32_r201_m335,5_vs_5
5405,1,3,m_sp_arch_medium_heads_conv16_0_bt_32_r313_m288_1370M,2,m_sp_arch_medium_heads_bt_32_r201_m335,5_vs_5
5406,0,2,m_sp_arch_medium_heads_conv16_0_bt_32_r313_m288_1370M,2,m_sp_arch_medium_heads_bt_32_r201_m335,5_vs_5
5407,-2,1,m_sp_arch_medium_heads_conv16_0_bt_32_r313_m288_1370M,3,m_sp_arch_medium_heads_bt_32_r201_m335,5_vs_5
5408,3,4,m_sp_arch_medium_heads_conv16_0_bt_32_r313_m288_1370M,1,m_sp_arch_medium_heads_bt_32_r201_m335,5_vs_5
5409,0,1,m_sp_arch_medium_heads_conv16_0_bt_32_r313_m288_1370M,1,m_sp_arch_medium_heads_bt_32_r201_m335,5_vs_5
5410,2,2,m_sp_arch_medium_heads_conv16_0_bt_32_r313_m288_1370M,0,m_sp_arch_medium_heads_bt_32_r201_m335,5_vs_5
5411,0,1,m_sp_arch_medium_heads_conv16_0_bt_32_r313_m288_1370M,1,m_sp_arch_medium_heads_bt_32_r201_m335,5_vs_5
5412,3,3,m_sp_arch_medium_heads_conv16_0_bt_32_r313_m288_1370M,0,m_sp_arch_medium_heads_bt_32_r201_m335,5_vs_5
5413,0,2,m_sp_arch_medium_heads_conv16_0_bt_32_r313_m288_1370M,2,m_sp_arch_medium_heads_bt_32_r201_m335,5_vs_5
5414,-1,3,m_sp_arch_medium_heads_conv16_0_bt_32_r313_m288_1370M,4,m_sp_arch_medium_heads_bt_32_r201_m335,5_vs_5
5415,1,1,m_sp_arch_medium_heads_conv16_0_bt_32_r313_m288_1370M,0,m_sp_arch_medium_heads_bt_32_r201_m335,5_vs_5
5416,-1,0,m_sp_arch_medium_heads_conv16_0_bt_32_r313_m288_1370M,1,m_sp_arch_medium_heads_bt_32_r201_m335,5_vs_5
5417,4,5,m_sp_arch_medium_heads_conv16_0_bt_32_r313_m288_1370M,1,m_sp_arch_medium_heads_bt_32_r201_m335,5_vs_5
5418,0,3,m_sp_arch_medium_heads_conv16_0_bt_32_r313_m288_1370M,3,m_sp_arch_medium_heads_bt_32_r201_m335,5_vs_5
5419,-1,0,m_sp_arch_medium_heads_conv16_0_bt_32_r313_m288_1370M,1,m_sp_arch_medium_heads_bt_32_r201_m335,5_vs_5
5420,3,3,m_sp_arch_medium_heads_conv16_0_bt_32_r313_m288_1370M,0,m_sp_arch_medium_heads_bt_32_r201_m273_1370M,5_vs_5
5421,-4,0,m_sp_arch_medium_heads_conv16_0_bt_32_r313_m288_1370M,4,m_sp_arch_medium_heads_bt_32_r201_m273_1370M,5_vs_5
5422,-1,1,m_sp_arch_medium_heads_conv16_0_bt_32_r313_m288_1370M,2,m_sp_arch_medium_heads_bt_32_r201_m273_1370M,5_vs_5
5423,0,2,m_sp_arch_medium_heads_conv16_0_bt_32_r313_m288_1370M,2,m_sp_arch_medium_heads_bt_32_r201_m273_1370M,5_vs_5
5424,4,4,m_sp_arch_medium_heads_conv16_0_bt_32_r313_m288_1370M,0,m_sp_arch_medium_heads_bt_32_r201_m273_1370M,5_vs_5
5425,-1,2,m_sp_arch_medium_heads_conv16_0_bt_32_r313_m288_1370M,3,m_sp_arch_medium_heads_bt_32_r201_m273_1370M,5_vs_5
5426,1,4,m_sp_arch_medium_heads_conv16_0_bt_32_r313_m288_1370M,3,m_sp_arch_medium_heads_bt_32_r201_m273_1370M,5_vs_5
5427,-1,3,m_sp_arch_medium_heads_conv16_0_bt_32_r313_m288_1370M,4,m_sp_arch_medium_heads_bt_32_r201_m273_1370M,5_vs_5
5428,2,5,m_sp_arch_medium_heads_conv16_0_bt_32_r313_m288_1370M,3,m_sp_arch_medium_heads_bt_32_r201_m273_1370M,5_vs_5
5429,2,2,m_sp_arch_medium_heads_conv16_0_bt_32_r313_m288_1370M,0,m_sp_arch_medium_heads_bt_32_r201_m273_1370M,5_vs_5
5430,-4,2,m_sp_arch_medium_heads_conv16_0_bt_32_r313_m288_1370M,6,m_sp_arch_medium_heads_bt_32_r201_m273_1370M,5_vs_5
5431,-1,1,m_sp_arch_medium_heads_conv16_0_bt_32_r313_m288_1370M,2,m_sp_arch_medium_heads_bt_32_r201_m273_1370M,5_vs_5
5432,1,4,m_sp_arch_medium_heads_conv16_0_bt_32_r313_m288_1370M,3,m_sp_arch_medium_heads_bt_32_r201_m273_1370M,5_vs_5
5433,1,4,m_sp_arch_medium_heads_conv16_0_bt_32_r313_m288_1370M,3,m_sp_arch_medium_heads_bt_32_r201_m273_1370M,5_vs_5
5434,-1,2,m_sp_arch_medium_heads_conv16_0_bt_32_r313_m288_1370M,3,m_sp_arch_medium_heads_bt_32_r201_m273_1370M,5_vs_5
5435,-1,2,m_sp_arch_medium_heads_conv16_0_bt_32_r313_m288_1370M,3,m_sp_arch_medium_heads_bt_32_r201_m273_1370M,5_vs_5
5436,1,3,m_sp_arch_medium_heads_conv16_0_bt_32_r313_m288_1370M,2,m_sp_arch_medium_heads_bt_32_r201_m273_1370M,5_vs_5
5437,-1,4,m_sp_arch_medium_heads_conv16_0_bt_32_r313_m288_1370M,5,m_sp_arch_medium_heads_bt_32_r201_m273_1370M,5_vs_5
5438,0,4,m_sp_arch_medium_heads_conv16_0_bt_32_r313_m288_1370M,4,m_sp_arch_medium_heads_bt_32_r201_m273_1370M,5_vs_5
5439,-2,3,m_sp_arch_medium_heads_conv16_0_bt_32_r313_m288_1370M,5,m_sp_arch_medium_heads_bt_32_r201_m273_1370M,5_vs_5
5440,-7,1,m_sp_arch_medium_heads_conv16_0_bt_32_r313_m288_1370M,8,m_sp_arch_4x1_bt_32_r201_m335,5_vs_5
5441,-11,0,m_sp_arch_medium_heads_conv16_0_bt_32_r313_m288_1370M,11,m_sp_arch_4x1_bt_32_r201_m335,5_vs_5
5442,-6,0,m_sp_arch_medium_heads_conv16_0_bt_32_r313_m288_1370M,6,m_sp_arch_4x1_bt_32_r201_m335,5_vs_5
5443,-3,1,m_sp_arch_medium_heads_conv16_0_bt_32_r313_m288_1370M,4,m_sp_arch_4x1_bt_32_r201_m335,5_vs_5
5444,-5,2,m_sp_arch_medium_heads_conv16_0_bt_32_r313_m288_1370M,7,m_sp_arch_4x1_bt_32_r201_m335,5_vs_5
5445,-3,2,m_sp_arch_medium_heads_conv16_0_bt_32_r313_m288_1370M,5,m_sp_arch_4x1_bt_32_r201_m335,5_vs_5
5446,-6,0,m_sp_arch_medium_heads_conv16_0_bt_32_r313_m288_1370M,6,m_sp_arch_4x1_bt_32_r201_m335,5_vs_5
5447,-4,0,m_sp_arch_medium_heads_conv16_0_bt_32_r313_m288_1370M,4,m_sp_arch_4x1_bt_32_r201_m335,5_vs_5
5448,-9,0,m_sp_arch_medium_heads_conv16_0_bt_32_r313_m288_1370M,9,m_sp_arch_4x1_bt_32_r201_m335,5_vs_5
5449,-4,0,m_sp_arch_medium_heads_conv16_0_bt_32_r313_m288_1370M,4,m_sp_arch_4x1_bt_32_r201_m335,5_vs_5
5450,-5,0,m_sp_arch_medium_heads_conv16_0_bt_32_r313_m288_1370M,5,m_sp_arch_4x1_bt_32_r201_m335,5_vs_5
5451,-6,0,m_sp_arch_medium_heads_conv16_0_bt_32_r313_m288_1370M,6,m_sp_arch_4x1_bt_32_r201_m335,5_vs_5
5452,-4,1,m_sp_arch_medium_heads_conv16_0_bt_32_r313_m288_1370M,5,m_sp_arch_4x1_bt_32_r201_m335,5_vs_5
5453,-3,2,m_sp_arch_medium_heads_conv16_0_bt_32_r313_m288_1370M,5,m_sp_arch_4x1_bt_32_r201_m335,5_vs_5
5454,-6,0,m_sp_arch_medium_heads_conv16_0_bt_32_r313_m288_1370M,6,m_sp_arch_4x1_bt_32_r201_m335,5_vs_5
5455,-3,0,m_sp_arch_medium_heads_conv16_0_bt_32_r313_m288_1370M,3,m_sp_arch_4x1_bt_32_r201_m335,5_vs_5
5456,-7,2,m_sp_arch_medium_heads_conv16_0_bt_32_r313_m288_1370M,9,m_sp_arch_4x1_bt_32_r201_m335,5_vs_5
5457,-8,1,m_sp_arch_medium_heads_conv16_0_bt_32_r313_m288_1370M,9,m_sp_arch_4x1_bt_32_r201_m335,5_vs_5
5458,-6,0,m_sp_arch_medium_heads_conv16_0_bt_32_r313_m288_1370M,6,m_sp_arch_4x1_bt_32_r201_m335,5_vs_5
5459,-3,1,m_sp_arch_medium_heads_conv16_0_bt_32_r313_m288_1370M,4,m_sp_arch_4x1_bt_32_r201_m335,5_vs_5
5460,-4,1,m_sp_arch_medium_heads_conv16_0_bt_32_r313_m288_1370M,5,m_sp_arch_4x1_bt_32_r201_cont3_m650,5_vs_5
5461,-6,0,m_sp_arch_medium_heads_conv16_0_bt_32_r313_m288_1370M,6,m_sp_arch_4x1_bt_32_r201_cont3_m650,5_vs_5
5462,-7,3,m_sp_arch_medium_heads_conv16_0_bt_32_r313_m288_1370M,10,m_sp_arch_4x1_bt_32_r201_cont3_m650,5_vs_5
5463,-5,0,m_sp_arch_medium_heads_conv16_0_bt_32_r313_m288_1370M,5,m_sp_arch_4x1_bt_32_r201_cont3_m650,5_vs_5
5464,-6,0,m_sp_arch_medium_heads_conv16_0_bt_32_r313_m288_1370M,6,m_sp_arch_4x1_bt_32_r201_cont3_m650,5_vs_5
5465,-8,0,m_sp_arch_medium_heads_conv16_0_bt_32_r313_m288_1370M,8,m_sp_arch_4x1_bt_32_r201_cont3_m650,5_vs_5
5466,-7,0,m_sp_arch_medium_heads_conv16_0_bt_32_r313_m288_1370M,7,m_sp_arch_4x1_bt_32_r201_cont3_m650,5_vs_5
5467,-3,0,m_sp_arch_medium_heads_conv16_0_bt_32_r313_m288_1370M,3,m_sp_arch_4x1_bt_32_r201_cont3_m650,5_vs_5
5468,-9,1,m_sp_arch_medium_heads_conv16_0_bt_32_r313_m288_1370M,10,m_sp_arch_4x1_bt_32_r201_cont3_m650,5_vs_5
5469,-7,2,m_sp_arch_medium_heads_conv16_0_bt_32_r313_m288_1370M,9,m_sp_arch_4x1_bt_32_r201_cont3_m650,5_vs_5
5470,-8,0,m_sp_arch_medium_heads_conv16_0_bt_32_r313_m288_1370M,8,m_sp_arch_4x1_bt_32_r201_cont3_m650,5_vs_5
5471,-6,0,m_sp_arch_medium_heads_conv16_0_bt_32_r313_m288_1370M,6,m_sp_arch_4x1_bt_32_r201_cont3_m650,5_vs_5
5472,-2,0,m_sp_arch_medium_heads_conv16_0_bt_32_r313_m288_1370M,2,m_sp_arch_4x1_bt_32_r201_cont3_m650,5_vs_5
5473,-6,0,m_sp_arch_medium_heads_conv16_0_bt_32_r313_m288_1370M,6,m_sp_arch_4x1_bt_32_r201_cont3_m650,5_vs_5
5474,-6,0,m_sp_arch_medium_heads_conv16_0_bt_32_r313_m288_1370M,6,m_sp_arch_4x1_bt_32_r201_cont3_m650,5_vs_5
5475,-4,0,m_sp_arch_medium_heads_conv16_0_bt_32_r313_m288_1370M,4,m_sp_arch_4x1_bt_32_r201_cont3_m650,5_vs_5
5476,-2,0,m_sp_arch_medium_heads_conv16_0_bt_32_r313_m288_1370M,2,m_sp_arch_4x1_bt_32_r201_cont3_m650,5_vs_5
5477,-4,0,m_sp_arch_medium_heads_conv16_0_bt_32_r313_m288_1370M,4,m_sp_arch_4x1_bt_32_r201_cont3_m650,5_vs_5
5478,-7,0,m_sp_arch_medium_heads_conv16_0_bt_32_r313_m288_1370M,7,m_sp_arch_4x1_bt_32_r201_cont3_m650,5_vs_5
5479,-1,2,m_sp_arch_medium_heads_conv16_0_bt_32_r313_m288_1370M,3,m_sp_arch_4x1_bt_32_r201_cont3_m650,5_vs_5
5480,-1,1,m_sp_arch_medium_heads_conv16_0_bt_32_r313_m288_1370M,2,explt_v0_7_2_m54,5_vs_5
5481,-4,0,m_sp_arch_medium_heads_conv16_0_bt_32_r313_m288_1370M,4,explt_v0_7_2_m54,5_vs_5
5482,-2,0,m_sp_arch_medium_heads_conv16_0_bt_32_r313_m288_1370M,2,explt_v0_7_2_m54,5_vs_5
5483,-2,1,m_sp_arch_medium_heads_conv16_0_bt_32_r313_m288_1370M,3,explt_v0_7_2_m54,5_vs_5
5484,-1,1,m_sp_arch_medium_heads_conv16_0_bt_32_r313_m288_1370M,2,explt_v0_7_2_m54,5_vs_5
5485,-3,0,m_sp_arch_medium_heads_conv16_0_bt_32_r313_m288_1370M,3,explt_v0_7_2_m54,5_vs_5
5486,-2,0,m_sp_arch_medium_heads_conv16_0_bt_32_r313_m288_1370M,2,explt_v0_7_2_m54,5_vs_5
5487,-1,1,m_sp_arch_medium_heads_conv16_0_bt_32_r313_m288_1370M,2,explt_v0_7_2_m54,5_vs_5
5488,-3,0,m_sp_arch_medium_heads_conv16_0_bt_32_r313_m288_1370M,3,explt_v0_7_2_m54,5_vs_5
5489,0,2,m_sp_arch_medium_heads_conv16_0_bt_32_r313_m288_1370M,2,explt_v0_7_2_m54,5_vs_5
5490,1,1,m_sp_arch_medium_heads_conv16_0_bt_32_r313_m288_1370M,0,explt_v0_7_2_m54,5_vs_5
5491,1,1,m_sp_arch_medium_heads_conv16_0_bt_32_r313_m288_1370M,0,explt_v0_7_2_m54,5_vs_5
5492,-2,1,m_sp_arch_medium_heads_conv16_0_bt_32_r313_m288_1370M,3,explt_v0_7_2_m54,5_vs_5
5493,-1,0,m_sp_arch_medium_heads_conv16_0_bt_32_r313_m288_1370M,1,explt_v0_7_2_m54,5_vs_5
5494,0,1,m_sp_arch_medium_heads_conv16_0_bt_32_r313_m288_1370M,1,explt_v0_7_2_m54,5_vs_5
5495,-5,0,m_sp_arch_medium_heads_conv16_0_bt_32_r313_m288_1370M,5,explt_v0_7_2_m54,5_vs_5
5496,-3,1,m_sp_arch_medium_heads_conv16_0_bt_32_r313_m288_1370M,4,explt_v0_7_2_m54,5_vs_5
5497,0,0,m_sp_arch_medium_heads_conv16_0_bt_32_r313_m288_1370M,0,explt_v0_7_2_m54,5_vs_5
5498,-3,0,m_sp_arch_medium_heads_conv16_0_bt_32_r313_m288_1370M,3,explt_v0_7_2_m54,5_vs_5
5499,-6,0,m_sp_arch_medium_heads_conv16_0_bt_32_r313_m288_1370M,6,explt_v0_7_2_m54,5_vs_5
5500,-1,3,m_sp_arch_medium_heads_conv16_0_bt_32_r313_m288_1370M,4,m_sp_sc3v3_arch_2x1_32_r500_cont4x1_m224,5_vs_5
5501,-5,0,m_sp_arch_medium_heads_conv16_0_bt_32_r313_m288_1370M,5,m_sp_sc3v3_arch_2x1_32_r500_cont4x1_m224,5_vs_5
5502,-2,0,m_sp_arch_medium_heads_conv16_0_bt_32_r313_m288_1370M,2,m_sp_sc3v3_arch_2x1_32_r500_cont4x1_m224,5_vs_5
5503,-6,0,m_sp_arch_medium_heads_conv16_0_bt_32_r313_m288_1370M,6,m_sp_sc3v3_arch_2x1_32_r500_cont4x1_m224,5_vs_5
5504,-7,1,m_sp_arch_medium_heads_conv16_0_bt_32_r313_m288_1370M,8,m_sp_sc3v3_arch_2x1_32_r500_cont4x1_m224,5_vs_5
5505,-5,0,m_sp_arch_medium_heads_conv16_0_bt_32_r313_m288_1370M,5,m_sp_sc3v3_arch_2x1_32_r500_cont4x1_m224,5_vs_5
5506,-3,2,m_sp_arch_medium_heads_conv16_0_bt_32_r313_m288_1370M,5,m_sp_sc3v3_arch_2x1_32_r500_cont4x1_m224,5_vs_5
5507,-6,0,m_sp_arch_medium_heads_conv16_0_bt_32_r313_m288_1370M,6,m_sp_sc3v3_arch_2x1_32_r500_cont4x1_m224,5_vs_5
5508,-6,0,m_sp_arch_medium_heads_conv16_0_bt_32_r313_m288_1370M,6,m_sp_sc3v3_arch_2x1_32_r500_cont4x1_m224,5_vs_5
5509,-3,1,m_sp_arch_medium_heads_conv16_0_bt_32_r313_m288_1370M,4,m_sp_sc3v3_arch_2x1_32_r500_cont4x1_m224,5_vs_5
5510,-4,1,m_sp_arch_medium_heads_conv16_0_bt_32_r313_m288_1370M,5,m_sp_sc3v3_arch_2x1_32_r500_cont4x1_m224,5_vs_5
5511,-5,0,m_sp_arch_medium_heads_conv16_0_bt_32_r313_m288_1370M,5,m_sp_sc3v3_arch_2x1_32_r500_cont4x1_m224,5_vs_5
5512,-6,0,m_sp_arch_medium_heads_conv16_0_bt_32_r313_m288_1370M,6,m_sp_sc3v3_arch_2x1_32_r500_cont4x1_m224,5_vs_5
5513,-2,1,m_sp_arch_medium_heads_conv16_0_bt_32_r313_m288_1370M,3,m_sp_sc3v3_arch_2x1_32_r500_cont4x1_m224,5_vs_5
5514,-10,0,m_sp_arch_medium_heads_conv16_0_bt_32_r313_m288_1370M,10,m_sp_sc3v3_arch_2x1_32_r500_cont4x1_m224,5_vs_5
5515,-6,0,m_sp_arch_medium_heads_conv16_0_bt_32_r313_m288_1370M,6,m_sp_sc3v3_arch_2x1_32_r500_cont4x1_m224,5_vs_5
5516,-2,0,m_sp_arch_medium_heads_conv16_0_bt_32_r313_m288_1370M,2,m_sp_sc3v3_arch_2x1_32_r500_cont4x1_m224,5_vs_5
5517,-6,2,m_sp_arch_medium_heads_conv16_0_bt_32_r313_m288_1370M,8,m_sp_sc3v3_arch_2x1_32_r500_cont4x1_m224,5_vs_5
5518,-6,1,m_sp_arch_medium_heads_conv16_0_bt_32_r313_m288_1370M,7,m_sp_sc3v3_arch_2x1_32_r500_cont4x1_m224,5_vs_5
5519,-5,1,m_sp_arch_medium_heads_conv16_0_bt_32_r313_m288_1370M,6,m_sp_sc3v3_arch_2x1_32_r500_cont4x1_m224,5_vs_5
5520,-1,2,m_sp_arch_medium_heads_conv16_0_bt_32_r313_m288_1370M,3,m_sp_arch_4x1_bt_32_roles_r500_m335,5_vs_5
5521,-3,0,m_sp_arch_medium_heads_conv16_0_bt_32_r313_m288_1370M,3,m_sp_arch_4x1_bt_32_roles_r500_m335,5_vs_5
5522,-7,0,m_sp_arch_medium_heads_conv16_0_bt_32_r313_m288_1370M,7,m_sp_arch_4x1_bt_32_roles_r500_m335,5_vs_5
5523,-3,3,m_sp_arch_medium_heads_conv16_0_bt_32_r313_m288_1370M,6,m_sp_arch_4x1_bt_32_roles_r500_m335,5_vs_5
5524,-8,1,m_sp_arch_medium_heads_conv16_0_bt_32_r313_m288_1370M,9,m_sp_arch_4x1_bt_32_roles_r500_m335,5_vs_5
5525,-5,3,m_sp_arch_medium_heads_conv16_0_bt_32_r313_m288_1370M,8,m_sp_arch_4x1_bt_32_roles_r500_m335,5_vs_5
5526,-3,1,m_sp_arch_medium_heads_conv16_0_bt_32_r313_m288_1370M,4,m_sp_arch_4x1_bt_32_roles_r500_m335,5_vs_5
5527,-5,0,m_sp_arch_medium_heads_conv16_0_bt_32_r313_m288_1370M,5,m_sp_arch_4x1_bt_32_roles_r500_m335,5_vs_5
5528,-3,3,m_sp_arch_medium_heads_conv16_0_bt_32_r313_m288_1370M,6,m_sp_arch_4x1_bt_32_roles_r500_m335,5_vs_5
5529,-6,0,m_sp_arch_medium_heads_conv16_0_bt_32_r313_m288_1370M,6,m_sp_arch_4x1_bt_32_roles_r500_m335,5_vs_5
5530,-8,3,m_sp_arch_medium_heads_conv16_0_bt_32_r313_m288_1370M,11,m_sp_arch_4x1_bt_32_roles_r500_m335,5_vs_5
5531,-2,1,m_sp_arch_medium_heads_conv16_0_bt_32_r313_m288_1370M,3,m_sp_arch_4x1_bt_32_roles_r500_m335,5_vs_5
5532,-7,3,m_sp_arch_medium_heads_conv16_0_bt_32_r313_m288_1370M,10,m_sp_arch_4x1_bt_32_roles_r500_m335,5_vs_5
5533,-5,1,m_sp_arch_medium_heads_conv16_0_bt_32_r313_m288_1370M,6,m_sp_arch_4x1_bt_32_roles_r500_m335,5_vs_5
5534,-3,0,m_sp_arch_medium_heads_conv16_0_bt_32_r313_m288_1370M,3,m_sp_arch_4x1_bt_32_roles_r500_m335,5_vs_5
5535,-10,0,m_sp_arch_medium_heads_conv16_0_bt_32_r313_m288_1370M,10,m_sp_arch_4x1_bt_32_roles_r500_m335,5_vs_5
5536,-6,1,m_sp_arch_medium_heads_conv16_0_bt_32_r313_m288_1370M,7,m_sp_arch_4x1_bt_32_roles_r500_m335,5_vs_5
5537,-10,0,m_sp_arch_medium_heads_conv16_0_bt_32_r313_m288_1370M,10,m_sp_arch_4x1_bt_32_roles_r500_m335,5_vs_5
5538,-5,2,m_sp_arch_medium_heads_conv16_0_bt_32_r313_m288_1370M,7,m_sp_arch_4x1_bt_32_roles_r500_m335,5_vs_5
5539,-8,1,m_sp_arch_medium_heads_conv16_0_bt_32_r313_m288_1370M,9,m_sp_arch_4x1_bt_32_roles_r500_m335,5_vs_5
5540,0,0,scenario_curriculum_ckpt830,0,easy_bots,5_vs_5
5541,0,0,scenario_curriculum_ckpt830,0,easy_bots,5_vs_5
5542,0,0,scenario_curriculum_ckpt830,0,easy_bots,5_vs_5
5543,-1,0,scenario_curriculum_ckpt830,1,easy_bots,5_vs_5
5544,0,0,scenario_curriculum_ckpt830,0,easy_bots,5_vs_5
5545,0,0,scenario_curriculum_ckpt830,0,easy_bots,5_vs_5
5546,-1,0,scenario_curriculum_ckpt830,1,easy_bots,5_vs_5
5547,0,0,scenario_curriculum_ckpt830,0,easy_bots,5_vs_5
5548,0,0,scenario_curriculum_ckpt830,0,easy_bots,5_vs_5
5549,0,0,scenario_curriculum_ckpt830,0,easy_bots,5_vs_5
5550,0,0,scenario_curriculum_ckpt830,0,easy_bots,5_vs_5
5551,0,0,scenario_curriculum_ckpt830,0,easy_bots,5_vs_5
5552,0,0,scenario_curriculum_ckpt830,0,easy_bots,5_vs_5
5553,0,0,scenario_curriculum_ckpt830,0,easy_bots,5_vs_5
5554,0,0,scenario_curriculum_ckpt830,0,easy_bots,5_vs_5
5555,0,0,scenario_curriculum_ckpt830,0,easy_bots,5_vs_5
5556,0,0,scenario_curriculum_ckpt830,0,easy_bots,5_vs_5
5557,0,0,scenario_curriculum_ckpt830,0,easy_bots,5_vs_5
5558,0,0,scenario_curriculum_ckpt830,0,easy_bots,5_vs_5
5559,0,0,scenario_curriculum_ckpt830,0,easy_bots,5_vs_5
5560,0,0,scenario_curriculum_ckpt830,0,medium_bots,5_vs_5_medium
5561,-1,0,scenario_curriculum_ckpt830,1,medium_bots,5_vs_5_medium
5562,-1,0,scenario_curriculum_ckpt830,1,medium_bots,5_vs_5_medium
5563,-2,0,scenario_curriculum_ckpt830,2,medium_bots,5_vs_5_medium
5564,0,0,scenario_curriculum_ckpt830,0,medium_bots,5_vs_5_medium
5565,-3,0,scenario_curriculum_ckpt830,3,medium_bots,5_vs_5_medium
5566,0,0,scenario_curriculum_ckpt830,0,medium_bots,5_vs_5_medium
5567,-3,0,scenario_curriculum_ckpt830,3,medium_bots,5_vs_5_medium
5568,-5,0,scenario_curriculum_ckpt830,5,medium_bots,5_vs_5_medium
5569,-1,0,scenario_curriculum_ckpt830,1,medium_bots,5_vs_5_medium
5570,0,0,scenario_curriculum_ckpt830,0,medium_bots,5_vs_5_medium
5571,0,0,scenario_curriculum_ckpt830,0,medium_bots,5_vs_5_medium
5572,0,0,scenario_curriculum_ckpt830,0,medium_bots,5_vs_5_medium
5573,-1,0,scenario_curriculum_ckpt830,1,medium_bots,5_vs_5_medium
5574,-1,0,scenario_curriculum_ckpt830,1,medium_bots,5_vs_5_medium
5575,-1,0,scenario_curriculum_ckpt830,1,medium_bots,5_vs_5_medium
5576,0,0,scenario_curriculum_ckpt830,0,medium_bots,5_vs_5_medium
5577,-2,0,scenario_curriculum_ckpt830,2,medium_bots,5_vs_5_medium
5578,0,0,scenario_curriculum_ckpt830,0,medium_bots,5_vs_5_medium
5579,0,0,scenario_curriculum_ckpt830,0,medium_bots,5_vs_5_medium
5580,0,0,scenario_curriculum_ckpt830,0,hard_bots,5_vs_5_hard
5581,0,0,scenario_curriculum_ckpt830,0,hard_bots,5_vs_5_hard
5582,0,0,scenario_curriculum_ckpt830,0,hard_bots,5_vs_5_hard
5583,-1,0,scenario_curriculum_ckpt830,1,hard_bots,5_vs_5_hard
5584,0,0,scenario_curriculum_ckpt830,0,hard_bots,5_vs_5_hard
5585,-1,0,scenario_curriculum_ckpt830,1,hard_bots,5_vs_5_hard
5586,-3,0,scenario_curriculum_ckpt830,3,hard_bots,5_vs_5_hard
5587,-2,0,scenario_curriculum_ckpt830,2,hard_bots,5_vs_5_hard
5588,0,0,scenario_curriculum_ckpt830,0,hard_bots,5_vs_5_hard
5589,-1,0,scenario_curriculum_ckpt830,1,hard_bots,5_vs_5_hard
5590,0,0,scenario_curriculum_ckpt830,0,hard_bots,5_vs_5_hard
5591,0,0,scenario_curriculum_ckpt830,0,hard_bots,5_vs_5_hard
5592,0,0,scenario_curriculum_ckpt830,0,hard_bots,5_vs_5_hard
5593,-1,0,scenario_curriculum_ckpt830,1,hard_bots,5_vs_5_hard
5594,-4,0,scenario_curriculum_ckpt830,4,hard_bots,5_vs_5_hard
5595,-3,0,scenario_curriculum_ckpt830,3,hard_bots,5_vs_5_hard
5596,0,0,scenario_curriculum_ckpt830,0,hard_bots,5_vs_5_hard
5597,-2,0,scenario_curriculum_ckpt830,2,hard_bots,5_vs_5_hard
5598,-1,0,scenario_curriculum_ckpt830,1,hard_bots,5_vs_5_hard
5599,-4,0,scenario_curriculum_ckpt830,4,hard_bots,5_vs_5_hard
5600,-1,0,scenario_curriculum_ckpt830,1,f5v0to1to2t05_e2_ckpt291,5_vs_5
5601,-2,0,scenario_curriculum_ckpt830,2,f5v0to1to2t05_e2_ckpt291,5_vs_5
5602,0,0,scenario_curriculum_ckpt830,0,f5v0to1to2t05_e2_ckpt291,5_vs_5
5603,-3,0,scenario_curriculum_ckpt830,3,f5v0to1to2t05_e2_ckpt291,5_vs_5
5604,-2,0,scenario_curriculum_ckpt830,2,f5v0to1to2t05_e2_ckpt291,5_vs_5
5605,-1,0,scenario_curriculum_ckpt830,1,f5v0to1to2t05_e2_ckpt291,5_vs_5
5606,0,0,scenario_curriculum_ckpt830,0,f5v0to1to2t05_e2_ckpt291,5_vs_5
5607,-1,0,scenario_curriculum_ckpt830,1,f5v0to1to2t05_e2_ckpt291,5_vs_5
5608,0,0,scenario_curriculum_ckpt830,0,f5v0to1to2t05_e2_ckpt291,5_vs_5
5609,-6,0,scenario_curriculum_ckpt830,6,f5v0to1to2t05_e2_ckpt291,5_vs_5
5610,-2,0,scenario_curriculum_ckpt830,2,f5v0to1to5_e2_ckpt252,5_vs_5
5611,0,0,scenario_curriculum_ckpt830,0,f5v0to1to5_e2_ckpt252,5_vs_5
5612,-1,0,scenario_curriculum_ckpt830,1,f5v0to1to5_e2_ckpt252,5_vs_5
5613,-2,0,scenario_curriculum_ckpt830,2,f5v0to1to5_e2_ckpt252,5_vs_5
5614,-1,0,scenario_curriculum_ckpt830,1,f5v0to1to5_e2_ckpt252,5_vs_5
5615,-2,0,scenario_curriculum_ckpt830,2,f5v0to1to5_e2_ckpt252,5_vs_5
5616,0,0,scenario_curriculum_ckpt830,0,f5v0to1to5_e2_ckpt252,5_vs_5
5617,-2,0,scenario_curriculum_ckpt830,2,f5v0to1to5_e2_ckpt252,5_vs_5
5618,-1,0,scenario_curriculum_ckpt830,1,f5v0to1to5_e2_ckpt252,5_vs_5
5619,-1,0,scenario_curriculum_ckpt830,1,f5v0to1to5_e2_ckpt252,5_vs_5
5620,-1,0,scenario_curriculum_ckpt830,1,scon_e3_p2_hard_ckpt840,5_vs_5
5621,-2,0,scenario_curriculum_ckpt830,2,scon_e3_p2_hard_ckpt840,5_vs_5
5622,-1,0,scenario_curriculum_ckpt830,1,scon_e3_p2_hard_ckpt840,5_vs_5
5623,-1,0,scenario_curriculum_ckpt830,1,scon_e3_p2_hard_ckpt840,5_vs_5
5624,-2,0,scenario_curriculum_ckpt830,2,scon_e3_p2_hard_ckpt840,5_vs_5
5625,-1,0,scenario_curriculum_ckpt830,1,scon_e3_p2_hard_ckpt840,5_vs_5
5626,0,0,scenario_curriculum_ckpt830,0,scon_e3_p2_hard_ckpt840,5_vs_5
5627,-1,0,scenario_curriculum_ckpt830,1,scon_e3_p2_hard_ckpt840,5_vs_5
5628,-1,0,scenario_curriculum_ckpt830,1,scon_e3_p2_hard_ckpt840,5_vs_5
5629,-1,0,scenario_curriculum_ckpt830,1,scon_e3_p2_hard_ckpt840,5_vs_5
5630,0,0,scenario_curriculum_ckpt830,0,less_then_partially_randomized_checkpoints_bots_4_heads_38_ckpt108,5_vs_5
5631,-1,0,scenario_curriculum_ckpt830,1,less_then_partially_randomized_checkpoints_bots_4_heads_38_ckpt108,5_vs_5
5632,0,0,scenario_curriculum_ckpt830,0,less_then_partially_randomized_checkpoints_bots_4_heads_38_ckpt108,5_vs_5
5633,0,0,scenario_curriculum_ckpt830,0,less_then_partially_randomized_checkpoints_bots_4_heads_38_ckpt108,5_vs_5
5634,0,0,scenario_curriculum_ckpt830,0,less_then_partially_randomized_checkpoints_bots_4_heads_38_ckpt108,5_vs_5
5635,-1,0,scenario_curriculum_ckpt830,1,less_then_partially_randomized_checkpoints_bots_4_heads_38_ckpt108,5_vs_5
5636,0,0,scenario_curriculum_ckpt830,0,less_then_partially_randomized_checkpoints_bots_4_heads_38_ckpt108,5_vs_5
5637,0,0,scenario_curriculum_ckpt830,0,less_then_partially_randomized_checkpoints_bots_4_heads_38_ckpt108,5_vs_5
5638,-1,0,scenario_curriculum_ckpt830,1,less_then_partially_randomized_checkpoints_bots_4_heads_38_ckpt108,5_vs_5
5639,-5,0,scenario_curriculum_ckpt830,5,less_then_partially_randomized_checkpoints_bots_4_heads_38_ckpt108,5_vs_5
5640,-1,0,scenario_curriculum_ckpt830,1,less_then_partially_randomized_entropy_checkpoints_bots_4_heads_39_ckpt109,5_vs_5
5641,0,0,scenario_curriculum_ckpt830,0,less_then_partially_randomized_entropy_checkpoints_bots_4_heads_39_ckpt109,5_vs_5
5642,-3,0,scenario_curriculum_ckpt830,3,less_then_partially_randomized_entropy_checkpoints_bots_4_heads_39_ckpt109,5_vs_5
5643,0,0,scenario_curriculum_ckpt830,0,less_then_partially_randomized_entropy_checkpoints_bots_4_heads_39_ckpt109,5_vs_5
5644,0,0,scenario_curriculum_ckpt830,0,less_then_partially_randomized_entropy_checkpoints_bots_4_heads_39_ckpt109,5_vs_5
5645,0,0,scenario_curriculum_ckpt830,0,less_then_partially_randomized_entropy_checkpoints_bots_4_heads_39_ckpt109,5_vs_5
5646,0,0,scenario_curriculum_ckpt830,0,less_then_partially_randomized_entropy_checkpoints_bots_4_heads_39_ckpt109,5_vs_5
5647,0,0,scenario_curriculum_ckpt830,0,less_then_partially_randomized_entropy_checkpoints_bots_4_heads_39_ckpt109,5_vs_5
5648,-3,0,scenario_curriculum_ckpt830,3,less_then_partially_randomized_entropy_checkpoints_bots_4_heads_39_ckpt109,5_vs_5
5649,-3,0,scenario_curriculum_ckpt830,3,less_then_partially_randomized_entropy_checkpoints_bots_4_heads_39_ckpt109,5_vs_5
5650,-1,0,scenario_curriculum_ckpt830,1,reward_shaping_checkpoints_bots_4_heads_1_ckpt360,5_vs_5
5651,0,0,scenario_curriculum_ckpt830,0,reward_shaping_checkpoints_bots_4_heads_1_ckpt360,5_vs_5
5652,-1,0,scenario_curriculum_ckpt830,1,reward_shaping_checkpoints_bots_4_heads_1_ckpt360,5_vs_5
5653,-1,0,scenario_curriculum_ckpt830,1,reward_shaping_checkpoints_bots_4_heads_1_ckpt360,5_vs_5
5654,0,0,scenario_curriculum_ckpt830,0,reward_shaping_checkpoints_bots_4_heads_1_ckpt360,5_vs_5
5655,0,0,scenario_curriculum_ckpt830,0,reward_shaping_checkpoints_bots_4_heads_1_ckpt360,5_vs_5
5656,0,0,scenario_curriculum_ckpt830,0,reward_shaping_checkpoints_bots_4_heads_1_ckpt360,5_vs_5
5657,0,0,scenario_curriculum_ckpt830,0,reward_shaping_checkpoints_bots_4_heads_1_ckpt360,5_vs_5
5658,1,1,scenario_curriculum_ckpt830,0,reward_shaping_checkpoints_bots_4_heads_1_ckpt360,5_vs_5
5659,-1,0,scenario_curriculum_ckpt830,1,reward_shaping_checkpoints_bots_4_heads_1_ckpt360,5_vs_5
5660,-3,0,scenario_curriculum_ckpt830,3,checkpoints_selfplay_e9_sp_ckpt274,5_vs_5
5661,-12,0,scenario_curriculum_ckpt830,12,checkpoints_selfplay_e9_sp_ckpt274,5_vs_5
5662,-8,0,scenario_curriculum_ckpt830,8,checkpoints_selfplay_e9_sp_ckpt274,5_vs_5
5663,-1,0,scenario_curriculum_ckpt830,1,checkpoints_selfplay_e9_sp_ckpt274,5_vs_5
5664,-5,0,scenario_curriculum_ckpt830,5,checkpoints_selfplay_e9_sp_ckpt274,5_vs_5
5665,-1,0,scenario_curriculum_ckpt830,1,checkpoints_selfplay_e9_sp_ckpt274,5_vs_5
5666,-11,0,scenario_curriculum_ckpt830,11,checkpoints_selfplay_e9_sp_ckpt274,5_vs_5
5667,-8,0,scenario_curriculum_ckpt830,8,checkpoints_selfplay_e9_sp_ckpt274,5_vs_5
5668,-1,0,scenario_curriculum_ckpt830,1,checkpoints_selfplay_e9_sp_ckpt274,5_vs_5
5669,-5,0,scenario_curriculum_ckpt830,5,checkpoints_selfplay_e9_sp_ckpt274,5_vs_5
5670,0,0,scenario_curriculum_ckpt830,0,checkpoints_sp_c_nb_e2_ckpt667,5_vs_5
5671,-5,0,scenario_curriculum_ckpt830,5,checkpoints_sp_c_nb_e2_ckpt667,5_vs_5
5672,-2,0,scenario_curriculum_ckpt830,2,checkpoints_sp_c_nb_e2_ckpt667,5_vs_5
5673,-8,0,scenario_curriculum_ckpt830,8,checkpoints_sp_c_nb_e2_ckpt667,5_vs_5
5674,-7,0,scenario_curriculum_ckpt830,7,checkpoints_sp_c_nb_e2_ckpt667,5_vs_5
5675,-5,0,scenario_curriculum_ckpt830,5,checkpoints_sp_c_nb_e2_ckpt667,5_vs_5
5676,-5,0,scenario_curriculum_ckpt830,5,checkpoints_sp_c_nb_e2_ckpt667,5_vs_5
5677,-9,0,scenario_curriculum_ckpt830,9,checkpoints_sp_c_nb_e2_ckpt667,5_vs_5
5678,-3,0,scenario_curriculum_ckpt830,3,checkpoints_sp_c_nb_e2_ckpt667,5_vs_5
5679,-4,0,scenario_curriculum_ckpt830,4,checkpoints_sp_c_nb_e2_ckpt667,5_vs_5
5680,0,0,scenario_curriculum_ckpt830,0,scenario_curriculum_ckpt830,5_vs_5
5681,0,0,scenario_curriculum_ckpt830,0,scenario_curriculum_ckpt830,5_vs_5
5682,0,0,scenario_curriculum_ckpt830,0,scenario_curriculum_ckpt830,5_vs_5
5683,0,0,scenario_curriculum_ckpt830,0,scenario_curriculum_ckpt830,5_vs_5
5684,0,0,scenario_curriculum_ckpt830,0,scenario_curriculum_ckpt830,5_vs_5
5685,0,0,scenario_curriculum_ckpt830,0,scenario_curriculum_ckpt830,5_vs_5
5686,0,0,scenario_curriculum_ckpt830,0,scenario_curriculum_ckpt830,5_vs_5
5687,-1,0,scenario_curriculum_ckpt830,1,scenario_curriculum_ckpt830,5_vs_5
5688,0,0,scenario_curriculum_ckpt830,0,scenario_curriculum_ckpt830,5_vs_5
5689,0,0,scenario_curriculum_ckpt830,0,scenario_curriculum_ckpt830,5_vs_5
5690,-2,0,scenario_curriculum_ckpt830,2,m_sp_arch_medium_heads_conv16_0_bt_32_r313_m335,5_vs_5
5691,-2,0,scenario_curriculum_ckpt830,2,m_sp_arch_medium_heads_conv16_0_bt_32_r313_m335,5_vs_5
5692,-1,0,scenario_curriculum_ckpt830,1,m_sp_arch_medium_heads_conv16_0_bt_32_r313_m335,5_vs_5
5693,-1,0,scenario_curriculum_ckpt830,1,m_sp_arch_medium_heads_conv16_0_bt_32_r313_m335,5_vs_5
5694,-2,0,scenario_curriculum_ckpt830,2,m_sp_arch_medium_heads_conv16_0_bt_32_r313_m335,5_vs_5
5695,0,0,scenario_curriculum_ckpt830,0,m_sp_arch_medium_heads_conv16_0_bt_32_r313_m335,5_vs_5
5696,-1,0,scenario_curriculum_ckpt830,1,m_sp_arch_medium_heads_conv16_0_bt_32_r313_m335,5_vs_5
5697,-1,0,scenario_curriculum_ckpt830,1,m_sp_arch_medium_heads_conv16_0_bt_32_r313_m335,5_vs_5
5698,-4,0,scenario_curriculum_ckpt830,4,m_sp_arch_medium_heads_conv16_0_bt_32_r313_m335,5_vs_5
5699,-1,0,scenario_curriculum_ckpt830,1,m_sp_arch_medium_heads_conv16_0_bt_32_r313_m335,5_vs_5
5700,0,0,scenario_curriculum_ckpt830,0,m_sp_arch_longer_heads_bt_32_r201_m335,5_vs_5
5701,-1,0,scenario_curriculum_ckpt830,1,m_sp_arch_longer_heads_bt_32_r201_m335,5_vs_5
5702,-1,0,scenario_curriculum_ckpt830,1,m_sp_arch_longer_heads_bt_32_r201_m335,5_vs_5
5703,-3,0,scenario_curriculum_ckpt830,3,m_sp_arch_longer_heads_bt_32_r201_m335,5_vs_5
5704,0,0,scenario_curriculum_ckpt830,0,m_sp_arch_longer_heads_bt_32_r201_m335,5_vs_5
5705,-4,0,scenario_curriculum_ckpt830,4,m_sp_arch_longer_heads_bt_32_r201_m335,5_vs_5
5706,-1,0,scenario_curriculum_ckpt830,1,m_sp_arch_longer_heads_bt_32_r201_m335,5_vs_5
5707,-1,0,scenario_curriculum_ckpt830,1,m_sp_arch_longer_heads_bt_32_r201_m335,5_vs_5
5708,-1,0,scenario_curriculum_ckpt830,1,m_sp_arch_longer_heads_bt_32_r201_m335,5_vs_5
5709,-1,0,scenario_curriculum_ckpt830,1,m_sp_arch_longer_heads_bt_32_r201_m335,5_vs_5
5710,0,0,scenario_curriculum_ckpt830,0,m_sp_arch_medium_heads_bt_32_r201_m335,5_vs_5
5711,-1,0,scenario_curriculum_ckpt830,1,m_sp_arch_medium_heads_bt_32_r201_m335,5_vs_5
5712,0,0,scenario_curriculum_ckpt830,0,m_sp_arch_medium_heads_bt_32_r201_m335,5_vs_5
5713,-2,0,scenario_curriculum_ckpt830,2,m_sp_arch_medium_heads_bt_32_r201_m335,5_vs_5
5714,0,0,scenario_curriculum_ckpt830,0,m_sp_arch_medium_heads_bt_32_r201_m335,5_vs_5
5715,-3,0,scenario_curriculum_ckpt830,3,m_sp_arch_medium_heads_bt_32_r201_m335,5_vs_5
5716,-2,0,scenario_curriculum_ckpt830,2,m_sp_arch_medium_heads_bt_32_r201_m335,5_vs_5
5717,-4,0,scenario_curriculum_ckpt830,4,m_sp_arch_medium_heads_bt_32_r201_m335,5_vs_5
5718,-9,0,scenario_curriculum_ckpt830,9,m_sp_arch_medium_heads_bt_32_r201_m335,5_vs_5
5719,-5,0,scenario_curriculum_ckpt830,5,m_sp_arch_medium_heads_bt_32_r201_m335,5_vs_5
5720,-8,0,scenario_curriculum_ckpt830,8,m_sp_arch_4x1_bt_32_r201_m335,5_vs_5
5721,-13,0,scenario_curriculum_ckpt830,13,m_sp_arch_4x1_bt_32_r201_m335,5_vs_5
5722,-13,0,scenario_curriculum_ckpt830,13,m_sp_arch_4x1_bt_32_r201_m335,5_vs_5
5723,-14,0,scenario_curriculum_ckpt830,14,m_sp_arch_4x1_bt_32_r201_m335,5_vs_5
5724,-6,0,scenario_curriculum_ckpt830,6,m_sp_arch_4x1_bt_32_r201_m335,5_vs_5
5725,-13,0,scenario_curriculum_ckpt830,13,m_sp_arch_4x1_bt_32_r201_m335,5_vs_5
5726,-12,0,scenario_curriculum_ckpt830,12,m_sp_arch_4x1_bt_32_r201_m335,5_vs_5
5727,0,0,scenario_curriculum_ckpt830,0,m_sp_arch_4x1_bt_32_r201_m335,5_vs_5
5728,-11,0,scenario_curriculum_ckpt830,11,m_sp_arch_4x1_bt_32_r201_m335,5_vs_5
5729,-16,0,scenario_curriculum_ckpt830,16,m_sp_arch_4x1_bt_32_r201_m335,5_vs_5
5730,-8,0,scenario_curriculum_ckpt830,8,m_sp_arch_4x1_bt_32_r201_cont3_m650,5_vs_5
5731,-15,0,scenario_curriculum_ckpt830,15,m_sp_arch_4x1_bt_32_r201_cont3_m650,5_vs_5
5732,-1,0,scenario_curriculum_ckpt830,1,m_sp_arch_4x1_bt_32_r201_cont3_m650,5_vs_5
5733,-10,0,scenario_curriculum_ckpt830,10,m_sp_arch_4x1_bt_32_r201_cont3_m650,5_vs_5
5734,-1,0,scenario_curriculum_ckpt830,1,m_sp_arch_4x1_bt_32_r201_cont3_m650,5_vs_5
5735,-13,0,scenario_curriculum_ckpt830,13,m_sp_arch_4x1_bt_32_r201_cont3_m650,5_vs_5
5736,-2,0,scenario_curriculum_ckpt830,2,m_sp_arch_4x1_bt_32_r201_cont3_m650,5_vs_5
5737,-3,0,scenario_curriculum_ckpt830,3,m_sp_arch_4x1_bt_32_r201_cont3_m650,5_vs_5
5738,-7,0,scenario_curriculum_ckpt830,7,m_sp_arch_4x1_bt_32_r201_cont3_m650,5_vs_5
5739,-9,0,scenario_curriculum_ckpt830,9,m_sp_arch_4x1_bt_32_r201_cont3_m650,5_vs_5
5740,-2,1,scenario_curriculum_ckpt830,3,explt_v0_7_2_m54,5_vs_5
5741,-2,0,scenario_curriculum_ckpt830,2,explt_v0_7_2_m54,5_vs_5
5742,-1,0,scenario_curriculum_ckpt830,1,explt_v0_7_2_m54,5_vs_5
5743,-2,0,scenario_curriculum_ckpt830,2,explt_v0_7_2_m54,5_vs_5
5744,-2,0,scenario_curriculum_ckpt830,2,explt_v0_7_2_m54,5_vs_5
5745,-1,0,scenario_curriculum_ckpt830,1,explt_v0_7_2_m54,5_vs_5
5746,-1,0,scenario_curriculum_ckpt830,1,explt_v0_7_2_m54,5_vs_5
5747,-4,0,scenario_curriculum_ckpt830,4,explt_v0_7_2_m54,5_vs_5
5748,0,0,scenario_curriculum_ckpt830,0,explt_v0_7_2_m54,5_vs_5
5749,-3,0,scenario_curriculum_ckpt830,3,explt_v0_7_2_m54,5_vs_5
5750,-4,0,scenario_curriculum_ckpt830,4,m_sp_sc3v3_arch_2x1_32_r500_cont4x1_m224,5_vs_5
5751,-4,0,scenario_curriculum_ckpt830,4,m_sp_sc3v3_arch_2x1_32_r500_cont4x1_m224,5_vs_5
5752,-12,0,scenario_curriculum_ckpt830,12,m_sp_sc3v3_arch_2x1_32_r500_cont4x1_m224,5_vs_5
5753,-13,0,scenario_curriculum_ckpt830,13,m_sp_sc3v3_arch_2x1_32_r500_cont4x1_m224,5_vs_5
5754,-4,0,scenario_curriculum_ckpt830,4,m_sp_sc3v3_arch_2x1_32_r500_cont4x1_m224,5_vs_5
5755,-12,0,scenario_curriculum_ckpt830,12,m_sp_sc3v3_arch_2x1_32_r500_cont4x1_m224,5_vs_5
5756,-2,0,scenario_curriculum_ckpt830,2,m_sp_sc3v3_arch_2x1_32_r500_cont4x1_m224,5_vs_5
5757,-4,0,scenario_curriculum_ckpt830,4,m_sp_sc3v3_arch_2x1_32_r500_cont4x1_m224,5_vs_5
5758,-15,0,scenario_curriculum_ckpt830,15,m_sp_sc3v3_arch_2x1_32_r500_cont4x1_m224,5_vs_5
5759,-2,0,scenario_curriculum_ckpt830,2,m_sp_sc3v3_arch_2x1_32_r500_cont4x1_m224,5_vs_5
5760,-15,0,scenario_curriculum_ckpt830,15,m_sp_arch_4x1_bt_32_roles_r500_m335,5_vs_5
5761,-13,0,scenario_curriculum_ckpt830,13,m_sp_arch_4x1_bt_32_roles_r500_m335,5_vs_5
5762,-15,0,scenario_curriculum_ckpt830,15,m_sp_arch_4x1_bt_32_roles_r500_m335,5_vs_5
5763,-14,0,scenario_curriculum_ckpt830,14,m_sp_arch_4x1_bt_32_roles_r500_m335,5_vs_5
5764,-13,0,scenario_curriculum_ckpt830,13,m_sp_arch_4x1_bt_32_roles_r500_m335,5_vs_5
5765,-15,0,scenario_curriculum_ckpt830,15,m_sp_arch_4x1_bt_32_roles_r500_m335,5_vs_5
5766,-14,0,scenario_curriculum_ckpt830,14,m_sp_arch_4x1_bt_32_roles_r500_m335,5_vs_5
5767,-13,0,scenario_curriculum_ckpt830,13,m_sp_arch_4x1_bt_32_roles_r500_m335,5_vs_5
5768,-15,0,scenario_curriculum_ckpt830,15,m_sp_arch_4x1_bt_32_roles_r500_m335,5_vs_5
5769,-13,0,scenario_curriculum_ckpt830,13,m_sp_arch_4x1_bt_32_roles_r500_m335,5_vs_5
5770,0,1,m_sp_arch_4x1_bt_32_r201_cont3_m650,1,easy_bots,5_vs_5
5771,1,2,m_sp_arch_4x1_bt_32_r201_cont3_m650,1,easy_bots,5_vs_5
5772,1,2,m_sp_arch_4x1_bt_32_r201_cont3_m650,1,easy_bots,5_vs_5
5773,0,2,m_sp_arch_4x1_bt_32_r201_cont3_m650,2,easy_bots,5_vs_5
5774,2,3,m_sp_arch_4x1_bt_32_r201_cont3_m650,1,easy_bots,5_vs_5
5775,0,2,m_sp_arch_4x1_bt_32_r201_cont3_m650,2,easy_bots,5_vs_5
5776,2,3,m_sp_arch_4x1_bt_32_r201_cont3_m650,1,easy_bots,5_vs_5
5777,-1,0,m_sp_arch_4x1_bt_32_r201_cont3_m650,1,easy_bots,5_vs_5
5778,2,2,m_sp_arch_4x1_bt_32_r201_cont3_m650,0,easy_bots,5_vs_5
5779,2,2,m_sp_arch_4x1_bt_32_r201_cont3_m650,0,easy_bots,5_vs_5
5780,2,2,m_sp_arch_4x1_bt_32_r201_cont3_m650,0,easy_bots,5_vs_5
5781,1,2,m_sp_arch_4x1_bt_32_r201_cont3_m650,1,easy_bots,5_vs_5
5782,1,2,m_sp_arch_4x1_bt_32_r201_cont3_m650,1,easy_bots,5_vs_5
5783,1,2,m_sp_arch_4x1_bt_32_r201_cont3_m650,1,easy_bots,5_vs_5
5784,0,2,m_sp_arch_4x1_bt_32_r201_cont3_m650,2,easy_bots,5_vs_5
5785,0,1,m_sp_arch_4x1_bt_32_r201_cont3_m650,1,easy_bots,5_vs_5
5786,3,3,m_sp_arch_4x1_bt_32_r201_cont3_m650,0,easy_bots,5_vs_5
5787,1,2,m_sp_arch_4x1_bt_32_r201_cont3_m650,1,easy_bots,5_vs_5
5788,4,6,m_sp_arch_4x1_bt_32_r201_cont3_m650,2,easy_bots,5_vs_5
5789,2,2,m_sp_arch_4x1_bt_32_r201_cont3_m650,0,easy_bots,5_vs_5
5790,-1,2,m_sp_arch_4x1_bt_32_r201_cont3_m650,3,medium_bots,5_vs_5_medium
5791,0,2,m_sp_arch_4x1_bt_32_r201_cont3_m650,2,medium_bots,5_vs_5_medium
5792,1,1,m_sp_arch_4x1_bt_32_r201_cont3_m650,0,medium_bots,5_vs_5_medium
5793,-1,1,m_sp_arch_4x1_bt_32_r201_cont3_m650,2,medium_bots,5_vs_5_medium
5794,3,3,m_sp_arch_4x1_bt_32_r201_cont3_m650,0,medium_bots,5_vs_5_medium
5795,-1,0,m_sp_arch_4x1_bt_32_r201_cont3_m650,1,medium_bots,5_vs_5_medium
5796,1,1,m_sp_arch_4x1_bt_32_r201_cont3_m650,0,medium_bots,5_vs_5_medium
5797,-1,1,m_sp_arch_4x1_bt_32_r201_cont3_m650,2,medium_bots,5_vs_5_medium
5798,1,2,m_sp_arch_4x1_bt_32_r201_cont3_m650,1,medium_bots,5_vs_5_medium
5799,-2,2,m_sp_arch_4x1_bt_32_r201_cont3_m650,4,medium_bots,5_vs_5_medium
5800,0,0,m_sp_arch_4x1_bt_32_r201_cont3_m650,0,medium_bots,5_vs_5_medium
5801,-1,0,m_sp_arch_4x1_bt_32_r201_cont3_m650,1,medium_bots,5_vs_5_medium
5802,1,3,m_sp_arch_4x1_bt_32_r201_cont3_m650,2,medium_bots,5_vs_5_medium
5803,0,0,m_sp_arch_4x1_bt_32_r201_cont3_m650,0,medium_bots,5_vs_5_medium
5804,0,1,m_sp_arch_4x1_bt_32_r201_cont3_m650,1,medium_bots,5_vs_5_medium
5805,3,3,m_sp_arch_4x1_bt_32_r201_cont3_m650,0,medium_bots,5_vs_5_medium
5806,-1,1,m_sp_arch_4x1_bt_32_r201_cont3_m650,2,medium_bots,5_vs_5_medium
5807,-1,0,m_sp_arch_4x1_bt_32_r201_cont3_m650,1,medium_bots,5_vs_5_medium
5808,-2,0,m_sp_arch_4x1_bt_32_r201_cont3_m650,2,medium_bots,5_vs_5_medium
5809,0,1,m_sp_arch_4x1_bt_32_r201_cont3_m650,1,medium_bots,5_vs_5_medium
5810,-1,0,m_sp_arch_4x1_bt_32_r201_cont3_m650,1,hard_bots,5_vs_5_hard
5811,0,1,m_sp_arch_4x1_bt_32_r201_cont3_m650,1,hard_bots,5_vs_5_hard
5812,-1,0,m_sp_arch_4x1_bt_32_r201_cont3_m650,1,hard_bots,5_vs_5_hard
5813,0,0,m_sp_arch_4x1_bt_32_r201_cont3_m650,0,hard_bots,5_vs_5_hard
5814,1,2,m_sp_arch_4x1_bt_32_r201_cont3_m650,1,hard_bots,5_vs_5_hard
5815,0,0,m_sp_arch_4x1_bt_32_r201_cont3_m650,0,hard_bots,5_vs_5_hard
5816,0,1,m_sp_arch_4x1_bt_32_r201_cont3_m650,1,hard_bots,5_vs_5_hard
5817,-1,1,m_sp_arch_4x1_bt_32_r201_cont3_m650,2,hard_bots,5_vs_5_hard
5818,-1,0,m_sp_arch_4x1_bt_32_r201_cont3_m650,1,hard_bots,5_vs_5_hard
5819,-1,1,m_sp_arch_4x1_bt_32_r201_cont3_m650,2,hard_bots,5_vs_5_hard
5820,-1,0,m_sp_arch_4x1_bt_32_r201_cont3_m650,1,hard_bots,5_vs_5_hard
5821,0,2,m_sp_arch_4x1_bt_32_r201_cont3_m650,2,hard_bots,5_vs_5_hard
5822,-2,2,m_sp_arch_4x1_bt_32_r201_cont3_m650,4,hard_bots,5_vs_5_hard
5823,-2,1,m_sp_arch_4x1_bt_32_r201_cont3_m650,3,hard_bots,5_vs_5_hard
5824,0,1,m_sp_arch_4x1_bt_32_r201_cont3_m650,1,hard_bots,5_vs_5_hard
5825,-1,1,m_sp_arch_4x1_bt_32_r201_cont3_m650,2,hard_bots,5_vs_5_hard
5826,-1,2,m_sp_arch_4x1_bt_32_r201_cont3_m650,3,hard_bots,5_vs_5_hard
5827,-2,0,m_sp_arch_4x1_bt_32_r201_cont3_m650,2,hard_bots,5_vs_5_hard
5828,-1,0,m_sp_arch_4x1_bt_32_r201_cont3_m650,1,hard_bots,5_vs_5_hard
5829,0,1,m_sp_arch_4x1_bt_32_r201_cont3_m650,1,hard_bots,5_vs_5_hard
5830,8,8,m_sp_arch_4x1_bt_32_r201_cont3_m650,0,f5v0to1to2t05_e2_ckpt291,5_vs_5
5831,12,14,m_sp_arch_4x1_bt_32_r201_cont3_m650,2,f5v0to1to2t05_e2_ckpt291,5_vs_5
5832,16,16,m_sp_arch_4x1_bt_32_r201_cont3_m650,0,f5v0to1to2t05_e2_ckpt291,5_vs_5
5833,9,10,m_sp_arch_4x1_bt_32_r201_cont3_m650,1,f5v0to1to2t05_e2_ckpt291,5_vs_5
5834,14,14,m_sp_arch_4x1_bt_32_r201_cont3_m650,0,f5v0to1to2t05_e2_ckpt291,5_vs_5
5835,10,10,m_sp_arch_4x1_bt_32_r201_cont3_m650,0,f5v0to1to2t05_e2_ckpt291,5_vs_5
5836,10,12,m_sp_arch_4x1_bt_32_r201_cont3_m650,2,f5v0to1to2t05_e2_ckpt291,5_vs_5
5837,10,11,m_sp_arch_4x1_bt_32_r201_cont3_m650,1,f5v0to1to2t05_e2_ckpt291,5_vs_5
5838,13,14,m_sp_arch_4x1_bt_32_r201_cont3_m650,1,f5v0to1to2t05_e2_ckpt291,5_vs_5
5839,10,10,m_sp_arch_4x1_bt_32_r201_cont3_m650,0,f5v0to1to2t05_e2_ckpt291,5_vs_5
5840,9,9,m_sp_arch_4x1_bt_32_r201_cont3_m650,0,f5v0to1to5_e2_ckpt252,5_vs_5
5841,6,6,m_sp_arch_4x1_bt_32_r201_cont3_m650,0,f5v0to1to5_e2_ckpt252,5_vs_5
5842,9,9,m_sp_arch_4x1_bt_32_r201_cont3_m650,0,f5v0to1to5_e2_ckpt252,5_vs_5
5843,9,9,m_sp_arch_4x1_bt_32_r201_cont3_m650,0,f5v0to1to5_e2_ckpt252,5_vs_5
5844,8,8,m_sp_arch_4x1_bt_32_r201_cont3_m650,0,f5v0to1to5_e2_ckpt252,5_vs_5
5845,9,10,m_sp_arch_4x1_bt_32_r201_cont3_m650,1,f5v0to1to5_e2_ckpt252,5_vs_5
5846,5,6,m_sp_arch_4x1_bt_32_r201_cont3_m650,1,f5v0to1to5_e2_ckpt252,5_vs_5
5847,8,8,m_sp_arch_4x1_bt_32_r201_cont3_m650,0,f5v0to1to5_e2_ckpt252,5_vs_5
5848,9,9,m_sp_arch_4x1_bt_32_r201_cont3_m650,0,f5v0to1to5_e2_ckpt252,5_vs_5
5849,4,4,m_sp_arch_4x1_bt_32_r201_cont3_m650,0,f5v0to1to5_e2_ckpt252,5_vs_5
5850,12,12,m_sp_arch_4x1_bt_32_r201_cont3_m650,0,scon_e3_p2_hard_ckpt840,5_vs_5
5851,9,9,m_sp_arch_4x1_bt_32_r201_cont3_m650,0,scon_e3_p2_hard_ckpt840,5_vs_5
5852,12,13,m_sp_arch_4x1_bt_32_r201_cont3_m650,1,scon_e3_p2_hard_ckpt840,5_vs_5
5853,11,11,m_sp_arch_4x1_bt_32_r201_cont3_m650,0,scon_e3_p2_hard_ckpt840,5_vs_5
5854,13,13,m_sp_arch_4x1_bt_32_r201_cont3_m650,0,scon_e3_p2_hard_ckpt840,5_vs_5
5855,13,13,m_sp_arch_4x1_bt_32_r201_cont3_m650,0,scon_e3_p2_hard_ckpt840,5_vs_5
5856,13,13,m_sp_arch_4x1_bt_32_r201_cont3_m650,0,scon_e3_p2_hard_ckpt840,5_vs_5
5857,11,11,m_sp_arch_4x1_bt_32_r201_cont3_m650,0,scon_e3_p2_hard_ckpt840,5_vs_5
5858,9,9,m_sp_arch_4x1_bt_32_r201_cont3_m650,0,scon_e3_p2_hard_ckpt840,5_vs_5
5859,11,11,m_sp_arch_4x1_bt_32_r201_cont3_m650,0,scon_e3_p2_hard_ckpt840,5_vs_5
5860,9,9,m_sp_arch_4x1_bt_32_r201_cont3_m650,0,less_then_partially_randomized_checkpoints_bots_4_heads_38_ckpt108,5_vs_5
5861,10,10,m_sp_arch_4x1_bt_32_r201_cont3_m650,0,less_then_partially_randomized_checkpoints_bots_4_heads_38_ckpt108,5_vs_5
5862,5,6,m_sp_arch_4x1_bt_32_r201_cont3_m650,1,less_then_partially_randomized_checkpoints_bots_4_heads_38_ckpt108,5_vs_5
5863,11,11,m_sp_arch_4x1_bt_32_r201_cont3_m650,0,less_then_partially_randomized_checkpoints_bots_4_heads_38_ckpt108,5_vs_5
5864,11,12,m_sp_arch_4x1_bt_32_r201_cont3_m650,1,less_then_partially_randomized_checkpoints_bots_4_heads_38_ckpt108,5_vs_5
5865,10,10,m_sp_arch_4x1_bt_32_r201_cont3_m650,0,less_then_partially_randomized_checkpoints_bots_4_heads_38_ckpt108,5_vs_5
5866,9,9,m_sp_arch_4x1_bt_32_r201_cont3_m650,0,less_then_partially_randomized_checkpoints_bots_4_heads_38_ckpt108,5_vs_5
5867,7,7,m_sp_arch_4x1_bt_32_r201_cont3_m650,0,less_then_partially_randomized_checkpoints_bots_4_heads_38_ckpt108,5_vs_5
5868,12,12,m_sp_arch_4x1_bt_32_r201_cont3_m650,0,less_then_partially_randomized_checkpoints_bots_4_heads_38_ckpt108,5_vs_5
5869,10,11,m_sp_arch_4x1_bt_32_r201_cont3_m650,1,less_then_partially_randomized_checkpoints_bots_4_heads_38_ckpt108,5_vs_5
5870,10,10,m_sp_arch_4x1_bt_32_r201_cont3_m650,0,less_then_partially_randomized_entropy_checkpoints_bots_4_heads_39_ckpt109,5_vs_5
5871,8,8,m_sp_arch_4x1_bt_32_r201_cont3_m650,0,less_then_partially_randomized_entropy_checkpoints_bots_4_heads_39_ckpt109,5_vs_5
5872,10,10,m_sp_arch_4x1_bt_32_r201_cont3_m650,0,less_then_partially_randomized_entropy_checkpoints_bots_4_heads_39_ckpt109,5_vs_5
5873,10,10,m_sp_arch_4x1_bt_32_r201_cont3_m650,0,less_then_partially_randomized_entropy_checkpoints_bots_4_heads_39_ckpt109,5_vs_5
5874,6,6,m_sp_arch_4x1_bt_32_r201_cont3_m650,0,less_then_partially_randomized_entropy_checkpoints_bots_4_heads_39_ckpt109,5_vs_5
5875,9,10,m_sp_arch_4x1_bt_32_r201_cont3_m650,1,less_then_partially_randomized_entropy_checkpoints_bots_4_heads_39_ckpt109,5_vs_5
5876,13,13,m_sp_arch_4x1_bt_32_r201_cont3_m650,0,less_then_partially_randomized_entropy_checkpoints_bots_4_heads_39_ckpt109,5_vs_5
5877,8,8,m_sp_arch_4x1_bt_32_r201_cont3_m650,0,less_then_partially_randomized_entropy_checkpoints_bots_4_heads_39_ckpt109,5_vs_5
5878,18,18,m_sp_arch_4x1_bt_32_r201_cont3_m650,0,less_then_partially_randomized_entropy_checkpoints_bots_4_heads_39_ckpt109,5_vs_5
5879,12,12,m_sp_arch_4x1_bt_32_r201_cont3_m650,0,less_then_partially_randomized_entropy_checkpoints_bots_4_heads_39_ckpt109,5_vs_5
5880,9,9,m_sp_arch_4x1_bt_32_r201_cont3_m650,0,reward_shaping_checkpoints_bots_4_heads_1_ckpt360,5_vs_5
5881,6,6,m_sp_arch_4x1_bt_32_r201_cont3_m650,0,reward_shaping_checkpoints_bots_4_heads_1_ckpt360,5_vs_5
5882,8,8,m_sp_arch_4x1_bt_32_r201_cont3_m650,0,reward_shaping_checkpoints_bots_4_heads_1_ckpt360,5_vs_5
5883,16,16,m_sp_arch_4x1_bt_32_r201_cont3_m650,0,reward_shaping_checkpoints_bots_4_heads_1_ckpt360,5_vs_5
5884,16,17,m_sp_arch_4x1_bt_32_r201_cont3_m650,1,reward_shaping_checkpoints_bots_4_heads_1_ckpt360,5_vs_5
5885,12,12,m_sp_arch_4x1_bt_32_r201_cont3_m650,0,reward_shaping_checkpoints_bots_4_heads_1_ckpt360,5_vs_5
5886,8,9,m_sp_arch_4x1_bt_32_r201_cont3_m650,1,reward_shaping_checkpoints_bots_4_heads_1_ckpt360,5_vs_5
5887,10,10,m_sp_arch_4x1_bt_32_r201_cont3_m650,0,reward_shaping_checkpoints_bots_4_heads_1_ckpt360,5_vs_5
5888,12,12,m_sp_arch_4x1_bt_32_r201_cont3_m650,0,reward_shaping_checkpoints_bots_4_heads_1_ckpt360,5_vs_5
5889,5,5,m_sp_arch_4x1_bt_32_r201_cont3_m650,0,reward_shaping_checkpoints_bots_4_heads_1_ckpt360,5_vs_5
5890,1,2,m_sp_arch_4x1_bt_32_r201_cont3_m650,1,checkpoints_selfplay_e9_sp_ckpt274,5_vs_5
5891,6,6,m_sp_arch_4x1_bt_32_r201_cont3_m650,0,checkpoints_selfplay_e9_sp_ckpt274,5_vs_5
5892,5,5,m_sp_arch_4x1_bt_32_r201_cont3_m650,0,checkpoints_selfplay_e9_sp_ckpt274,5_vs_5
5893,4,4,m_sp_arch_4x1_bt_32_r201_cont3_m650,0,checkpoints_selfplay_e9_sp_ckpt274,5_vs_5
5894,6,6,m_sp_arch_4x1_bt_32_r201_cont3_m650,0,checkpoints_selfplay_e9_sp_ckpt274,5_vs_5
5895,9,10,m_sp_arch_4x1_bt_32_r201_cont3_m650,1,checkpoints_selfplay_e9_sp_ckpt274,5_vs_5
5896,8,8,m_sp_arch_4x1_bt_32_r201_cont3_m650,0,checkpoints_selfplay_e9_sp_ckpt274,5_vs_5
5897,6,6,m_sp_arch_4x1_bt_32_r201_cont3_m650,0,checkpoints_selfplay_e9_sp_ckpt274,5_vs_5
5898,2,4,m_sp_arch_4x1_bt_32_r201_cont3_m650,2,checkpoints_selfplay_e9_sp_ckpt274,5_vs_5
5899,5,5,m_sp_arch_4x1_bt_32_r201_cont3_m650,0,checkpoints_selfplay_e9_sp_ckpt274,5_vs_5
5900,1,2,m_sp_arch_4x1_bt_32_r201_cont3_m650,1,checkpoints_sp_c_nb_e2_ckpt667,5_vs_5
5901,2,3,m_sp_arch_4x1_bt_32_r201_cont3_m650,1,checkpoints_sp_c_nb_e2_ckpt667,5_vs_5
5902,3,5,m_sp_arch_4x1_bt_32_r201_cont3_m650,2,checkpoints_sp_c_nb_e2_ckpt667,5_vs_5
5903,1,3,m_sp_arch_4x1_bt_32_r201_cont3_m650,2,checkpoints_sp_c_nb_e2_ckpt667,5_vs_5
5904,5,5,m_sp_arch_4x1_bt_32_r201_cont3_m650,0,checkpoints_sp_c_nb_e2_ckpt667,5_vs_5
5905,0,3,m_sp_arch_4x1_bt_32_r201_cont3_m650,3,checkpoints_sp_c_nb_e2_ckpt667,5_vs_5
5906,4,5,m_sp_arch_4x1_bt_32_r201_cont3_m650,1,checkpoints_sp_c_nb_e2_ckpt667,5_vs_5
5907,2,2,m_sp_arch_4x1_bt_32_r201_cont3_m650,0,checkpoints_sp_c_nb_e2_ckpt667,5_vs_5
5908,5,5,m_sp_arch_4x1_bt_32_r201_cont3_m650,0,checkpoints_sp_c_nb_e2_ckpt667,5_vs_5
5909,5,5,m_sp_arch_4x1_bt_32_r201_cont3_m650,0,checkpoints_sp_c_nb_e2_ckpt667,5_vs_5
5910,13,13,m_sp_arch_4x1_bt_32_r201_cont3_m650,0,scenario_curriculum_ckpt830,5_vs_5
5911,14,14,m_sp_arch_4x1_bt_32_r201_cont3_m650,0,scenario_curriculum_ckpt830,5_vs_5
5912,15,15,m_sp_arch_4x1_bt_32_r201_cont3_m650,0,scenario_curriculum_ckpt830,5_vs_5
5913,15,15,m_sp_arch_4x1_bt_32_r201_cont3_m650,0,scenario_curriculum_ckpt830,5_vs_5
5914,9,9,m_sp_arch_4x1_bt_32_r201_cont3_m650,0,scenario_curriculum_ckpt830,5_vs_5
5915,1,1,m_sp_arch_4x1_bt_32_r201_cont3_m650,0,scenario_curriculum_ckpt830,5_vs_5
5916,5,5,m_sp_arch_4x1_bt_32_r201_cont3_m650,0,scenario_curriculum_ckpt830,5_vs_5
5917,7,7,m_sp_arch_4x1_bt_32_r201_cont3_m650,0,scenario_curriculum_ckpt830,5_vs_5
5918,11,11,m_sp_arch_4x1_bt_32_r201_cont3_m650,0,scenario_curriculum_ckpt830,5_vs_5
5919,4,4,m_sp_arch_4x1_bt_32_r201_cont3_m650,0,scenario_curriculum_ckpt830,5_vs_5
5920,6,7,m_sp_arch_4x1_bt_32_r201_cont3_m650,1,m_sp_arch_medium_heads_conv16_0_bt_32_r313_m335,5_vs_5
5921,7,7,m_sp_arch_4x1_bt_32_r201_cont3_m650,0,m_sp_arch_medium_heads_conv16_0_bt_32_r313_m335,5_vs_5
5922,7,7,m_sp_arch_4x1_bt_32_r201_cont3_m650,0,m_sp_arch_medium_heads_conv16_0_bt_32_r313_m335,5_vs_5
5923,4,4,m_sp_arch_4x1_bt_32_r201_cont3_m650,0,m_sp_arch_medium_heads_conv16_0_bt_32_r313_m335,5_vs_5
5924,5,5,m_sp_arch_4x1_bt_32_r201_cont3_m650,0,m_sp_arch_medium_heads_conv16_0_bt_32_r313_m335,5_vs_5
5925,8,8,m_sp_arch_4x1_bt_32_r201_cont3_m650,0,m_sp_arch_medium_heads_conv16_0_bt_32_r313_m335,5_vs_5
5926,0,3,m_sp_arch_4x1_bt_32_r201_cont3_m650,3,m_sp_arch_medium_heads_conv16_0_bt_32_r313_m335,5_vs_5
5927,6,8,m_sp_arch_4x1_bt_32_r201_cont3_m650,2,m_sp_arch_medium_heads_conv16_0_bt_32_r313_m335,5_vs_5
5928,2,2,m_sp_arch_4x1_bt_32_r201_cont3_m650,0,m_sp_arch_medium_heads_conv16_0_bt_32_r313_m335,5_vs_5
5929,5,6,m_sp_arch_4x1_bt_32_r201_cont3_m650,1,m_sp_arch_medium_heads_conv16_0_bt_32_r313_m335,5_vs_5
5930,4,5,m_sp_arch_4x1_bt_32_r201_cont3_m650,1,m_sp_arch_longer_heads_bt_32_r201_m335,5_vs_5
5931,5,5,m_sp_arch_4x1_bt_32_r201_cont3_m650,0,m_sp_arch_longer_heads_bt_32_r201_m335,5_vs_5
5932,6,7,m_sp_arch_4x1_bt_32_r201_cont3_m650,1,m_sp_arch_longer_heads_bt_32_r201_m335,5_vs_5
5933,1,1,m_sp_arch_4x1_bt_32_r201_cont3_m650,0,m_sp_arch_longer_heads_bt_32_r201_m335,5_vs_5
5934,3,5,m_sp_arch_4x1_bt_32_r201_cont3_m650,2,m_sp_arch_longer_heads_bt_32_r201_m335,5_vs_5
5935,5,7,m_sp_arch_4x1_bt_32_r201_cont3_m650,2,m_sp_arch_longer_heads_bt_32_r201_m335,5_vs_5
5936,7,8,m_sp_arch_4x1_bt_32_r201_cont3_m650,1,m_sp_arch_longer_heads_bt_32_r201_m335,5_vs_5
5937,2,3,m_sp_arch_4x1_bt_32_r201_cont3_m650,1,m_sp_arch_longer_heads_bt_32_r201_m335,5_vs_5
5938,4,4,m_sp_arch_4x1_bt_32_r201_cont3_m650,0,m_sp_arch_longer_heads_bt_32_r201_m335,5_vs_5
5939,4,5,m_sp_arch_4x1_bt_32_r201_cont3_m650,1,m_sp_arch_longer_heads_bt_32_r201_m335,5_vs_5
5940,3,3,m_sp_arch_4x1_bt_32_r201_cont3_m650,0,m_sp_arch_medium_heads_bt_32_r201_m335,5_vs_5
5941,4,4,m_sp_arch_4x1_bt_32_r201_cont3_m650,0,m_sp_arch_medium_heads_bt_32_r201_m335,5_vs_5
5942,3,4,m_sp_arch_4x1_bt_32_r201_cont3_m650,1,m_sp_arch_medium_heads_bt_32_r201_m335,5_vs_5
5943,4,4,m_sp_arch_4x1_bt_32_r201_cont3_m650,0,m_sp_arch_medium_heads_bt_32_r201_m335,5_vs_5
5944,5,5,m_sp_arch_4x1_bt_32_r201_cont3_m650,0,m_sp_arch_medium_heads_bt_32_r201_m335,5_vs_5
5945,5,6,m_sp_arch_4x1_bt_32_r201_cont3_m650,1,m_sp_arch_medium_heads_bt_32_r201_m335,5_vs_5
5946,4,4,m_sp_arch_4x1_bt_32_r201_cont3_m650,0,m_sp_arch_medium_heads_bt_32_r201_m335,5_vs_5
5947,6,7,m_sp_arch_4x1_bt_32_r201_cont3_m650,1,m_sp_arch_medium_heads_bt_32_r201_m335,5_vs_5
5948,4,4,m_sp_arch_4x1_bt_32_r201_cont3_m650,0,m_sp_arch_medium_heads_bt_32_r201_m335,5_vs_5
5949,6,6,m_sp_arch_4x1_bt_32_r201_cont3_m650,0,m_sp_arch_medium_heads_bt_32_r201_m335,5_vs_5
5950,3,4,m_sp_arch_4x1_bt_32_r201_cont3_m650,1,m_sp_arch_4x1_bt_32_r201_m335,5_vs_5
5951,2,3,m_sp_arch_4x1_bt_32_r201_cont3_m650,1,m_sp_arch_4x1_bt_32_r201_m335,5_vs_5
5952,5,6,m_sp_arch_4x1_bt_32_r201_cont3_m650,1,m_sp_arch_4x1_bt_32_r201_m335,5_vs_5
5953,1,2,m_sp_arch_4x1_bt_32_r201_cont3_m650,1,m_sp_arch_4x1_bt_32_r201_m335,5_vs_5
5954,7,7,m_sp_arch_4x1_bt_32_r201_cont3_m650,0,m_sp_arch_4x1_bt_32_r201_m335,5_vs_5
5955,2,2,m_sp_arch_4x1_bt_32_r201_cont3_m650,0,m_sp_arch_4x1_bt_32_r201_m335,5_vs_5
5956,2,2,m_sp_arch_4x1_bt_32_r201_cont3_m650,0,m_sp_arch_4x1_bt_32_r201_m335,5_vs_5
5957,0,1,m_sp_arch_4x1_bt_32_r201_cont3_m650,1,m_sp_arch_4x1_bt_32_r201_m335,5_vs_5
5958,5,6,m_sp_arch_4x1_bt_32_r201_cont3_m650,1,m_sp_arch_4x1_bt_32_r201_m335,5_vs_5
5959,0,0,m_sp_arch_4x1_bt_32_r201_cont3_m650,0,m_sp_arch_4x1_bt_32_r201_m335,5_vs_5
5960,-3,1,m_sp_arch_4x1_bt_32_r201_cont3_m650,4,m_sp_arch_4x1_bt_32_r201_cont3_m650,5_vs_5
5961,1,2,m_sp_arch_4x1_bt_32_r201_cont3_m650,1,m_sp_arch_4x1_bt_32_r201_cont3_m650,5_vs_5
5962,0,1,m_sp_arch_4x1_bt_32_r201_cont3_m650,1,m_sp_arch_4x1_bt_32_r201_cont3_m650,5_vs_5
5963,-1,0,m_sp_arch_4x1_bt_32_r201_cont3_m650,1,m_sp_arch_4x1_bt_32_r201_cont3_m650,5_vs_5
5964,-2,0,m_sp_arch_4x1_bt_32_r201_cont3_m650,2,m_sp_arch_4x1_bt_32_r201_cont3_m650,5_vs_5
5965,-1,2,m_sp_arch_4x1_bt_32_r201_cont3_m650,3,m_sp_arch_4x1_bt_32_r201_cont3_m650,5_vs_5
5966,-2,0,m_sp_arch_4x1_bt_32_r201_cont3_m650,2,m_sp_arch_4x1_bt_32_r201_cont3_m650,5_vs_5
5967,0,0,m_sp_arch_4x1_bt_32_r201_cont3_m650,0,m_sp_arch_4x1_bt_32_r201_cont3_m650,5_vs_5
5968,-1,3,m_sp_arch_4x1_bt_32_r201_cont3_m650,4,m_sp_arch_4x1_bt_32_r201_cont3_m650,5_vs_5
5969,0,0,m_sp_arch_4x1_bt_32_r201_cont3_m650,0,m_sp_arch_4x1_bt_32_r201_cont3_m650,5_vs_5
5970,2,3,m_sp_arch_4x1_bt_32_r201_cont3_m650,1,explt_v0_7_2_m54,5_vs_5
5971,-1,2,m_sp_arch_4x1_bt_32_r201_cont3_m650,3,explt_v0_7_2_m54,5_vs_5
5972,0,2,m_sp_arch_4x1_bt_32_r201_cont3_m650,2,explt_v0_7_2_m54,5_vs_5
5973,-2,1,m_sp_arch_4x1_bt_32_r201_cont3_m650,3,explt_v0_7_2_m54,5_vs_5
5974,1,2,m_sp_arch_4x1_bt_32_r201_cont3_m650,1,explt_v0_7_2_m54,5_vs_5
5975,-1,1,m_sp_arch_4x1_bt_32_r201_cont3_m650,2,explt_v0_7_2_m54,5_vs_5
5976,-3,1,m_sp_arch_4x1_bt_32_r201_cont3_m650,4,explt_v0_7_2_m54,5_vs_5
5977,-3,0,m_sp_arch_4x1_bt_32_r201_cont3_m650,3,explt_v0_7_2_m54,5_vs_5
5978,-1,2,m_sp_arch_4x1_bt_32_r201_cont3_m650,3,explt_v0_7_2_m54,5_vs_5
5979,-4,0,m_sp_arch_4x1_bt_32_r201_cont3_m650,4,explt_v0_7_2_m54,5_vs_5
5980,3,3,m_sp_arch_4x1_bt_32_r201_cont3_m650,0,m_sp_sc3v3_arch_2x1_32_r500_cont4x1_m224,5_vs_5
5981,1,1,m_sp_arch_4x1_bt_32_r201_cont3_m650,0,m_sp_sc3v3_arch_2x1_32_r500_cont4x1_m224,5_vs_5
5982,3,5,m_sp_arch_4x1_bt_32_r201_cont3_m650,2,m_sp_sc3v3_arch_2x1_32_r500_cont4x1_m224,5_vs_5
5983,3,4,m_sp_arch_4x1_bt_32_r201_cont3_m650,1,m_sp_sc3v3_arch_2x1_32_r500_cont4x1_m224,5_vs_5
5984,1,1,m_sp_arch_4x1_bt_32_r201_cont3_m650,0,m_sp_sc3v3_arch_2x1_32_r500_cont4x1_m224,5_vs_5
5985,3,6,m_sp_arch_4x1_bt_32_r201_cont3_m650,3,m_sp_sc3v3_arch_2x1_32_r500_cont4x1_m224,5_vs_5
5986,-1,1,m_sp_arch_4x1_bt_32_r201_cont3_m650,2,m_sp_sc3v3_arch_2x1_32_r500_cont4x1_m224,5_vs_5
5987,4,4,m_sp_arch_4x1_bt_32_r201_cont3_m650,0,m_sp_sc3v3_arch_2x1_32_r500_cont4x1_m224,5_vs_5
5988,6,7,m_sp_arch_4x1_bt_32_r201_cont3_m650,1,m_sp_sc3v3_arch_2x1_32_r500_cont4x1_m224,5_vs_5
5989,-1,2,m_sp_arch_4x1_bt_32_r201_cont3_m650,3,m_sp_sc3v3_arch_2x1_32_r500_cont4x1_m224,5_vs_5
5990,2,3,m_sp_arch_4x1_bt_32_r201_cont3_m650,1,m_sp_arch_4x1_bt_32_roles_r500_m335,5_vs_5
5991,4,5,m_sp_arch_4x1_bt_32_r201_cont3_m650,1,m_sp_arch_4x1_bt_32_roles_r500_m335,5_vs_5
5992,2,2,m_sp_arch_4x1_bt_32_r201_cont3_m650,0,m_sp_arch_4x1_bt_32_roles_r500_m335,5_vs_5
5993,0,0,m_sp_arch_4x1_bt_32_r201_cont3_m650,0,m_sp_arch_4x1_bt_32_roles_r500_m335,5_vs_5
5994,0,3,m_sp_arch_4x1_bt_32_r201_cont3_m650,3,m_sp_arch_4x1_bt_32_roles_r500_m335,5_vs_5
5995,1,2,m_sp_arch_4x1_bt_32_r201_cont3_m650,1,m_sp_arch_4x1_bt_32_roles_r500_m335,5_vs_5
5996,0,3,m_sp_arch_4x1_bt_32_r201_cont3_m650,3,m_sp_arch_4x1_bt_32_roles_r500_m335,5_vs_5
5997,0,0,m_sp_arch_4x1_bt_32_r201_cont3_m650,0,m_sp_arch_4x1_bt_32_roles_r500_m335,5_vs_5
5998,3,3,m_sp_arch_4x1_bt_32_r201_cont3_m650,0,m_sp_arch_4x1_bt_32_roles_r500_m335,5_vs_5
5999,-1,0,m_sp_arch_4x1_bt_32_r201_cont3_m650,1,m_sp_arch_4x1_bt_32_roles_r500_m335,5_vs_5
6000,2,3,m_sp_arch_4x1_bt_32_roles_r500_m335,1,easy_bots,5_vs_5
6001,-2,0,m_sp_arch_4x1_bt_32_roles_r500_m335,2,easy_bots,5_vs_5
6002,0,1,m_sp_arch_4x1_bt_32_roles_r500_m335,1,easy_bots,5_vs_5
6003,3,4,m_sp_arch_4x1_bt_32_roles_r500_m335,1,easy_bots,5_vs_5
6004,3,3,m_sp_arch_4x1_bt_32_roles_r500_m335,0,easy_bots,5_vs_5
6005,-1,1,m_sp_arch_4x1_bt_32_roles_r500_m335,2,easy_bots,5_vs_5
6006,1,2,m_sp_arch_4x1_bt_32_roles_r500_m335,1,easy_bots,5_vs_5
6007,3,3,m_sp_arch_4x1_bt_32_roles_r500_m335,0,easy_bots,5_vs_5
6008,2,2,m_sp_arch_4x1_bt_32_roles_r500_m335,0,easy_bots,5_vs_5
6009,2,2,m_sp_arch_4x1_bt_32_roles_r500_m335,0,easy_bots,5_vs_5
6010,3,4,m_sp_arch_4x1_bt_32_roles_r500_m335,1,easy_bots,5_vs_5
6011,2,3,m_sp_arch_4x1_bt_32_roles_r500_m335,1,easy_bots,5_vs_5
6012,3,3,m_sp_arch_4x1_bt_32_roles_r500_m335,0,easy_bots,5_vs_5
6013,3,4,m_sp_arch_4x1_bt_32_roles_r500_m335,1,easy_bots,5_vs_5
6014,2,2,m_sp_arch_4x1_bt_32_roles_r500_m335,0,easy_bots,5_vs_5
6015,2,3,m_sp_arch_4x1_bt_32_roles_r500_m335,1,easy_bots,5_vs_5
6016,2,3,m_sp_arch_4x1_bt_32_roles_r500_m335,1,easy_bots,5_vs_5
6017,4,5,m_sp_arch_4x1_bt_32_roles_r500_m335,1,easy_bots,5_vs_5
6018,3,4,m_sp_arch_4x1_bt_32_roles_r500_m335,1,easy_bots,5_vs_5
6019,3,4,m_sp_arch_4x1_bt_32_roles_r500_m335,1,easy_bots,5_vs_5
6020,1,2,m_sp_arch_4x1_bt_32_roles_r500_m335,1,medium_bots,5_vs_5_medium
6021,1,3,m_sp_arch_4x1_bt_32_roles_r500_m335,2,medium_bots,5_vs_5_medium
6022,2,3,m_sp_arch_4x1_bt_32_roles_r500_m335,1,medium_bots,5_vs_5_medium
6023,-1,1,m_sp_arch_4x1_bt_32_roles_r500_m335,2,medium_bots,5_vs_5_medium
6024,0,1,m_sp_arch_4x1_bt_32_roles_r500_m335,1,medium_bots,5_vs_5_medium
6025,1,1,m_sp_arch_4x1_bt_32_roles_r500_m335,0,medium_bots,5_vs_5_medium
6026,-1,2,m_sp_arch_4x1_bt_32_roles_r500_m335,3,medium_bots,5_vs_5_medium
6027,-1,2,m_sp_arch_4x1_bt_32_roles_r500_m335,3,medium_bots,5_vs_5_medium
6028,1,2,m_sp_arch_4x1_bt_32_roles_r500_m335,1,medium_bots,5_vs_5_medium
6029,1,1,m_sp_arch_4x1_bt_32_roles_r500_m335,0,medium_bots,5_vs_5_medium
6030,2,2,m_sp_arch_4x1_bt_32_roles_r500_m335,0,medium_bots,5_vs_5_medium
6031,0,0,m_sp_arch_4x1_bt_32_roles_r500_m335,0,medium_bots,5_vs_5_medium
6032,0,1,m_sp_arch_4x1_bt_32_roles_r500_m335,1,medium_bots,5_vs_5_medium
6033,-2,0,m_sp_arch_4x1_bt_32_roles_r500_m335,2,medium_bots,5_vs_5_medium
6034,3,3,m_sp_arch_4x1_bt_32_roles_r500_m335,0,medium_bots,5_vs_5_medium
6035,2,2,m_sp_arch_4x1_bt_32_roles_r500_m335,0,medium_bots,5_vs_5_medium
6036,1,2,m_sp_arch_4x1_bt_32_roles_r500_m335,1,medium_bots,5_vs_5_medium
6037,2,3,m_sp_arch_4x1_bt_32_roles_r500_m335,1,medium_bots,5_vs_5_medium
6038,-1,2,m_sp_arch_4x1_bt_32_roles_r500_m335,3,medium_bots,5_vs_5_medium
6039,3,3,m_sp_arch_4x1_bt_32_roles_r500_m335,0,medium_bots,5_vs_5_medium
6040,0,0,m_sp_arch_4x1_bt_32_roles_r500_m335,0,hard_bots,5_vs_5_hard
6041,-1,0,m_sp_arch_4x1_bt_32_roles_r500_m335,1,hard_bots,5_vs_5_hard
6042,-1,0,m_sp_arch_4x1_bt_32_roles_r500_m335,1,hard_bots,5_vs_5_hard
6043,-1,0,m_sp_arch_4x1_bt_32_roles_r500_m335,1,hard_bots,5_vs_5_hard
6044,0,1,m_sp_arch_4x1_bt_32_roles_r500_m335,1,hard_bots,5_vs_5_hard
6045,-2,0,m_sp_arch_4x1_bt_32_roles_r500_m335,2,hard_bots,5_vs_5_hard
6046,-1,0,m_sp_arch_4x1_bt_32_roles_r500_m335,1,hard_bots,5_vs_5_hard
6047,0,0,m_sp_arch_4x1_bt_32_roles_r500_m335,0,hard_bots,5_vs_5_hard
6048,0,0,m_sp_arch_4x1_bt_32_roles_r500_m335,0,hard_bots,5_vs_5_hard
6049,-1,1,m_sp_arch_4x1_bt_32_roles_r500_m335,2,hard_bots,5_vs_5_hard
6050,0,0,m_sp_arch_4x1_bt_32_roles_r500_m335,0,hard_bots,5_vs_5_hard
6051,0,1,m_sp_arch_4x1_bt_32_roles_r500_m335,1,hard_bots,5_vs_5_hard
6052,0,0,m_sp_arch_4x1_bt_32_roles_r500_m335,0,hard_bots,5_vs_5_hard
6053,0,1,m_sp_arch_4x1_bt_32_roles_r500_m335,1,hard_bots,5_vs_5_hard
6054,2,2,m_sp_arch_4x1_bt_32_roles_r500_m335,0,hard_bots,5_vs_5_hard
6055,0,1,m_sp_arch_4x1_bt_32_roles_r500_m335,1,hard_bots,5_vs_5_hard
6056,-2,1,m_sp_arch_4x1_bt_32_roles_r500_m335,3,hard_bots,5_vs_5_hard
6057,-1,0,m_sp_arch_4x1_bt_32_roles_r500_m335,1,hard_bots,5_vs_5_hard
6058,-1,0,m_sp_arch_4x1_bt_32_roles_r500_m335,1,hard_bots,5_vs_5_hard
6059,-2,0,m_sp_arch_4x1_bt_32_roles_r500_m335,2,hard_bots,5_vs_5_hard
6060,14,16,m_sp_arch_4x1_bt_32_roles_r500_m335,2,f5v0to1to2t05_e2_ckpt291,5_vs_5
6061,12,14,m_sp_arch_4x1_bt_32_roles_r500_m335,2,f5v0to1to2t05_e2_ckpt291,5_vs_5
6062,11,11,m_sp_arch_4x1_bt_32_roles_r500_m335,0,f5v0to1to2t05_e2_ckpt291,5_vs_5
6063,7,10,m_sp_arch_4x1_bt_32_roles_r500_m335,3,f5v0to1to2t05_e2_ckpt291,5_vs_5
6064,7,8,m_sp_arch_4x1_bt_32_roles_r500_m335,1,f5v0to1to2t05_e2_ckpt291,5_vs_5
6065,9,10,m_sp_arch_4x1_bt_32_roles_r500_m335,1,f5v0to1to2t05_e2_ckpt291,5_vs_5
6066,8,9,m_sp_arch_4x1_bt_32_roles_r500_m335,1,f5v0to1to2t05_e2_ckpt291,5_vs_5
6067,11,12,m_sp_arch_4x1_bt_32_roles_r500_m335,1,f5v0to1to2t05_e2_ckpt291,5_vs_5
6068,11,13,m_sp_arch_4x1_bt_32_roles_r500_m335,2,f5v0to1to2t05_e2_ckpt291,5_vs_5
6069,9,9,m_sp_arch_4x1_bt_32_roles_r500_m335,0,f5v0to1to2t05_e2_ckpt291,5_vs_5
6070,10,10,m_sp_arch_4x1_bt_32_roles_r500_m335,0,f5v0to1to5_e2_ckpt252,5_vs_5
6071,11,11,m_sp_arch_4x1_bt_32_roles_r500_m335,0,f5v0to1to5_e2_ckpt252,5_vs_5
6072,12,12,m_sp_arch_4x1_bt_32_roles_r500_m335,0,f5v0to1to5_e2_ckpt252,5_vs_5
6073,11,11,m_sp_arch_4x1_bt_32_roles_r500_m335,0,f5v0to1to5_e2_ckpt252,5_vs_5
6074,8,9,m_sp_arch_4x1_bt_32_roles_r500_m335,1,f5v0to1to5_e2_ckpt252,5_vs_5
6075,13,14,m_sp_arch_4x1_bt_32_roles_r500_m335,1,f5v0to1to5_e2_ckpt252,5_vs_5
6076,12,13,m_sp_arch_4x1_bt_32_roles_r500_m335,1,f5v0to1to5_e2_ckpt252,5_vs_5
6077,8,10,m_sp_arch_4x1_bt_32_roles_r500_m335,2,f5v0to1to5_e2_ckpt252,5_vs_5
6078,10,10,m_sp_arch_4x1_bt_32_roles_r500_m335,0,f5v0to1to5_e2_ckpt252,5_vs_5
6079,9,9,m_sp_arch_4x1_bt_32_roles_r500_m335,0,f5v0to1to5_e2_ckpt252,5_vs_5
6080,8,9,m_sp_arch_4x1_bt_32_roles_r500_m335,1,scon_e3_p2_hard_ckpt840,5_vs_5
6081,17,17,m_sp_arch_4x1_bt_32_roles_r500_m335,0,scon_e3_p2_hard_ckpt840,5_vs_5
6082,15,15,m_sp_arch_4x1_bt_32_roles_r500_m335,0,scon_e3_p2_hard_ckpt840,5_vs_5
6083,12,12,m_sp_arch_4x1_bt_32_roles_r500_m335,0,scon_e3_p2_hard_ckpt840,5_vs_5
6084,10,10,m_sp_arch_4x1_bt_32_roles_r500_m335,0,scon_e3_p2_hard_ckpt840,5_vs_5
6085,9,9,m_sp_arch_4x1_bt_32_roles_r500_m335,0,scon_e3_p2_hard_ckpt840,5_vs_5
6086,15,15,m_sp_arch_4x1_bt_32_roles_r500_m335,0,scon_e3_p2_hard_ckpt840,5_vs_5
6087,11,11,m_sp_arch_4x1_bt_32_roles_r500_m335,0,scon_e3_p2_hard_ckpt840,5_vs_5
6088,14,14,m_sp_arch_4x1_bt_32_roles_r500_m335,0,scon_e3_p2_hard_ckpt840,5_vs_5
6089,13,13,m_sp_arch_4x1_bt_32_roles_r500_m335,0,scon_e3_p2_hard_ckpt840,5_vs_5
6090,11,11,m_sp_arch_4x1_bt_32_roles_r500_m335,0,less_then_partially_randomized_checkpoints_bots_4_heads_38_ckpt108,5_vs_5
6091,13,13,m_sp_arch_4x1_bt_32_roles_r500_m335,0,less_then_partially_randomized_checkpoints_bots_4_heads_38_ckpt108,5_vs_5
6092,16,16,m_sp_arch_4x1_bt_32_roles_r500_m335,0,less_then_partially_randomized_checkpoints_bots_4_heads_38_ckpt108,5_vs_5
6093,9,9,m_sp_arch_4x1_bt_32_roles_r500_m335,0,less_then_partially_randomized_checkpoints_bots_4_heads_38_ckpt108,5_vs_5
6094,7,8,m_sp_arch_4x1_bt_32_roles_r500_m335,1,less_then_partially_randomized_checkpoints_bots_4_heads_38_ckpt108,5_vs_5
6095,11,11,m_sp_arch_4x1_bt_32_roles_r500_m335,0,less_then_partially_randomized_checkpoints_bots_4_heads_38_ckpt108,5_vs_5
6096,12,12,m_sp_arch_4x1_bt_32_roles_r500_m335,0,less_then_partially_randomized_checkpoints_bots_4_heads_38_ckpt108,5_vs_5
6097,13,15,m_sp_arch_4x1_bt_32_roles_r500_m335,2,less_then_partially_randomized_checkpoints_bots_4_heads_38_ckpt108,5_vs_5
6098,8,9,m_sp_arch_4x1_bt_32_roles_r500_m335,1,less_then_partially_randomized_checkpoints_bots_4_heads_38_ckpt108,5_vs_5
6099,10,10,m_sp_arch_4x1_bt_32_roles_r500_m335,0,less_then_partially_randomized_checkpoints_bots_4_heads_38_ckpt108,5_vs_5
6100,10,10,m_sp_arch_4x1_bt_32_roles_r500_m335,0,less_then_partially_randomized_entropy_checkpoints_bots_4_heads_39_ckpt109,5_vs_5
6101,14,14,m_sp_arch_4x1_bt_32_roles_r500_m335,0,less_then_partially_randomized_entropy_checkpoints_bots_4_heads_39_ckpt109,5_vs_5
6102,13,13,m_sp_arch_4x1_bt_32_roles_r500_m335,0,less_then_partially_randomized_entropy_checkpoints_bots_4_heads_39_ckpt109,5_vs_5
6103,14,15,m_sp_arch_4x1_bt_32_roles_r500_m335,1,less_then_partially_randomized_entropy_checkpoints_bots_4_heads_39_ckpt109,5_vs_5
6104,18,18,m_sp_arch_4x1_bt_32_roles_r500_m335,0,less_then_partially_randomized_entropy_checkpoints_bots_4_heads_39_ckpt109,5_vs_5
6105,9,9,m_sp_arch_4x1_bt_32_roles_r500_m335,0,less_then_partially_randomized_entropy_checkpoints_bots_4_heads_39_ckpt109,5_vs_5
6106,13,14,m_sp_arch_4x1_bt_32_roles_r500_m335,1,less_then_partially_randomized_entropy_checkpoints_bots_4_heads_39_ckpt109,5_vs_5
6107,11,11,m_sp_arch_4x1_bt_32_roles_r500_m335,0,less_then_partially_randomized_entropy_checkpoints_bots_4_heads_39_ckpt109,5_vs_5
6108,17,17,m_sp_arch_4x1_bt_32_roles_r500_m335,0,less_then_partially_randomized_entropy_checkpoints_bots_4_heads_39_ckpt109,5_vs_5
6109,6,6,m_sp_arch_4x1_bt_32_roles_r500_m335,0,less_then_partially_randomized_entropy_checkpoints_bots_4_heads_39_ckpt109,5_vs_5
6110,13,13,m_sp_arch_4x1_bt_32_roles_r500_m335,0,reward_shaping_checkpoints_bots_4_heads_1_ckpt360,5_vs_5
6111,13,13,m_sp_arch_4x1_bt_32_roles_r500_m335,0,reward_shaping_checkpoints_bots_4_heads_1_ckpt360,5_vs_5
6112,11,11,m_sp_arch_4x1_bt_32_roles_r500_m335,0,reward_shaping_checkpoints_bots_4_heads_1_ckpt360,5_vs_5
6113,9,10,m_sp_arch_4x1_bt_32_roles_r500_m335,1,reward_shaping_checkpoints_bots_4_heads_1_ckpt360,5_vs_5
6114,16,16,m_sp_arch_4x1_bt_32_roles_r500_m335,0,reward_shaping_checkpoints_bots_4_heads_1_ckpt360,5_vs_5
6115,15,17,m_sp_arch_4x1_bt_32_roles_r500_m335,2,reward_shaping_checkpoints_bots_4_heads_1_ckpt360,5_vs_5
6116,8,8,m_sp_arch_4x1_bt_32_roles_r500_m335,0,reward_shaping_checkpoints_bots_4_heads_1_ckpt360,5_vs_5
6117,14,15,m_sp_arch_4x1_bt_32_roles_r500_m335,1,reward_shaping_checkpoints_bots_4_heads_1_ckpt360,5_vs_5
6118,10,10,m_sp_arch_4x1_bt_32_roles_r500_m335,0,reward_shaping_checkpoints_bots_4_heads_1_ckpt360,5_vs_5
6119,10,10,m_sp_arch_4x1_bt_32_roles_r500_m335,0,reward_shaping_checkpoints_bots_4_heads_1_ckpt360,5_vs_5
6120,-1,3,m_sp_arch_4x1_bt_32_roles_r500_m335,4,checkpoints_selfplay_e9_sp_ckpt274,5_vs_5
6121,4,5,m_sp_arch_4x1_bt_32_roles_r500_m335,1,checkpoints_selfplay_e9_sp_ckpt274,5_vs_5
6122,4,7,m_sp_arch_4x1_bt_32_roles_r500_m335,3,checkpoints_selfplay_e9_sp_ckpt274,5_vs_5
6123,7,8,m_sp_arch_4x1_bt_32_roles_r500_m335,1,checkpoints_selfplay_e9_sp_ckpt274,5_vs_5
6124,3,6,m_sp_arch_4x1_bt_32_roles_r500_m335,3,checkpoints_selfplay_e9_sp_ckpt274,5_vs_5
6125,0,5,m_sp_arch_4x1_bt_32_roles_r500_m335,5,checkpoints_selfplay_e9_sp_ckpt274,5_vs_5
6126,6,6,m_sp_arch_4x1_bt_32_roles_r500_m335,0,checkpoints_selfplay_e9_sp_ckpt274,5_vs_5
6127,7,8,m_sp_arch_4x1_bt_32_roles_r500_m335,1,checkpoints_selfplay_e9_sp_ckpt274,5_vs_5
6128,3,4,m_sp_arch_4x1_bt_32_roles_r500_m335,1,checkpoints_selfplay_e9_sp_ckpt274,5_vs_5
6129,6,6,m_sp_arch_4x1_bt_32_roles_r500_m335,0,checkpoints_selfplay_e9_sp_ckpt274,5_vs_5
6130,4,5,m_sp_arch_4x1_bt_32_roles_r500_m335,1,checkpoints_sp_c_nb_e2_ckpt667,5_vs_5
6131,-1,4,m_sp_arch_4x1_bt_32_roles_r500_m335,5,checkpoints_sp_c_nb_e2_ckpt667,5_vs_5
6132,5,5,m_sp_arch_4x1_bt_32_roles_r500_m335,0,checkpoints_sp_c_nb_e2_ckpt667,5_vs_5
6133,4,6,m_sp_arch_4x1_bt_32_roles_r500_m335,2,checkpoints_sp_c_nb_e2_ckpt667,5_vs_5
6134,4,4,m_sp_arch_4x1_bt_32_roles_r500_m335,0,checkpoints_sp_c_nb_e2_ckpt667,5_vs_5
6135,1,4,m_sp_arch_4x1_bt_32_roles_r500_m335,3,checkpoints_sp_c_nb_e2_ckpt667,5_vs_5
6136,5,5,m_sp_arch_4x1_bt_32_roles_r500_m335,0,checkpoints_sp_c_nb_e2_ckpt667,5_vs_5
6137,0,3,m_sp_arch_4x1_bt_32_roles_r500_m335,3,checkpoints_sp_c_nb_e2_ckpt667,5_vs_5
6138,5,6,m_sp_arch_4x1_bt_32_roles_r500_m335,1,checkpoints_sp_c_nb_e2_ckpt667,5_vs_5
6139,2,6,m_sp_arch_4x1_bt_32_roles_r500_m335,4,checkpoints_sp_c_nb_e2_ckpt667,5_vs_5
6140,11,11,m_sp_arch_4x1_bt_32_roles_r500_m335,0,scenario_curriculum_ckpt830,5_vs_5
6141,12,12,m_sp_arch_4x1_bt_32_roles_r500_m335,0,scenario_curriculum_ckpt830,5_vs_5
6142,9,9,m_sp_arch_4x1_bt_32_roles_r500_m335,0,scenario_curriculum_ckpt830,5_vs_5
6143,7,7,m_sp_arch_4x1_bt_32_roles_r500_m335,0,scenario_curriculum_ckpt830,5_vs_5
6144,14,14,m_sp_arch_4x1_bt_32_roles_r500_m335,0,scenario_curriculum_ckpt830,5_vs_5
6145,13,13,m_sp_arch_4x1_bt_32_roles_r500_m335,0,scenario_curriculum_ckpt830,5_vs_5
6146,12,12,m_sp_arch_4x1_bt_32_roles_r500_m335,0,scenario_curriculum_ckpt830,5_vs_5
6147,14,14,m_sp_arch_4x1_bt_32_roles_r500_m335,0,scenario_curriculum_ckpt830,5_vs_5
6148,9,9,m_sp_arch_4x1_bt_32_roles_r500_m335,0,scenario_curriculum_ckpt830,5_vs_5
6149,9,9,m_sp_arch_4x1_bt_32_roles_r500_m335,0,scenario_curriculum_ckpt830,5_vs_5
6150,9,9,m_sp_arch_4x1_bt_32_roles_r500_m335,0,m_sp_arch_medium_heads_conv16_0_bt_32_r313_m335,5_vs_5
6151,2,5,m_sp_arch_4x1_bt_32_roles_r500_m335,3,m_sp_arch_medium_heads_conv16_0_bt_32_r313_m335,5_vs_5
6152,4,5,m_sp_arch_4x1_bt_32_roles_r500_m335,1,m_sp_arch_medium_heads_conv16_0_bt_32_r313_m335,5_vs_5
6153,10,10,m_sp_arch_4x1_bt_32_roles_r500_m335,0,m_sp_arch_medium_heads_conv16_0_bt_32_r313_m335,5_vs_5
6154,5,7,m_sp_arch_4x1_bt_32_roles_r500_m335,2,m_sp_arch_medium_heads_conv16_0_bt_32_r313_m335,5_vs_5
6155,4,4,m_sp_arch_4x1_bt_32_roles_r500_m335,0,m_sp_arch_medium_heads_conv16_0_bt_32_r313_m335,5_vs_5
6156,8,8,m_sp_arch_4x1_bt_32_roles_r500_m335,0,m_sp_arch_medium_heads_conv16_0_bt_32_r313_m335,5_vs_5
6157,2,3,m_sp_arch_4x1_bt_32_roles_r500_m335,1,m_sp_arch_medium_heads_conv16_0_bt_32_r313_m335,5_vs_5
6158,5,8,m_sp_arch_4x1_bt_32_roles_r500_m335,3,m_sp_arch_medium_heads_conv16_0_bt_32_r313_m335,5_vs_5
6159,7,7,m_sp_arch_4x1_bt_32_roles_r500_m335,0,m_sp_arch_medium_heads_conv16_0_bt_32_r313_m335,5_vs_5
6160,3,5,m_sp_arch_4x1_bt_32_roles_r500_m335,2,m_sp_arch_longer_heads_bt_32_r201_m335,5_vs_5
6161,6,8,m_sp_arch_4x1_bt_32_roles_r500_m335,2,m_sp_arch_longer_heads_bt_32_r201_m335,5_vs_5
6162,1,4,m_sp_arch_4x1_bt_32_roles_r500_m335,3,m_sp_arch_longer_heads_bt_32_r201_m335,5_vs_5
6163,4,5,m_sp_arch_4x1_bt_32_roles_r500_m335,1,m_sp_arch_longer_heads_bt_32_r201_m335,5_vs_5
6164,-2,3,m_sp_arch_4x1_bt_32_roles_r500_m335,5,m_sp_arch_longer_heads_bt_32_r201_m335,5_vs_5
6165,2,4,m_sp_arch_4x1_bt_32_roles_r500_m335,2,m_sp_arch_longer_heads_bt_32_r201_m335,5_vs_5
6166,5,6,m_sp_arch_4x1_bt_32_roles_r500_m335,1,m_sp_arch_longer_heads_bt_32_r201_m335,5_vs_5
6167,4,5,m_sp_arch_4x1_bt_32_roles_r500_m335,1,m_sp_arch_longer_heads_bt_32_r201_m335,5_vs_5
6168,6,7,m_sp_arch_4x1_bt_32_roles_r500_m335,1,m_sp_arch_longer_heads_bt_32_r201_m335,5_vs_5
6169,2,4,m_sp_arch_4x1_bt_32_roles_r500_m335,2,m_sp_arch_longer_heads_bt_32_r201_m335,5_vs_5
6170,7,8,m_sp_arch_4x1_bt_32_roles_r500_m335,1,m_sp_arch_medium_heads_bt_32_r201_m335,5_vs_5
6171,0,2,m_sp_arch_4x1_bt_32_roles_r500_m335,2,m_sp_arch_medium_heads_bt_32_r201_m335,5_vs_5
6172,3,5,m_sp_arch_4x1_bt_32_roles_r500_m335,2,m_sp_arch_medium_heads_bt_32_r201_m335,5_vs_5
6173,3,5,m_sp_arch_4x1_bt_32_roles_r500_m335,2,m_sp_arch_medium_heads_bt_32_r201_m335,5_vs_5
6174,9,10,m_sp_arch_4x1_bt_32_roles_r500_m335,1,m_sp_arch_medium_heads_bt_32_r201_m335,5_vs_5
6175,3,4,m_sp_arch_4x1_bt_32_roles_r500_m335,1,m_sp_arch_medium_heads_bt_32_r201_m335,5_vs_5
6176,3,4,m_sp_arch_4x1_bt_32_roles_r500_m335,1,m_sp_arch_medium_heads_bt_32_r201_m335,5_vs_5
6177,8,9,m_sp_arch_4x1_bt_32_roles_r500_m335,1,m_sp_arch_medium_heads_bt_32_r201_m335,5_vs_5
6178,5,6,m_sp_arch_4x1_bt_32_roles_r500_m335,1,m_sp_arch_medium_heads_bt_32_r201_m335,5_vs_5
6179,8,8,m_sp_arch_4x1_bt_32_roles_r500_m335,0,m_sp_arch_medium_heads_bt_32_r201_m335,5_vs_5
6180,0,1,m_sp_arch_4x1_bt_32_roles_r500_m335,1,m_sp_arch_4x1_bt_32_r201_m335,5_vs_5
6181,0,1,m_sp_arch_4x1_bt_32_roles_r500_m335,1,m_sp_arch_4x1_bt_32_r201_m335,5_vs_5
6182,0,2,m_sp_arch_4x1_bt_32_roles_r500_m335,2,m_sp_arch_4x1_bt_32_r201_m335,5_vs_5
6183,0,1,m_sp_arch_4x1_bt_32_roles_r500_m335,1,m_sp_arch_4x1_bt_32_r201_m335,5_vs_5
6184,-2,2,m_sp_arch_4x1_bt_32_roles_r500_m335,4,m_sp_arch_4x1_bt_32_r201_m335,5_vs_5
6185,1,1,m_sp_arch_4x1_bt_32_roles_r500_m335,0,m_sp_arch_4x1_bt_32_r201_m335,5_vs_5
6186,-1,1,m_sp_arch_4x1_bt_32_roles_r500_m335,2,m_sp_arch_4x1_bt_32_r201_m335,5_vs_5
6187,3,3,m_sp_arch_4x1_bt_32_roles_r500_m335,0,m_sp_arch_4x1_bt_32_r201_m335,5_vs_5
6188,0,0,m_sp_arch_4x1_bt_32_roles_r500_m335,0,m_sp_arch_4x1_bt_32_r201_m335,5_vs_5
6189,0,1,m_sp_arch_4x1_bt_32_roles_r500_m335,1,m_sp_arch_4x1_bt_32_r201_m335,5_vs_5
6190,-4,1,m_sp_arch_4x1_bt_32_roles_r500_m335,5,m_sp_arch_4x1_bt_32_r201_cont3_m650,5_vs_5
6191,-4,1,m_sp_arch_4x1_bt_32_roles_r500_m335,5,m_sp_arch_4x1_bt_32_r201_cont3_m650,5_vs_5
6192,-2,0,m_sp_arch_4x1_bt_32_roles_r500_m335,2,m_sp_arch_4x1_bt_32_r201_cont3_m650,5_vs_5
6193,-1,2,m_sp_arch_4x1_bt_32_roles_r500_m335,3,m_sp_arch_4x1_bt_32_r201_cont3_m650,5_vs_5
6194,1,3,m_sp_arch_4x1_bt_32_roles_r500_m335,2,m_sp_arch_4x1_bt_32_r201_cont3_m650,5_vs_5
6195,1,2,m_sp_arch_4x1_bt_32_roles_r500_m335,1,m_sp_arch_4x1_bt_32_r201_cont3_m650,5_vs_5
6196,-3,0,m_sp_arch_4x1_bt_32_roles_r500_m335,3,m_sp_arch_4x1_bt_32_r201_cont3_m650,5_vs_5
6197,-1,4,m_sp_arch_4x1_bt_32_roles_r500_m335,5,m_sp_arch_4x1_bt_32_r201_cont3_m650,5_vs_5
6198,1,2,m_sp_arch_4x1_bt_32_roles_r500_m335,1,m_sp_arch_4x1_bt_32_r201_cont3_m650,5_vs_5
6199,-1,1,m_sp_arch_4x1_bt_32_roles_r500_m335,2,m_sp_arch_4x1_bt_32_r201_cont3_m650,5_vs_5
6200,0,1,m_sp_arch_4x1_bt_32_roles_r500_m335,1,explt_v0_7_2_m54,5_vs_5
6201,1,2,m_sp_arch_4x1_bt_32_roles_r500_m335,1,explt_v0_7_2_m54,5_vs_5
6202,-1,0,m_sp_arch_4x1_bt_32_roles_r500_m335,1,explt_v0_7_2_m54,5_vs_5
6203,0,3,m_sp_arch_4x1_bt_32_roles_r500_m335,3,explt_v0_7_2_m54,5_vs_5
6204,1,4,m_sp_arch_4x1_bt_32_roles_r500_m335,3,explt_v0_7_2_m54,5_vs_5
6205,-2,1,m_sp_arch_4x1_bt_32_roles_r500_m335,3,explt_v0_7_2_m54,5_vs_5
6206,0,1,m_sp_arch_4x1_bt_32_roles_r500_m335,1,explt_v0_7_2_m54,5_vs_5
6207,1,4,m_sp_arch_4x1_bt_32_roles_r500_m335,3,explt_v0_7_2_m54,5_vs_5
6208,-1,1,m_sp_arch_4x1_bt_32_roles_r500_m335,2,explt_v0_7_2_m54,5_vs_5
6209,-2,0,m_sp_arch_4x1_bt_32_roles_r500_m335,2,explt_v0_7_2_m54,5_vs_5
6210,5,5,m_sp_arch_4x1_bt_32_roles_r500_m335,0,m_sp_sc3v3_arch_2x1_32_r500_cont4x1_m224,5_vs_5
6211,2,5,m_sp_arch_4x1_bt_32_roles_r500_m335,3,m_sp_sc3v3_arch_2x1_32_r500_cont4x1_m224,5_vs_5
6212,2,4,m_sp_arch_4x1_bt_32_roles_r500_m335,2,m_sp_sc3v3_arch_2x1_32_r500_cont4x1_m224,5_vs_5
6213,4,6,m_sp_arch_4x1_bt_32_roles_r500_m335,2,m_sp_sc3v3_arch_2x1_32_r500_cont4x1_m224,5_vs_5
6214,3,4,m_sp_arch_4x1_bt_32_roles_r500_m335,1,m_sp_sc3v3_arch_2x1_32_r500_cont4x1_m224,5_vs_5
6215,5,5,m_sp_arch_4x1_bt_32_roles_r500_m335,0,m_sp_sc3v3_arch_2x1_32_r500_cont4x1_m224,5_vs_5
6216,3,4,m_sp_arch_4x1_bt_32_roles_r500_m335,1,m_sp_sc3v3_arch_2x1_32_r500_cont4x1_m224,5_vs_5
6217,0,3,m_sp_arch_4x1_bt_32_roles_r500_m335,3,m_sp_sc3v3_arch_2x1_32_r500_cont4x1_m224,5_vs_5
6218,6,6,m_sp_arch_4x1_bt_32_roles_r500_m335,0,m_sp_sc3v3_arch_2x1_32_r500_cont4x1_m224,5_vs_5
6219,2,3,m_sp_arch_4x1_bt_32_roles_r500_m335,1,m_sp_sc3v3_arch_2x1_32_r500_cont4x1_m224,5_vs_5
6220,-1,2,m_sp_arch_4x1_bt_32_roles_r500_m335,3,m_sp_arch_4x1_bt_32_roles_r500_m335,5_vs_5
6221,-2,3,m_sp_arch_4x1_bt_32_roles_r500_m335,5,m_sp_arch_4x1_bt_32_roles_r500_m335,5_vs_5
6222,4,4,m_sp_arch_4x1_bt_32_roles_r500_m335,0,m_sp_arch_4x1_bt_32_roles_r500_m335,5_vs_5
6223,0,3,m_sp_arch_4x1_bt_32_roles_r500_m335,3,m_sp_arch_4x1_bt_32_roles_r500_m335,5_vs_5
6224,-5,0,m_sp_arch_4x1_bt_32_roles_r500_m335,5,m_sp_arch_4x1_bt_32_roles_r500_m335,5_vs_5
6225,3,3,m_sp_arch_4x1_bt_32_roles_r500_m335,0,m_sp_arch_4x1_bt_32_roles_r500_m335,5_vs_5
6226,-4,2,m_sp_arch_4x1_bt_32_roles_r500_m335,6,m_sp_arch_4x1_bt_32_roles_r500_m335,5_vs_5
6227,-2,0,m_sp_arch_4x1_bt_32_roles_r500_m335,2,m_sp_arch_4x1_bt_32_roles_r500_m335,5_vs_5
6228,2,4,m_sp_arch_4x1_bt_32_roles_r500_m335,2,m_sp_arch_4x1_bt_32_roles_r500_m335,5_vs_5
6229,1,6,m_sp_arch_4x1_bt_32_roles_r500_m335,5,m_sp_arch_4x1_bt_32_roles_r500_m335,5_vs_5
